,n_samples,MAE,RMSE,R2,time_learning,time_predicting,memory,n_nodes,n_branches,n_leaves,n_active_leaves,n_inactive_leaves,height,total_observed_weight
0,999,19.87467613477872,38.00657329860363,-0.017936755047596176,0.4986271858215332,0.05487847328186035,0.6950464248657227,3,1,2,2,0,2,1000.0
1,1999,20.88562719988493,42.952222813423504,-0.008061171212781826,1.1287732124328613,0.10615682601928711,0.7544641494750977,3,1,2,2,0,2,2000.0
2,2999,20.104384569232636,39.64382539051783,-0.002799535132529174,1.6126954555511475,0.15741586685180664,1.4075746536254883,16,2,14,14,0,3,3000.0
3,3999,20.33213749278216,44.59214011894246,0.00306697451949145,2.0538203716278076,0.20871901512145996,2.5804948806762695,16,2,14,14,0,3,4000.0
4,4999,19.88561207962757,42.07576906639284,0.003754179523012935,2.508697032928467,0.3014841079711914,3.7063722610473633,16,2,14,14,0,3,5000.0
5,5999,19.51552304269684,40.61815307574654,0.0041790512342650965,3.086296558380127,0.3533213138580322,3.6309709548950195,19,3,16,16,0,3,6000.0
6,6999,19.464098173541196,39.52555070484074,0.0053507017567312465,3.655155897140503,0.40644264221191406,3.715336799621582,20,4,16,16,0,4,7000.0
7,7999,19.66388337671361,39.00550207283877,0.005627435380718748,4.355443954467773,0.5135817527770996,3.808079719543457,20,4,16,16,0,4,8000.0
8,8999,20.03666580941256,39.17855631611896,0.008571938955022729,5.0335304737091064,0.5764729976654053,3.8386354446411133,22,5,17,17,0,4,9000.0
9,9999,20.58831254601793,39.817332965099105,0.012635190226126136,5.617243051528931,0.6338818073272705,4.399991035461426,22,5,17,17,0,4,10000.0
10,10999,20.736933867436978,39.446366557744305,0.01992781205383143,6.2474024295806885,0.6908366680145264,4.338620185852051,26,7,19,19,0,5,11000.0
11,11999,20.879453953372042,39.08437516974242,0.026578320448032544,6.904834270477295,0.7518393993377686,4.306424140930176,27,8,19,19,0,6,12000.0
12,12999,21.38055551863775,40.26313856958363,0.035935284860130645,7.55418062210083,0.8077914714813232,4.4283952713012695,27,8,19,19,0,6,13000.0
13,13999,21.893650912743826,40.61566098386248,0.04961613666373976,8.27038836479187,0.8638989925384521,4.497235298156738,27,8,19,19,0,6,14000.0
14,14999,22.366524504214937,41.00998286971977,0.055582701020685854,8.930835008621216,0.9195406436920166,4.585789680480957,27,8,19,19,0,6,15000.0
15,15999,22.560703860453145,40.890542482696716,0.05970350057836982,9.600197076797485,0.975928544998169,4.6089677810668945,27,8,19,19,0,6,16000.0
16,16999,22.90171812120823,41.259911379375076,0.06611771226131857,10.034642219543457,1.083540678024292,5.558316230773926,28,9,19,19,0,7,17000.0
17,17999,23.231761875731827,41.24273321069029,0.06526484301958224,10.759100198745728,1.1392288208007812,5.085423469543457,28,9,19,19,0,7,18000.0
18,18999,23.292962631271955,40.94470036487552,0.06374080560085549,11.298519372940063,1.1964671611785889,5.025479316711426,31,11,20,20,0,8,19000.0
19,19999,23.430777744610157,40.816545000455534,0.05191593262022909,11.887485027313232,1.253525972366333,5.641240119934082,31,11,20,20,0,8,20000.0
20,20999,23.40847814950948,40.70318198378756,0.040499120305651615,12.661580324172974,1.3099949359893799,4.665631294250488,33,12,21,21,0,8,21000.0
21,21999,23.277916101534444,40.30699909636474,0.03504279482251127,13.203397750854492,1.4200456142425537,5.1988115310668945,33,12,21,21,0,8,22000.0
22,22999,23.104531449917797,40.07684563949635,0.03275193544662047,13.696902990341187,1.4775044918060303,5.605618476867676,35,13,22,22,0,9,23000.0
23,23999,22.883063278091583,39.60550888326412,0.0317405889034893,14.318174362182617,1.535954236984253,5.676541328430176,35,13,22,22,0,9,24000.0
24,24999,22.668046551291017,39.21314221806156,0.029882506882076276,14.816542148590088,1.594287633895874,6.746197700500488,35,13,22,22,0,9,25000.0
25,25999,22.515391826458785,38.94049300791695,0.026644779039666,15.586402893066406,1.6525769233703613,5.6689348220825195,36,14,22,22,0,10,26000.0
26,26999,22.3976507785829,38.64227215431018,0.023574843181185967,16.28690457344055,1.71217942237854,5.633633613586426,36,14,22,22,0,10,27000.0
27,27999,22.255285244356106,38.36181135939044,0.02249608318361873,16.828542232513428,1.7703683376312256,6.173352241516113,36,14,22,22,0,10,28000.0
28,28999,22.126541437926264,38.23778858432603,0.02142008789236971,17.47377634048462,1.8304803371429443,6.137059211730957,37,15,22,22,0,11,29000.0
29,29999,22.000627834302573,37.93734599710161,0.022193799650218282,17.97499704360962,1.8886497020721436,6.7352800369262695,39,16,23,23,0,11,30000.0
30,30999,21.905931220350297,38.03292327969831,0.02369233851212027,18.811340808868408,1.9481456279754639,5.757847785949707,39,16,23,23,0,11,31000.0
31,31999,21.799584099892364,37.774046063978204,0.023619706038240817,19.38685655593872,2.011134624481201,6.217709541320801,40,17,23,23,0,12,32000.0
32,32999,21.7459777483536,37.64739829871916,0.023525296100258886,20.118272304534912,2.0715863704681396,5.762692451477051,40,17,23,23,0,12,33000.0
33,33999,21.683902727996955,37.47267422154832,0.023419829804883774,20.6672146320343,2.131333589553833,6.296574592590332,40,17,23,23,0,12,34000.0
34,34999,21.634989040170105,37.34193205777538,0.023270743650723902,21.41733479499817,2.1915817260742188,5.720738410949707,41,18,23,23,0,13,35000.0
35,35999,21.630124452807678,37.21434470861422,0.023048285561051762,22.14894723892212,2.2521800994873047,5.298069953918457,41,18,23,23,0,13,36000.0
36,36999,21.585147744171913,37.047712444323146,0.023145309485196996,22.598755598068237,2.3120715618133545,6.3717851638793945,41,18,23,23,0,13,37000.0
37,37999,21.555904187732896,36.86081479781561,0.022707182880162824,23.28268837928772,2.430354118347168,5.777279853820801,42,19,23,23,0,14,38000.0
38,38999,21.5011550591125,36.68793143450739,0.022601807259707063,23.913475513458252,2.4915292263031006,5.829228401184082,42,19,23,23,0,14,39000.0
39,39999,21.423999152801457,36.493377190265996,0.022868598821548458,24.48699188232422,2.564225912094116,6.364834785461426,42,19,23,23,0,14,40000.0
40,40999,21.329359173173746,36.36381034956911,0.022085223818040678,25.24411916732788,2.632254123687744,6.466992378234863,45,20,25,25,0,14,41000.0
41,41999,21.20474101043111,36.13422882308678,0.020747379907598118,25.903398990631104,2.6940088272094727,6.569684028625488,45,20,25,25,0,14,42000.0
42,42999,21.062943746437355,35.90826465918883,0.02105751671455658,26.64955711364746,2.7540442943573,6.055508613586426,48,21,27,27,0,14,43000.0
43,43999,20.907893089138057,35.65607758988105,0.021406165043201586,27.2834894657135,2.8126943111419678,6.164608955383301,48,21,27,27,0,14,44000.0
44,44999,20.77825604480003,35.44711551814915,0.022148188487258302,27.984198570251465,2.8732688426971436,6.155407905578613,48,21,27,27,0,14,45000.0
45,45999,20.635231145868417,35.19765310909597,0.022447803342792394,28.632367372512817,2.9316186904907227,6.109936714172363,48,21,27,27,0,14,46000.0
46,46999,20.512805052275077,34.9875072774824,0.022125155299064336,29.26855230331421,2.99145245552063,6.126255989074707,48,21,27,27,0,14,47000.0
47,47999,20.40969066260522,34.87239532879932,0.021690473982900027,29.860654592514038,3.051290273666382,6.750103950500488,48,21,27,27,0,14,48000.0
48,48999,20.344388662114454,34.85651497248627,0.02126240072230645,30.415083169937134,3.111300230026245,6.442753791809082,51,23,28,28,0,14,49000.0
49,49999,20.25923053705972,34.80996333651808,0.021522111761940077,30.96734094619751,3.171138048171997,7.0091447830200195,52,24,28,28,0,14,50000.0
50,50999,20.197412709995827,34.73079477311281,0.023308264583628446,31.611330032348633,3.2311267852783203,7.0781450271606445,52,24,28,28,0,14,51000.0
51,51999,20.15652374099384,34.620848180592155,0.02451047401456985,32.34590792655945,3.2907421588897705,6.614758491516113,52,24,28,28,0,14,52000.0
52,52999,20.09056948252507,34.493501226807076,0.025025801185081686,32.94788146018982,3.3503966331481934,7.167477607727051,52,24,28,28,0,14,53000.0
53,53999,20.063259924355613,34.45187287198042,0.0249221944543474,33.49723291397095,3.4109935760498047,7.696141242980957,52,24,28,28,0,14,54000.0
54,54999,20.04109265090725,34.38759301965415,0.02579985876545343,34.25349140167236,3.4732935428619385,7.1588029861450195,52,24,28,28,0,14,55000.0
55,55999,20.037895519451144,34.34602406711384,0.0266220841513658,34.70860195159912,3.594766616821289,8.196110725402832,52,24,28,28,0,14,56000.0
56,56999,20.031683434873464,34.29418522259322,0.02694127207683772,35.304826974868774,3.6550087928771973,8.315629005432129,98,25,73,73,0,14,57000.0
57,57999,20.035640375213713,34.251818677684334,0.026912387873230803,35.90969514846802,3.7148854732513428,8.318215370178223,99,26,73,73,0,14,58000.0
58,58999,20.030485500106025,34.17641766454959,0.02737597381038026,36.460349798202515,3.775960683822632,9.066147804260254,115,27,88,88,0,14,59000.0
59,59999,20.04234355361257,34.12656229759703,0.027229999145064077,36.8536581993103,3.83756160736084,10.25063419342041,119,28,91,91,0,14,60000.0
60,60999,20.064358528707196,34.24457308464049,0.02705262197247016,37.26554822921753,3.897773027420044,11.921128273010254,120,28,92,92,0,14,61000.0
61,61999,20.00570070766739,34.13809415993173,0.026646907590255675,37.74138784408569,3.9572927951812744,12.603264808654785,124,29,95,95,0,14,62000.0
62,62999,19.93892733869654,34.06587064581439,0.02568029994053056,38.368579626083374,4.016183137893677,12.701165199279785,124,29,95,95,0,14,63000.0
63,63999,19.869877723165672,34.007926474045846,0.025393662707408948,39.06666541099548,4.076035261154175,12.940499305725098,124,29,95,95,0,14,64000.0
64,64999,19.801000410883706,33.8782374833241,0.024504833205378218,39.60224890708923,4.134923934936523,13.608124732971191,124,29,95,95,0,14,65000.0
65,65999,19.77434120660701,33.8663813889758,0.023891828666634973,40.28158211708069,4.2037293910980225,13.740548133850098,124,29,95,95,0,14,66000.0
66,66999,19.76306916659486,33.91885173237171,0.022985977350156506,40.97218680381775,4.354438543319702,13.847527503967285,124,29,95,95,0,14,67000.0
67,67999,19.751370036413565,33.88469289735479,0.02184336009174137,41.44394135475159,4.415106773376465,14.115311622619629,127,31,96,96,0,14,68000.0
68,68999,19.811670121976327,33.97716955263384,0.021205426903952995,42.3969464302063,4.476777791976929,12.339295387268066,130,33,97,97,0,14,69000.0
69,69999,19.88525369582151,34.324418038830274,0.020588779732161888,42.908064126968384,4.53825831413269,12.815781593322754,132,34,98,98,0,14,70000.0
70,70999,19.967869013558794,34.498119246813374,0.025314959418006655,43.52247476577759,4.600964069366455,12.770302772521973,134,35,99,99,0,14,71000.0
71,71999,20.072448926420726,34.67492073158882,0.029660449709150605,44.15929913520813,4.66491961479187,13.46712589263916,134,35,99,99,0,14,72000.0
72,72999,20.164964807625402,35.05478174419849,0.02985279568004151,44.77546215057373,4.726707696914673,13.468316078186035,138,36,102,102,0,14,73000.0
73,73999,20.24791689881824,35.27969058108399,0.035437376311060254,45.34410810470581,4.788604021072388,14.02358341217041,138,36,102,102,0,14,74000.0
74,74999,20.345574423182,35.41587976386209,0.037009535645824654,46.00972533226013,4.85044264793396,13.925950050354004,143,38,105,105,0,14,75000.0
75,75999,20.455318163265705,35.54938307583417,0.03855715787577352,46.77931070327759,4.9129369258880615,13.491814613342285,143,38,105,105,0,14,76000.0
76,76999,20.612722727764137,36.02834217823534,0.03768405635699357,47.62516236305237,4.97564959526062,13.030762672424316,143,38,105,105,0,14,77000.0
77,77999,20.765051995735732,36.227283569400086,0.038629175679986805,48.1499502658844,5.03802752494812,13.457154273986816,144,39,105,105,0,15,78000.0
78,78999,20.893432513361255,36.377245730322336,0.03932567039139112,48.90194487571716,5.102166652679443,13.019387245178223,144,39,105,105,0,15,79000.0
79,79999,21.037183922872448,36.51421595144071,0.03917225503622823,49.545963287353516,5.1662821769714355,13.59060001373291,144,39,105,105,0,15,80000.0
80,80999,21.136909776021167,36.581500065703345,0.039589521320951615,50.20400261878967,5.229197263717651,13.606423377990723,144,39,105,105,0,15,81000.0
81,81999,21.144124275528327,36.5755581368295,0.038579270762435836,50.45033144950867,5.2895495891571045,15.288849830627441,156,41,115,115,0,15,82000.0
82,82999,21.117938897796364,36.56443142843441,0.03797452516742106,50.934967041015625,5.349632501602173,16.537056922912598,170,42,128,128,0,15,83000.0
83,83999,21.063625581337284,36.45002798294249,0.03820658464654436,51.18220353126526,5.409916400909424,18.801323890686035,170,42,128,128,0,15,84000.0
84,84999,21.027405948361334,36.36627674401115,0.03827400666763825,51.879586696624756,5.469801902770996,18.40097141265869,172,43,129,129,0,15,85000.0
85,85999,21.033073310008426,36.40590641420691,0.03835311955579779,52.14507269859314,5.638735771179199,19.948227882385254,176,45,131,131,0,15,86000.0
86,86999,21.013399107304316,36.3525010514839,0.038071303629662934,52.558499813079834,5.700029134750366,20.524819374084473,183,48,135,135,0,15,87000.0
87,87999,21.053587995049472,36.406444845233466,0.038468931256072314,53.00780916213989,5.7616071701049805,21.784539222717285,183,48,135,135,0,15,88000.0
88,88999,21.086830640412614,36.46074235018013,0.03878666730716518,53.73590397834778,5.823206901550293,21.860100746154785,186,49,137,137,0,15,89000.0
89,89999,21.137672557704583,36.507790366063745,0.03939240532546895,54.099461793899536,5.884244441986084,23.508728981018066,186,49,137,137,0,15,90000.0
90,90999,21.19601535911991,36.58011895139918,0.039716467049345616,54.71756076812744,5.9472739696502686,23.508164405822754,188,50,138,138,0,15,91000.0
91,91999,21.26727008067721,36.684989326418446,0.04148265691117847,55.511752128601074,6.010521411895752,23.587265968322754,188,50,138,138,0,15,92000.0
92,92999,21.367161134435037,36.898736535738664,0.0434026044546828,55.91827893257141,6.072131872177124,24.766419410705566,190,51,139,139,0,15,93000.0
93,93999,21.451007769283436,37.02058055035162,0.044408805987802835,56.572383403778076,6.137537002563477,25.315674781799316,190,51,139,139,0,15,94000.0
94,94999,21.523068559375638,37.095103891012975,0.04530981281202273,57.4734890460968,6.337686538696289,23.672402381896973,193,53,140,140,0,15,95000.0
95,95999,21.62289860922065,37.239554086182785,0.04723910844277146,58.320168018341064,6.400548458099365,22.88356876373291,193,53,140,140,0,15,96000.0
96,96999,21.734687366495685,37.384773807609314,0.04858787919749852,58.795100927352905,6.463016986846924,23.983025550842285,193,53,140,140,0,15,97000.0
97,97999,21.861529363291368,37.68955666963863,0.04938148641717177,59.421478033065796,6.525890350341797,24.01168155670166,195,54,141,141,0,15,98000.0
98,98999,21.972786298820047,37.83923218818999,0.050542716362896645,60.08755016326904,6.589800119400024,24.42733860015869,197,55,142,142,0,15,99000.0
99,99999,22.096371795045226,38.00900330665247,0.051979582148341974,60.65962052345276,6.65572190284729,25.06527805328369,197,55,142,142,0,15,100000.0
100,100999,22.196559842782616,38.10422867799697,0.05243368366787937,61.29967403411865,6.720547199249268,25.277222633361816,199,56,143,143,0,15,101000.0
101,101999,22.25389178985716,38.135294987493026,0.051840920030662097,62.108392000198364,6.783297777175903,25.454880714416504,205,56,149,149,0,15,102000.0
102,102999,22.237823568402614,38.081408380681445,0.0510369148745643,62.62131905555725,6.844237565994263,26.05165958404541,207,57,150,150,0,15,103000.0
103,103999,22.226153049358555,38.08505865878803,0.05029942602496862,63.07719278335571,6.9050068855285645,27.210068702697754,207,57,150,150,0,15,104000.0
104,104999,22.193695290477525,38.05236760451859,0.04978280864668805,63.64842438697815,6.966633081436157,27.28225803375244,211,59,152,152,0,15,105000.0
105,105999,22.158307856183416,37.98839606512561,0.04973784460362474,64.32798027992249,7.186074256896973,27.316475868225098,213,60,153,153,0,15,106000.0
106,106999,22.116389141908726,37.91359258570404,0.04945571521266867,64.84779262542725,7.2477850914001465,27.88807773590088,215,61,154,154,0,15,107000.0
107,107999,22.07153624268736,37.81498688480241,0.04920703933198667,65.32562804222107,7.309176445007324,28.964356422424316,215,61,154,154,0,15,108000.0
108,108999,22.04681805948724,37.89931155174141,0.048389949906586405,65.84885048866272,7.371538162231445,29.45211887359619,216,62,154,154,0,15,109000.0
109,109999,22.007765948160646,37.82993404928143,0.04833674275152455,66.59221363067627,7.435024261474609,29.38631534576416,219,64,155,155,0,15,110000.0
110,110999,21.980177624854157,37.75789008197758,0.04817989450527882,67.06202793121338,7.4977123737335205,30.10464572906494,221,65,156,156,0,15,111000.0
111,111999,21.960748050190332,37.81662678903185,0.04806034682873894,67.74870014190674,7.561059474945068,30.180901527404785,221,65,156,156,0,15,112000.0
112,112999,21.936313360793157,37.74700554683714,0.047839578327729115,68.72939205169678,7.625207901000977,28.742966651916504,221,65,156,156,0,15,113000.0
113,113999,21.914393416399548,37.6948493272548,0.04769881524453212,69.30984306335449,7.689347267150879,29.291359901428223,221,65,156,156,0,15,114000.0
114,114999,21.904808280095335,37.65903330188715,0.04738741863452978,70.24182176589966,7.753725290298462,28.515374183654785,222,66,156,156,0,15,115000.0
115,115999,21.884018002998985,37.59529522496445,0.04733725270938027,70.87070560455322,7.817562818527222,28.48611545562744,223,67,156,156,0,15,116000.0
116,116999,21.86915799505955,37.52920162782693,0.04713901687196276,71.44404196739197,7.881200551986694,29.070626258850098,223,67,156,156,0,15,117000.0
117,117999,21.854147218339847,37.514437434255846,0.046930458228497174,72.02850103378296,7.94671630859375,29.623520851135254,223,67,156,156,0,15,118000.0
118,118999,21.824359655832613,37.45238285111478,0.046641511547515835,72.7996997833252,8.011782884597778,29.13344669342041,223,67,156,156,0,15,119000.0
119,119999,21.78606405877503,37.38801592145906,0.04645585557260801,73.23137950897217,8.239475965499878,30.780343055725098,229,67,162,162,0,15,120000.0
120,120999,21.741109462655203,37.303958123004776,0.046618467355611815,73.57907390594482,8.300484418869019,32.00727939605713,231,68,163,163,0,15,121000.0
121,121999,21.68316909111499,37.20651798083357,0.04676170100177113,74.19444751739502,8.362496137619019,32.08212375640869,233,69,164,164,0,15,122000.0
122,122999,21.633961673204084,37.133366224767364,0.04694315597768639,74.76254844665527,8.423787355422974,32.10654544830322,237,71,166,166,0,15,123000.0
123,123999,21.58995412790947,37.05401768279939,0.046871427065790616,75.64020657539368,8.485785961151123,31.868210792541504,239,72,167,167,0,15,124000.0
124,124999,21.549558759046604,37.04084982625421,0.04668718520057635,76.21412968635559,8.547251462936401,32.446160316467285,239,72,167,167,0,15,125000.0
125,125999,21.515317984862907,36.98275908323132,0.0463430149058488,76.64068865776062,8.608805656433105,33.40878391265869,240,73,167,167,0,15,126000.0
126,126999,21.483271918980954,36.920408802508184,0.046053260686273245,77.26440501213074,8.678951025009155,33.93093967437744,241,74,167,167,0,15,127000.0
127,127999,21.453319291614143,36.85456758298752,0.045805134886763965,78.01784992218018,8.743134021759033,34.53029727935791,241,74,167,167,0,15,128000.0
128,128999,21.428761634481898,36.79266737658331,0.045626749756999874,78.68155097961426,8.807792901992798,34.35646152496338,243,75,168,168,0,15,129000.0
129,129999,21.40749553064962,36.743471773646455,0.045380465408903725,79.26568078994751,8.87499713897705,34.93204593658447,297,76,221,221,0,15,130000.0
130,130999,21.381886339885586,36.69896384058475,0.04521877195721824,80.08135390281677,8.94279432296753,34.53733158111572,297,76,221,221,0,15,131000.0
131,131999,21.383834653075958,36.76362183066579,0.0448551371814887,80.53453636169434,9.009432077407837,35.530823707580566,298,77,221,221,0,15,132000.0
132,132999,21.381620393463056,36.74478061346659,0.04440743937133085,81.17717170715332,9.07555079460144,35.558030128479004,299,78,221,221,0,15,133000.0
133,133999,21.399655812548474,36.764552534533244,0.04419511168461909,82.36551403999329,9.142613410949707,34.22207736968994,299,78,221,221,0,15,134000.0
134,134999,21.434417572591443,36.79940628573552,0.04390907064513794,83.24764728546143,9.208892583847046,33.270142555236816,299,78,221,221,0,15,135000.0
135,135999,21.460426313361165,36.80488586749689,0.043880606667052624,83.79590797424316,9.272914409637451,33.8002405166626,304,79,225,225,0,15,136000.0
136,136999,21.487597192085385,36.82413572747616,0.04374778305182325,84.39232325553894,9.33882737159729,34.34034824371338,304,79,225,225,0,15,137000.0
137,137999,21.524537382212273,36.90676633456679,0.04361137409877214,85.32823419570923,9.412290096282959,33.23752689361572,306,80,226,226,0,15,138000.0
138,138999,21.537973617094476,36.89187923842692,0.043636947889323596,86.14832830429077,9.480043649673462,33.412034034729004,307,81,226,226,0,16,139000.0
139,139999,21.530943072509302,36.883422849283505,0.04305807604590883,86.60859441757202,9.540897130966187,34.59206485748291,307,81,226,226,0,16,140000.0
140,140999,21.51058552407223,36.818492934959885,0.04270878798294342,87.07979607582092,9.602541446685791,35.72865390777588,307,81,226,226,0,16,141000.0
141,141999,21.492182003963975,36.75940071165715,0.042534290854902346,87.55789160728455,9.664005994796753,36.81636142730713,307,81,226,226,0,16,142000.0
142,142999,21.465161056045382,36.68545414623577,0.04243431637894168,88.29543280601501,9.935496091842651,36.333909034729004,315,82,233,233,0,16,143000.0
143,143999,21.442399136134206,36.645157585954735,0.042203583832960856,89.14041829109192,9.998085260391235,35.22107791900635,316,83,233,233,0,16,144000.0
144,144999,21.410486186527276,36.57320608375276,0.04212113825843811,89.67185688018799,10.06144642829895,35.80307102203369,330,84,246,246,0,16,145000.0
145,145999,21.38080840706704,36.50987894035953,0.04210126706244277,89.94268774986267,10.127686500549316,38.135910987854004,331,84,247,247,0,16,146000.0
146,146999,21.354240609478673,36.45403750729163,0.04206660480910873,90.22389912605286,10.19101357460022,40.37654972076416,333,84,249,249,0,16,147000.0
147,147999,21.32240878281018,36.38354691628841,0.042151229642970134,91.1344702243805,10.25576138496399,40.52204990386963,333,84,249,249,0,16,148000.0
148,148999,21.29818522484644,36.34066260501624,0.042337009025741335,91.62370491027832,10.320264101028442,41.649888038635254,333,84,249,249,0,16,149000.0
149,149999,21.273512898584446,36.279951598881475,0.042442027151843975,92.35751366615295,10.386061191558838,41.379502296447754,341,85,256,256,0,16,150000.0
150,150999,21.255115965303307,36.24923057722007,0.04250557384375042,93.09488701820374,10.449091672897339,40.89993381500244,343,86,257,257,0,16,151000.0
151,151999,21.23113699448838,36.19920367943749,0.04276394811584938,93.48001956939697,10.513534545898438,42.502182960510254,343,86,257,257,0,16,152000.0
152,152999,21.208144073968043,36.154522460186065,0.042781927081465,94.61447429656982,10.579106330871582,41.586541175842285,343,86,257,257,0,16,153000.0
153,153999,21.19061622632817,36.10645861052686,0.04297894322085538,95.16996002197266,10.643600463867188,41.99149417877197,345,87,258,258,0,16,154000.0
154,154999,21.171433337952976,36.04739769876705,0.04310462863409592,95.8644347190857,10.70714020729065,42.047593116760254,345,87,258,258,0,16,155000.0
155,155999,21.14553071914245,35.980190244062165,0.04344793167966676,96.55778241157532,10.776281356811523,41.94227695465088,347,88,259,259,0,16,156000.0
156,156999,21.12124874692283,35.92365300116513,0.043801345018616655,97.56125140190125,10.842113494873047,40.452439308166504,347,88,259,259,0,16,157000.0
157,157999,21.10082989650784,35.88385042324229,0.043849005280935494,97.84608292579651,11.14698338508606,42.54176425933838,347,88,259,259,0,16,158000.0
158,158999,21.068224274192758,35.81869141392686,0.04398557174523543,98.32744693756104,11.212582111358643,43.62491703033447,347,88,259,259,0,16,159000.0
159,159999,21.051395393931962,35.75919899246812,0.043807408645223256,99.23573279380798,11.280946731567383,42.771294593811035,349,88,261,261,0,16,160000.0
160,160999,21.013714494957394,35.68631661964686,0.04390536500977116,99.78437638282776,11.352672576904297,43.27915287017822,351,89,262,262,0,16,161000.0
161,161999,20.968719081908592,35.61048364215776,0.04406178329517918,100.38103151321411,11.420626163482666,43.89779758453369,351,89,262,262,0,16,162000.0
162,162999,20.927545188666837,35.540430713723914,0.0441329699302222,100.87548637390137,11.486964225769043,45.001328468322754,351,89,262,262,0,16,163000.0
163,163999,20.89046328123,35.49153595031976,0.0442161202746737,101.94133162498474,11.556082010269165,43.99057865142822,367,91,276,276,0,16,164000.0
164,164999,20.843510859253662,35.410885120377124,0.04449968841023866,102.75593066215515,11.62497091293335,43.529709815979004,367,91,276,276,0,16,165000.0
165,165999,20.808475930167013,35.35082555336197,0.04475204149817458,103.31141209602356,11.692808389663696,43.98164463043213,368,92,276,276,0,16,166000.0
166,166999,20.78020767612878,35.285806268688354,0.04484311347501413,103.76215982437134,11.761631965637207,44.985466957092285,369,93,276,276,0,17,167000.0
167,167999,20.745665823413642,35.2366639355604,0.044910733631020716,104.46520161628723,11.83061957359314,45.070244789123535,369,93,276,276,0,17,168000.0
168,168999,20.71860565089123,35.18580573345537,0.04500295805751453,105.3361451625824,11.900765657424927,45.635483741760254,369,93,276,276,0,17,169000.0
169,169999,20.702094146956508,35.219904654850446,0.044817187084668864,106.20217728614807,11.969128608703613,44.623406410217285,371,94,277,277,0,17,170000.0
170,170999,20.691209181422376,35.21625482405124,0.04471073919775037,106.73979163169861,12.042301416397095,45.67825412750244,371,94,277,277,0,17,171000.0
171,171999,20.68421248100535,35.20769657295157,0.04458591123784894,107.19334697723389,12.114023685455322,46.63454532623291,372,95,277,277,0,18,172000.0
172,172999,20.682574718598627,35.21098079204256,0.04442600138065478,107.97754120826721,12.186807632446289,46.081536293029785,373,96,277,277,0,19,173000.0
173,173999,20.688951055251938,35.20177535803489,0.04432878101178939,108.79858255386353,12.258777618408203,45.65677738189697,373,96,277,277,0,19,174000.0
174,174999,20.700964662141736,35.20256899732101,0.04418997548589254,109.51214241981506,12.3312828540802,45.70132541656494,373,96,277,277,0,19,175000.0
175,175999,20.715008844453592,35.208745036577355,0.04409946314208235,110.24687480926514,12.402741193771362,46.68136692047119,378,97,281,281,0,19,176000.0
176,176999,20.72809879811946,35.21570124856273,0.043955567645331484,111.22911167144775,12.475186347961426,45.131218910217285,380,98,282,282,0,19,177000.0
177,177999,20.736267208276033,35.20172387330168,0.043809760134913445,111.67728352546692,12.545732498168945,46.07431888580322,381,99,282,282,0,20,178000.0
178,178999,20.72468861835413,35.15915206699293,0.04382519442428712,112.28435158729553,12.6171133518219,45.981186866760254,383,101,282,282,0,21,179000.0
179,179999,20.714287743100314,35.13497517182591,0.04349668848795907,112.62705540657043,12.688526153564453,47.662903785705566,388,102,286,286,0,21,180000.0
180,180999,20.685620444742252,35.07361441426285,0.043570932978467924,113.18647527694702,12.756879806518555,48.33841800689697,390,103,287,287,0,21,181000.0
181,181999,20.643836934865327,35.00076028241644,0.04388005703736475,114.05084156990051,12.82849931716919,48.389817237854004,396,106,290,290,0,21,182000.0
182,182999,20.605580451127288,34.93950239839813,0.044013712421346995,114.34581804275513,12.894360303878784,50.5790491104126,396,106,290,290,0,21,183000.0
183,183999,20.56949423081641,34.88689260333075,0.04423175088824027,115.25068354606628,12.960972785949707,49.65365695953369,396,106,290,290,0,21,184000.0
184,184999,20.529034765162727,34.81912540955434,0.04452945907518979,115.96741342544556,13.030872344970703,49.150147438049316,400,108,292,292,0,21,185000.0
185,185999,20.490032544489715,34.75143887443133,0.044887013460865655,116.58110666275024,13.097867012023926,49.131340980529785,404,110,294,294,0,21,186000.0
186,186999,20.447659632919706,34.68199036220895,0.04527136784101582,117.18990182876587,13.165374755859375,49.72791385650635,404,110,294,294,0,21,187000.0
187,187999,20.40666368245211,34.617465157072274,0.045579283019676065,118.08345913887024,13.235698699951172,50.317261695861816,404,110,294,294,0,21,188000.0
188,188999,20.370907275570747,34.56489504927069,0.045817421825475435,118.65151929855347,13.304898738861084,50.78394412994385,405,111,294,294,0,21,189000.0
189,189999,20.33164431226869,34.52732667180928,0.0459874154506299,119.31449174880981,13.37271785736084,50.204392433166504,411,114,297,297,0,21,190000.0
190,190999,20.28850548214953,34.461009493111895,0.04630829435393147,119.81786012649536,13.441060066223145,51.436463356018066,411,114,297,297,0,21,191000.0
191,191999,20.254911885799057,34.4248931539342,0.0463916747785077,120.52788925170898,13.50957703590393,51.52041721343994,411,114,297,297,0,21,192000.0
192,192999,20.22204555853494,34.38133099679222,0.04648279158544977,121.2819938659668,13.577869176864624,51.06623935699463,421,115,306,306,0,21,193000.0
193,193999,20.196529816811744,34.34284549237079,0.0465551939368507,122.0960910320282,13.652451753616333,52.14333438873291,421,115,306,306,0,21,194000.0
194,194999,20.171033751637037,34.30299230385546,0.04659259775981339,123.25842261314392,13.724666118621826,49.78750705718994,423,116,307,307,0,21,195000.0
195,195999,20.161523982689694,34.28786502692767,0.04640121963014987,123.72806644439697,13.792689085006714,50.9403772354126,425,117,308,308,0,21,196000.0
196,196999,20.144858902900744,34.258573852087956,0.04635330610111277,124.63237595558167,13.861782789230347,49.99002170562744,425,117,308,308,0,21,197000.0
197,197999,20.13184687508085,34.23665161380668,0.04626967748347688,125.02577614784241,13.933162927627563,51.56864261627197,425,117,308,308,0,21,198000.0
198,198999,20.11013020143202,34.20043907335991,0.04643456273289992,125.82772564888,14.002522468566895,51.28487491607666,426,117,309,309,0,21,199000.0
199,199999,20.101982707759532,34.17478493399185,0.045801445843327016,126.65212512016296,14.070797204971313,51.80477237701416,432,118,314,314,0,21,200000.0
200,200999,20.08816515972473,34.1581622161099,0.04511615778905853,127.15865683555603,14.14104175567627,52.95131015777588,433,118,315,315,0,21,201000.0
201,201999,20.058242179534197,34.1152255320924,0.04502579489459935,127.71990776062012,14.211515426635742,52.89734745025635,439,121,318,318,0,21,202000.0
202,202999,20.03659009590112,34.089806091256165,0.0451596457033937,128.23912572860718,14.280838012695312,53.328843116760254,443,123,320,320,0,21,203000.0
203,203999,20.00481510719742,34.04320835173015,0.04516152448832289,128.7863256931305,14.351447582244873,53.935669898986816,445,124,321,321,0,21,204000.0
204,204999,19.97173090836813,33.99390216744518,0.04592915502868167,129.4380624294281,14.422123193740845,54.02639102935791,448,125,323,323,0,21,205000.0
205,205999,19.9434363643078,33.94920105117984,0.04635525087081305,130.04531025886536,14.806328535079956,54.61689853668213,448,125,323,323,0,21,206000.0
206,206999,19.914787257533618,33.90353723782244,0.047123409160512275,130.56360483169556,14.88231348991394,55.099602699279785,451,127,324,324,0,21,207000.0
207,207999,19.894441425356465,33.882133309676355,0.047912016156196446,131.1976354122162,14.954679727554321,55.1145715713501,455,129,326,326,0,21,208000.0
208,208999,19.867520053027754,33.837338675089626,0.04829534953127412,131.9722180366516,15.026513576507568,54.620911598205566,457,130,327,327,0,21,209000.0
209,209999,19.851610286516884,33.8090039043023,0.04935305341956564,132.5428855419159,15.096177577972412,55.06112766265869,458,131,327,327,0,21,210000.0
210,210999,19.842656142748492,33.83821496023184,0.04884794122471614,133.17308497428894,15.17131233215332,55.16348361968994,471,133,338,338,0,21,211000.0
211,211999,19.82842805497228,33.81045930231458,0.04946605184367703,133.88831496238708,15.240591764450073,55.23817539215088,471,133,338,338,0,21,212000.0
212,212999,19.824004893445643,33.82213627229287,0.0493708360478925,134.62569093704224,15.312578439712524,56.827637672424316,471,133,338,338,0,21,213000.0
213,213999,19.82598770391777,33.83875834742476,0.049316825150607646,135.60118222236633,15.385855913162231,55.256524085998535,472,134,338,338,0,21,214000.0
214,214999,19.84187545943246,33.876804201642386,0.049677531259712526,136.20896673202515,15.459058046340942,55.83198642730713,472,134,338,338,0,21,215000.0
215,215999,19.858583804701993,33.90697881423506,0.049992373745931906,136.93431663513184,15.533496141433716,55.297730445861816,476,136,340,340,0,21,216000.0
216,216999,19.879145563089114,33.94245409500843,0.04996860051820173,137.5091269016266,15.605229377746582,55.71956729888916,477,137,340,340,0,21,217000.0
217,217999,19.899060559313966,33.96395111883813,0.0503301946284731,138.29434847831726,15.681014776229858,55.62683963775635,477,137,340,340,0,21,218000.0
218,218999,19.927831160679336,34.00410076201324,0.050365493197670475,139.0269694328308,15.753645181655884,55.66201877593994,477,137,340,340,0,21,219000.0
219,219999,19.937383030605744,33.991222899061604,0.04983675222441886,139.521963596344,15.82504677772522,56.78475284576416,481,137,344,344,0,21,220000.0
220,220999,19.95490573979699,33.992464965860904,0.04850577101778486,140.34555172920227,15.892613410949707,57.31736087799072,487,139,348,348,0,21,221000.0
221,221999,19.95785424046926,33.97471136909034,0.04764430248170437,140.79854035377502,15.95858383178711,58.260178565979004,489,140,349,349,0,21,222000.0
222,222999,19.950247890259853,33.94425759422151,0.0470132963591986,141.50378251075745,16.024755716323853,57.37013339996338,497,144,353,353,0,21,223000.0
223,223999,19.942566162419144,33.93497907205089,0.04674907203555645,141.8870611190796,16.0933039188385,58.77938938140869,499,145,354,354,0,21,224000.0
224,224999,19.93570674344883,33.91907572705008,0.04629271788606859,142.72296285629272,16.16387701034546,57.42537021636963,505,148,357,357,0,21,225000.0
225,225999,19.931533097221617,33.89798699978816,0.04592030039240669,143.33997774124146,16.231638431549072,57.382309913635254,509,150,359,359,0,21,226000.0
226,226999,19.92950423504901,33.89131741698725,0.04576608716108066,144.06203365325928,16.296642541885376,59.013672828674316,509,150,359,359,0,21,227000.0
227,227999,19.93511418788809,33.89414349059665,0.045212942045510185,144.5721230506897,16.36488437652588,60.1160364151001,509,150,359,359,0,21,228000.0
228,228999,19.94431894299884,33.91541396895368,0.045066890152249406,145.09045791625977,16.431427240371704,60.64022159576416,513,152,361,361,0,21,229000.0
229,229999,19.950520904042488,33.930368988689004,0.04531822234901128,145.64992380142212,16.496628046035767,61.18582248687744,515,153,362,362,0,21,230000.0
230,230999,19.966780533878076,33.96325795633315,0.04592040600523428,146.35356521606445,16.563172817230225,60.710381507873535,519,155,364,364,0,21,231000.0
231,231999,19.979817870998907,33.981022769604806,0.046710639096977924,146.91156482696533,16.628527641296387,60.671814918518066,542,158,384,384,0,21,232000.0
232,232999,20.00139452468249,34.0347650402753,0.04748317789273815,147.57788395881653,16.697232484817505,60.58558750152588,543,159,384,384,0,21,233000.0
233,233999,20.035476830912522,34.115942352669684,0.048335686261228195,148.54630661010742,16.76500415802002,61.12587833404541,543,159,384,384,0,21,234000.0
234,234999,20.07738348655529,34.25018480351819,0.04887871824008372,148.93723797798157,16.83362603187561,62.75772190093994,543,159,384,384,0,21,235000.0
235,235999,20.119045634914887,34.3777696269143,0.050185121912164954,149.69677186012268,16.902794361114502,61.782647132873535,548,162,386,386,0,21,236000.0
236,236999,20.175523923386326,34.53265586011894,0.05142709282328417,150.47187995910645,16.972403287887573,61.22327518463135,550,163,387,387,0,21,237000.0
237,237999,20.213997029813733,34.593915406205255,0.0524653465011099,151.4930760860443,17.043065547943115,59.65597629547119,552,164,388,388,0,21,238000.0
238,238999,20.244724085776298,34.64026261712466,0.05357792680632001,152.00280213356018,17.112138032913208,60.76404666900635,552,164,388,388,0,21,239000.0
239,239999,20.25549987869529,34.65877603281529,0.05392237726832472,152.50395488739014,17.182873487472534,61.91574954986572,557,164,393,393,0,21,240000.0
240,240999,20.244194466717648,34.65128257553684,0.05378640848925875,153.3382682800293,17.248530626296997,63.057915687561035,560,164,396,396,0,21,241000.0
241,241999,20.232385127364886,34.622847270504074,0.053821659055201865,153.8155608177185,17.31815528869629,63.99892520904541,562,165,397,397,0,21,242000.0
242,242999,20.220013364575372,34.61659266640785,0.0536834071674438,154.6107726097107,17.386144638061523,63.618103981018066,562,165,397,397,0,21,243000.0
243,243999,20.208509792630895,34.59605299748401,0.05365825111535549,155.22434854507446,17.455281019210815,64.20327854156494,562,165,397,397,0,21,244000.0
244,244999,20.19596233534627,34.569768900211116,0.053589913787459365,155.88184261322021,17.5240581035614,64.2141580581665,564,166,398,398,0,21,245000.0
245,245999,20.18386825432,34.544897121684436,0.05353331485059876,156.47475504875183,17.59390354156494,64.77141666412354,564,166,398,398,0,21,246000.0
246,246999,20.175931173820906,34.53594521261815,0.0534255696205681,156.93630027770996,17.66562795639038,65.7614221572876,565,167,398,398,0,21,247000.0
247,247999,20.16901058111807,34.51972190610053,0.05329366252139478,157.54889559745789,17.735096216201782,66.33998203277588,565,167,398,398,0,21,248000.0
248,248999,20.164998024406998,34.50790700070995,0.05314968931774677,158.3301854133606,18.178927898406982,65.23202610015869,575,170,405,405,0,21,249000.0
249,249999,20.160673231600434,34.493767680823105,0.05292186803682675,158.9075849056244,18.25174069404602,65.82314395904541,588,171,417,417,0,21,250000.0
250,250999,20.159227852173085,34.48358623147079,0.052812723686197605,159.90808963775635,18.323185920715332,64.46222019195557,590,172,418,418,0,21,251000.0
251,251999,20.15615534328353,34.46962965475222,0.05270952867259904,160.318767786026,18.395795345306396,66.03614139556885,590,172,418,418,0,21,252000.0
252,252999,20.15738812638127,34.457549672812505,0.05262217893905985,160.9860439300537,18.468327283859253,65.95375156402588,591,173,418,418,0,21,253000.0
253,253999,20.153421337265968,34.43892165215183,0.05262473282016589,161.54287695884705,18.54039978981018,66.52616214752197,593,174,419,419,0,21,254000.0
254,254999,20.151943540423456,34.42722869670055,0.0525706012135404,162.10782408714294,18.61243987083435,66.97974491119385,594,175,419,419,0,21,255000.0
255,255999,20.14968312724546,34.41171047242607,0.051868990329843045,162.7063570022583,18.685186624526978,67.69433689117432,600,175,425,425,0,21,256000.0
256,256999,20.156004006187576,34.42257848106799,0.05112667032165574,163.594562292099,18.75577712059021,68.87587070465088,603,175,428,428,0,21,257000.0
257,257999,20.164173183187163,34.430582258754754,0.05050459400177465,164.11540508270264,18.828805446624756,69.98079013824463,603,175,428,428,0,21,258000.0
258,258999,20.169666234590768,34.42835605374094,0.05008247123787113,164.61796236038208,18.89578366279602,70.47655582427979,607,177,430,430,0,21,259000.0
259,259999,20.17401999624084,34.42238830052753,0.04971557094926171,165.3782570362091,18.966156482696533,69.99808597564697,609,178,431,431,0,21,260000.0
260,260999,20.189296041997018,34.46635453291497,0.04943688972608373,166.13459038734436,19.034175157546997,69.62757968902588,611,179,432,432,0,21,261000.0
261,261999,20.199952709468636,34.491839981798655,0.04917143080028308,166.62987089157104,19.103113174438477,70.71502780914307,611,179,432,432,0,21,262000.0
262,262999,20.212256765929133,34.508842819047175,0.048951627801510966,167.16211795806885,19.1752986907959,71.18052005767822,614,181,433,433,0,21,263000.0
263,263999,20.228846389934734,34.52998870341936,0.0489440549094845,167.6841962337494,19.24797558784485,72.29924869537354,614,181,433,433,0,21,264000.0
264,264999,20.252266966293163,34.55992495304047,0.04916192770705674,168.40881156921387,19.72184467315674,72.59356784820557,614,181,433,433,0,21,265000.0
265,265999,20.277013212388983,34.62754222914298,0.04929872114404832,169.29691433906555,19.790947437286377,71.75418949127197,614,181,433,433,0,21,266000.0
266,266999,20.29877031732535,34.651970635270594,0.049448335017113765,169.965069770813,19.866695165634155,72.11548709869385,616,182,434,434,0,21,267000.0
267,267999,20.319808942451665,34.66776312932429,0.04985618174950934,170.46089029312134,19.938277006149292,73.17700290679932,616,182,434,434,0,21,268000.0
268,268999,20.34270139790419,34.691848015300565,0.05025952585102478,171.12764501571655,20.009034633636475,73.05571842193604,618,183,435,435,0,21,269000.0
269,269999,20.365810177312888,34.714490444354915,0.05058571118154531,171.57888555526733,20.07983136177063,74.15843296051025,619,184,435,435,0,21,270000.0
270,270999,20.406218581815132,34.78985316628346,0.051377653757530894,172.23137187957764,20.15171504020691,74.23228549957275,632,185,447,447,0,21,271000.0
271,271999,20.429166599508626,34.80250489124194,0.051884907611506104,173.15180706977844,20.227560997009277,73.69358158111572,632,185,447,447,0,21,272000.0
272,272999,20.45324354882903,34.81174286360531,0.052190778984694375,173.6828727722168,20.304327726364136,74.75585269927979,632,185,447,447,0,21,273000.0
273,273999,20.4665839310746,34.872225091042544,0.05160727462400261,174.4748694896698,20.373600006103516,76.15687656402588,640,186,454,454,0,21,274000.0
274,274999,20.484105604755573,34.94133315337086,0.05095733766848687,174.9156436920166,20.438236474990845,77.24424076080322,645,187,458,458,0,21,275000.0
275,275999,20.497085961672838,35.02206249052298,0.05043411708410561,175.87887263298035,20.508376598358154,75.62843418121338,650,189,461,461,0,21,276000.0
276,276999,20.51122236819981,35.05184226910631,0.050133222892185136,176.49580574035645,20.573443174362183,75.55840396881104,654,191,463,463,0,21,277000.0
277,277999,20.528917515715204,35.08297706997773,0.049906911962511624,177.1808159351349,20.641350269317627,75.0225076675415,660,194,466,466,0,21,278000.0
278,278999,20.553206542631848,35.13427197616599,0.04983179469885657,177.42727065086365,20.708707094192505,77.16014957427979,662,195,467,467,0,21,279000.0
279,279999,20.573102404538826,35.165445370250445,0.050020708691603244,178.04835200309753,20.77496862411499,77.14542484283447,666,197,469,469,0,21,280000.0
280,280999,20.59747797797689,35.20326758831183,0.050374948800966046,178.7363531589508,20.846317291259766,77.192307472229,668,198,470,470,0,21,281000.0
281,281999,20.6258012772781,35.275123556565184,0.05111595701359206,179.8953959941864,20.91215419769287,77.22935581207275,668,198,470,470,0,21,282000.0
282,282999,20.65911220237645,35.3525063929435,0.05179936970892973,180.4131486415863,20.981704235076904,78.32460880279541,668,198,470,470,0,21,283000.0
283,283999,20.697294037641637,35.42744886979425,0.052841002102908985,181.1283664703369,21.051703691482544,77.80996036529541,672,200,472,472,0,21,284000.0
284,284999,20.735462326870046,35.49934155373753,0.054140888301541845,181.5838634967804,21.1187105178833,78.84746646881104,674,201,473,473,0,21,285000.0
285,285999,20.77147376196974,35.54641420645177,0.05533316925118681,182.3027708530426,21.18709444999695,78.34439945220947,678,203,475,475,0,21,286000.0
286,286999,20.82064787585916,35.642120706252555,0.05677419175077891,182.69805145263672,21.252808809280396,79.96408176422119,678,203,475,475,0,21,287000.0
287,287999,20.859878843171767,35.70113294978586,0.058446282741904776,183.34723329544067,21.31811785697937,79.95723056793213,680,204,476,476,0,21,288000.0
288,288999,20.90628179496511,35.80601413462188,0.0604212144587748,183.91920447349548,21.38797903060913,80.49080753326416,682,205,477,477,0,21,289000.0
289,289999,20.961758909186145,35.90807457979044,0.06284305221412323,184.782071352005,21.45408844947815,79.44337558746338,684,206,478,478,0,21,290000.0
290,290999,21.01448295069731,36.002663227206725,0.06504294862801119,185.76355051994324,21.520440340042114,80.12181949615479,686,207,479,479,0,21,291000.0
291,291999,21.06386133332506,36.080729961371794,0.06699159221854778,186.37331223487854,21.58553671836853,80.04613590240479,690,209,481,481,0,21,292000.0
292,292999,21.092653964093476,36.12566463802293,0.06780170357739412,187.03188395500183,21.652175903320312,80.16403293609619,698,210,488,488,0,21,293000.0
293,293999,21.106296631289233,36.15163911737097,0.06749530688047978,187.66001296043396,21.72317886352539,80.3437967300415,703,211,492,492,0,21,294000.0
294,294999,21.103074755593692,36.15486116560172,0.0671893405485845,188.30981588363647,21.79368305206299,80.47147464752197,718,212,506,506,0,21,295000.0
295,295999,21.10036051427824,36.151600004849996,0.06695469780275032,188.57841444015503,21.864916801452637,82.76830387115479,719,212,507,507,0,21,296000.0
296,296999,21.100201855584697,36.144327040047074,0.0668372856104078,188.98748016357422,21.935094118118286,84.45614719390869,719,212,507,507,0,21,297000.0
297,297999,21.09767289131114,36.129950162461505,0.06692856168436334,189.65139770507812,22.005768060684204,84.56234836578369,722,213,509,509,0,21,298000.0
298,298999,21.097050224025605,36.12231555852906,0.06692397553939067,189.9978048801422,22.545116662979126,86.21801853179932,736,214,522,522,0,21,299000.0
299,299999,21.096070046557067,36.109415244854944,0.06681233075114956,190.84042739868164,22.622034311294556,85.81018161773682,737,214,523,523,0,21,300000.0
300,300999,21.093596229804046,36.090894407263676,0.06665618364727754,191.45609617233276,22.69319486618042,86.40120792388916,737,214,523,523,0,21,301000.0
301,301999,21.09387684682039,36.08077214524706,0.06653661110244513,192.05861687660217,22.76421594619751,86.97345066070557,737,214,523,523,0,21,302000.0
302,302999,21.091923609070776,36.06514111205361,0.06642720491756904,192.7277386188507,22.834346294403076,86.99482822418213,739,215,524,524,0,21,303000.0
303,303999,21.087982260624674,36.046301951219675,0.06635209991922753,193.39435076713562,22.90708327293396,87.05310916900635,746,216,530,530,0,21,304000.0
304,304999,21.08814184424328,36.03747414264133,0.06637899417796955,194.03149795532227,22.977067708969116,87.07564640045166,748,217,531,531,0,21,305000.0
305,305999,21.08805135338648,36.02683598599314,0.06637318008611304,194.53657293319702,23.049017429351807,88.14802646636963,748,217,531,531,0,21,306000.0
306,306999,21.086136181624394,36.01012232786213,0.06659713755558194,195.18449330329895,23.11904525756836,88.18428897857666,762,218,544,544,0,21,307000.0
307,307999,21.089052535098343,36.00457300565788,0.0668137147442679,196.04600620269775,23.188049793243408,87.12994480133057,764,219,545,545,0,21,308000.0
308,308999,21.099635371904693,36.03242586608546,0.06732778382683413,197.16135358810425,23.26020860671997,87.26341342926025,766,220,546,546,0,21,309000.0
309,309999,21.113999740211305,36.0831201363568,0.06783541671722593,197.94878125190735,23.330641269683838,86.8845682144165,766,220,546,546,0,21,310000.0
310,310999,21.117462133925248,36.09648529405792,0.06810703050561173,198.32806277275085,23.40164566040039,88.46372318267822,766,220,546,546,0,21,311000.0
311,311999,21.119386620239272,36.11564609321395,0.06852754106723191,199.37793278694153,23.472450256347656,87.03162479400635,766,220,546,546,0,21,312000.0
312,312999,21.1125520079729,36.15317969503674,0.06831973644400191,199.64774012565613,23.538190603256226,89.42896366119385,784,220,564,564,0,21,313000.0
313,313999,21.103040785477866,36.15864670983587,0.0682061307174322,200.02587151527405,23.603936433792114,91.16928195953369,787,220,567,567,0,21,314000.0
314,314999,21.10941588355122,36.19515072819988,0.06826963958962162,200.4507486820221,23.674664974212646,92.1582727432251,791,222,569,569,0,21,315000.0
315,315999,21.108629487251886,36.217920867454936,0.06840012729188305,200.89179015159607,23.740060091018677,93.30452823638916,793,223,570,570,0,21,316000.0
316,316999,21.1106377856196,36.22817808823846,0.06902145386103731,201.42857885360718,23.81169867515564,93.85547733306885,797,225,572,572,0,21,317000.0
317,317999,21.106444905368924,36.23297795697904,0.06951664505708166,202.42488765716553,23.879644870758057,95.06634616851807,797,225,572,572,0,21,318000.0
318,318999,21.10784447805878,36.24925950703658,0.06985319743042162,203.26950073242188,23.94748020172119,93.69433689117432,803,228,575,575,0,21,319000.0
319,319999,21.108505504747566,36.2546229020817,0.0706084694079403,203.80422163009644,24.016093015670776,94.83420658111572,803,228,575,575,0,21,320000.0
320,320999,21.10863683785963,36.255120219568646,0.07092857231007677,204.62245440483093,24.085949182510376,93.91169834136963,807,230,577,577,0,21,321000.0
321,321999,21.10698197320932,36.24711526250307,0.0708879493127188,205.12916326522827,24.1543550491333,94.47173404693604,811,232,579,579,0,21,322000.0
322,322999,21.11081800880117,36.246746080310764,0.07088859515799051,205.65663862228394,24.224934339523315,95.5999231338501,811,232,579,579,0,21,323000.0
323,323999,21.115145652159033,36.28506524109557,0.07075772329163676,206.17457509040833,24.29310631752014,96.04721927642822,814,234,580,580,0,21,324000.0
324,324999,21.114083369578758,36.273595955217935,0.07095724587540175,206.7397334575653,24.362748384475708,96.56593418121338,816,235,581,581,0,21,325000.0
325,325999,21.109464610997335,36.257078184772105,0.07122755378598944,207.60446405410767,24.433151483535767,94.77444553375244,834,239,595,595,0,21,326000.0
326,326999,21.114691889073143,36.258633776675275,0.07137084007510264,208.26888394355774,24.50340723991394,94.3274393081665,838,241,597,597,0,21,327000.0
327,327999,21.114520775434986,36.25024540600169,0.07166395828194327,209.34953379631042,24.57300567626953,94.92412662506104,840,242,598,598,0,21,328000.0
328,328999,21.112851294053154,36.23998829406559,0.07191856943981156,210.25652027130127,24.643333911895752,93.38623142242432,845,244,601,601,0,21,329000.0
329,329999,21.102474183365175,36.21494336127313,0.07236742900067161,210.67250680923462,24.721593379974365,95.00784397125244,845,244,601,601,0,21,330000.0
330,330999,21.092353640677217,36.19192565935847,0.07241775720388455,211.2349934577942,24.790074348449707,95.48457431793213,847,245,602,602,0,21,331000.0
331,331999,21.092080254029558,36.20501285210453,0.07204724063182677,211.77974772453308,24.861366510391235,96.554856300354,866,246,620,620,0,21,332000.0
332,332999,21.078610095395003,36.182721825618025,0.0719615454488226,212.1523358821869,24.932013988494873,98.30799961090088,869,246,623,623,0,21,333000.0
333,333999,21.067281412831708,36.16089489490228,0.07204544201863972,212.38901376724243,25.004206895828247,100.63171482086182,885,247,638,638,0,21,334000.0
334,334999,21.05588973302914,36.1484614045925,0.07222908027904751,212.82999563217163,25.076600790023804,101.84292697906494,887,248,639,639,0,21,335000.0
335,335999,21.04503634057222,36.1320528973341,0.07237111323042944,213.35849165916443,25.149206399917603,102.16856479644775,894,251,643,643,0,21,336000.0
336,336999,21.04162113743125,36.137542686309935,0.07241799520964676,214.3566918373108,25.220619201660156,103.328293800354,896,252,644,644,0,21,337000.0
337,337999,21.033585720154367,36.11983987802666,0.07260216168386935,214.6514253616333,25.291056632995605,105.54026889801025,897,252,645,645,0,21,338000.0
338,338999,21.032141014051554,36.11407444992021,0.07271319410096377,215.26560854911804,25.36182427406311,106.15655612945557,897,252,645,645,0,21,339000.0
339,339999,21.02770737628255,36.09974032432744,0.07298901804203306,216.07402276992798,25.43304443359375,105.75166416168213,897,252,645,645,0,21,340000.0
340,340999,21.030039571069338,36.099189350758664,0.07320278465786934,216.8605728149414,25.503795385360718,105.15606021881104,899,253,646,646,0,21,341000.0
341,341999,21.037220516375534,36.10591274604627,0.07345517949333258,217.19779014587402,25.573235273361206,106.96189975738525,901,254,647,647,0,21,342000.0
342,342999,21.059248143943645,36.14482571766029,0.07374449064546484,217.8024983406067,25.643054485321045,107.55574131011963,901,254,647,647,0,21,343000.0
343,343999,21.076717085649676,36.169507399910486,0.07409954589928158,218.12362456321716,25.7175190448761,109.08503818511963,905,256,649,649,0,21,344000.0
344,344999,21.10291185426544,36.20747485235589,0.07476531956667054,219.14157438278198,25.789111852645874,107.09499454498291,909,258,651,651,0,21,345000.0
345,345999,21.127367627766247,36.24537240333172,0.07559325849061105,219.85594248771667,25.86030149459839,106.63363742828369,913,260,653,653,0,21,346000.0
346,346999,21.152936573408372,36.27788068090602,0.07652539685827453,220.3452913761139,25.931127786636353,107.79910373687744,913,260,653,653,0,21,347000.0
347,347999,21.190763094536386,36.34207804473831,0.07795795738957922,221.38979744911194,26.00337052345276,108.87591648101807,915,261,654,654,0,21,348000.0
348,348999,21.21400397414153,36.37162939106342,0.07889790960317267,222.10968041419983,26.081018924713135,109.16269779205322,915,261,654,654,0,21,349000.0
349,349999,21.244433342453487,36.409175409392105,0.0799489769269115,222.55949997901917,26.15019130706787,110.2326135635376,917,262,655,655,0,21,350000.0
350,350999,21.26285666039799,36.43301234506184,0.08046206624392649,223.48702692985535,26.22521686553955,108.72104740142822,921,264,657,657,0,21,351000.0
351,351999,21.26248607739331,36.42732954013484,0.08008488590733276,223.95360374450684,26.298768043518066,109.87349033355713,938,265,673,673,0,21,352000.0
352,352999,21.260058816182326,36.417201196752856,0.07960729792806642,224.44259405136108,26.365131616592407,110.4843225479126,962,267,695,695,0,21,353000.0
353,353999,21.252198001304215,36.399938466443224,0.07934413446922328,224.62383365631104,26.434239149093628,113.29326725006104,964,267,697,697,0,21,354000.0
354,354999,21.242986361831854,36.37739076443129,0.07916309015525824,225.18111753463745,26.502079963684082,113.93728733062744,966,268,698,698,0,21,355000.0
355,355999,21.245666324439796,36.37469026989039,0.07873716943645515,225.54099369049072,26.569509029388428,115.44189548492432,969,269,700,700,0,21,356000.0
356,356999,21.248741270197044,36.368660544854805,0.07854522602904757,226.26057171821594,26.637519121170044,115.01988315582275,973,271,702,702,0,21,357000.0
357,357999,21.250240746741355,36.35817300011676,0.07840327767912736,226.85985112190247,26.705440759658813,115.22097110748291,977,273,704,704,0,21,358000.0
358,358999,21.25159203059436,36.347532569881636,0.07813961083019039,227.4056749343872,27.398319482803345,116.27654361724854,977,273,704,704,0,21,359000.0
359,359999,21.25284641815489,36.337350694836786,0.07802269354797087,228.13075304031372,27.465909481048584,115.6393518447876,982,275,707,707,0,21,360000.0
360,360999,21.254785566829423,36.33127295206045,0.07800048068173315,228.60080695152283,27.533299922943115,116.67547702789307,984,276,708,708,0,21,361000.0
361,361999,21.256866341142214,36.32466802124654,0.07807426813091345,229.46828603744507,27.601505041122437,115.75705051422119,986,277,709,709,0,21,362000.0
362,362999,21.25486398066808,36.31221843104142,0.07816951524958415,229.90331411361694,27.674002647399902,117.41007328033447,986,277,709,709,0,21,363000.0
363,363999,21.2556688544965,36.30250196529498,0.07822037976720198,230.55910730361938,27.746338844299316,117.25379276275635,997,280,717,717,0,21,364000.0
364,364999,21.255925315151845,36.29322726101659,0.07812999262555531,231.16923475265503,27.816516637802124,117.83960819244385,997,280,717,717,0,21,365000.0
365,365999,21.25866179093246,36.285724791149825,0.07813089026217512,232.14263796806335,27.887629508972168,116.35635471343994,1000,281,719,719,0,21,366000.0
366,366999,21.265040310312497,36.283405290361486,0.07817717952390957,232.82027077674866,27.9571316242218,116.30882358551025,1003,282,721,721,0,21,367000.0
367,367999,21.271153065741753,36.28248290183044,0.07811359972767451,233.52987408638,28.02647829055786,115.88219547271729,1008,284,724,724,0,21,368000.0
368,368999,21.275463436675434,36.27759451481039,0.07802716590278314,233.98531770706177,28.094133615493774,116.947190284729,1010,285,725,725,0,21,369000.0
369,369999,21.277060877058435,36.26837120736187,0.07799381135922556,234.59905123710632,28.162681341171265,117.60524082183838,1010,285,725,725,0,21,370000.0
370,370999,21.28253358654233,36.26138253579404,0.0779437601275309,236.10365319252014,28.23094892501831,116.60785007476807,1013,286,727,727,0,21,371000.0
371,371999,21.27802316256814,36.24960977506036,0.07782901071425463,236.68475890159607,28.299800157546997,116.87493228912354,1027,288,739,739,0,21,372000.0
372,372999,21.267290006664393,36.25109851207223,0.07772388538305064,237.07228446006775,28.37475299835205,118.672776222229,1030,288,742,742,0,21,373000.0
373,373999,21.250407126009275,36.225137409497655,0.07785042135092535,237.64945936203003,28.442253351211548,119.3086404800415,1033,288,745,745,0,21,374000.0
374,374999,21.232029237421994,36.193424623235586,0.07794201941659495,238.25847864151,28.510207414627075,119.89733219146729,1033,288,745,745,0,21,375000.0
375,375999,21.215356185045213,36.167641279977836,0.07797603217381832,238.77492928504944,28.579575538635254,120.50159549713135,1050,290,760,760,0,21,376000.0
376,376999,21.199034651497385,36.15381807976224,0.07795317982420313,239.4984519481659,28.651221990585327,120.65901279449463,1050,290,760,760,0,21,377000.0
377,377999,21.182917566890684,36.13771720588026,0.0779802823098632,239.88392734527588,28.72047734260559,122.42967319488525,1051,290,761,761,0,21,378000.0
378,378999,21.16376583794538,36.106019373682976,0.07808931894081694,240.39166378974915,28.787776947021484,123.49629306793213,1051,290,761,761,0,21,379000.0
379,379999,21.14732488842987,36.07913876771062,0.07814739757613876,240.82615756988525,28.862146139144897,124.41126346588135,1056,292,764,764,0,21,380000.0
380,380999,21.13640216876738,36.067672110657114,0.07817491676240662,241.57073760032654,28.934791803359985,124.61213779449463,1056,292,764,764,0,21,381000.0
381,381999,21.120972522755707,36.04287397658184,0.07829320547878449,242.2707269191742,29.009024381637573,124.68721103668213,1058,293,765,765,0,21,382000.0
382,382999,21.111843795523008,36.047718364023176,0.07818033205547492,242.9738368988037,29.761678218841553,124.11755466461182,1064,296,768,768,0,21,383000.0
383,383999,21.100405179480035,36.02542519919281,0.07825025037312994,243.38980889320374,29.83518624305725,125.7757043838501,1064,296,768,768,0,21,384000.0
384,384999,21.088292318662237,36.00127662918692,0.07835104437341367,244.10309505462646,29.908875942230225,125.68908786773682,1067,297,770,770,0,21,385000.0
385,385999,21.074687201620243,35.97409496667475,0.07845611711618239,244.8520369529724,29.983290195465088,125.73472690582275,1067,297,770,770,0,21,386000.0
386,386999,21.060117878062506,35.94971235257121,0.07855310717673913,245.50116610527039,30.05773949623108,126.29056644439697,1067,297,770,770,0,21,387000.0
387,387999,21.04333633547585,35.922231846157594,0.07866492810604264,245.95941734313965,30.129767417907715,127.01822757720947,1072,299,773,773,0,21,388000.0
388,388999,21.048073310444426,35.958265958691314,0.0783965653184604,246.58490681648254,30.204158544540405,127.76289463043213,1085,299,786,786,0,21,389000.0
389,389999,21.053829973487304,35.961441726417604,0.07849391357579971,247.12243628501892,30.280175924301147,128.13521671295166,1093,301,792,792,0,21,390000.0
390,390999,21.05779316005305,35.95406926381178,0.07852137985650942,247.7498836517334,30.35704517364502,128.77851963043213,1094,301,793,793,0,21,391000.0
391,391999,21.06661076595545,35.96462869314218,0.07870413105470564,248.1815083026886,30.437622785568237,129.7807321548462,1097,303,794,794,0,22,392000.0
392,392999,21.081950602896587,35.99878634838319,0.07875578837739738,248.76701831817627,30.513848543167114,129.7949686050415,1103,306,797,797,0,22,393000.0
393,393999,21.102009856017204,36.046069203622785,0.0794591652891552,249.29303073883057,30.591747760772705,130.9459466934204,1103,306,797,797,0,22,394000.0
394,394999,21.128926259527148,36.103859143723845,0.0800855543248008,249.98866605758667,30.669015645980835,131.055344581604,1105,307,798,798,0,22,395000.0
395,395999,21.15383317635109,36.15833379181753,0.08060531120447267,250.64689302444458,31.444480419158936,131.6730432510376,1105,307,798,798,0,22,396000.0
396,396999,21.18260116663848,36.21777107101164,0.08131787955106873,251.12088918685913,31.52006959915161,132.5877389907837,1107,308,799,799,0,23,397000.0
397,397999,21.21554971250029,36.282330339936266,0.08339659252946086,251.90102910995483,31.595558881759644,131.54998111724854,1112,311,801,801,0,24,398000.0
398,398999,21.245161127905362,36.33104879825245,0.08489228140645644,252.56723594665527,31.670600414276123,131.59878635406494,1115,312,803,803,0,24,399000.0
399,399999,21.279813391358687,36.418076094484654,0.08611950325287032,253.13480520248413,31.748760223388672,132.26222324371338,1118,313,805,805,0,24,400000.0
400,400999,21.314199254782093,36.47746496650608,0.08730097503471113,253.99129843711853,31.82334566116333,130.8263635635376,1126,316,810,810,0,24,401000.0
401,401999,21.34949614796416,36.53325831054302,0.0889150874863357,254.46958422660828,31.89912748336792,131.9023675918579,1128,317,811,811,0,24,402000.0
402,402999,21.39123785977786,36.62171561378694,0.08993668869926652,255.0061638355255,31.973284006118774,132.31603336334229,1132,319,813,813,0,25,403000.0
403,403999,21.428424522586084,36.673156791587616,0.09208698481864097,255.69059205055237,32.051480770111084,132.44005680084229,1139,320,819,819,0,25,404000.0
404,404999,21.468117905454122,36.74193849602782,0.09371656892307423,256.1661367416382,32.134432315826416,133.61160373687744,1140,321,819,819,0,26,405000.0
405,405999,21.49985556464726,36.77547270825639,0.09490681953415625,256.69784927368164,32.21615386009216,134.716233253479,1140,321,819,819,0,26,406000.0
406,406999,21.520872298073044,36.79588973913247,0.09507787001128343,257.44703578948975,32.28959536552429,134.58703708648682,1161,322,839,839,0,26,407000.0
407,407999,21.52471005690786,36.813618149554934,0.0945539857294504,257.60425329208374,32.35689830780029,137.48056888580322,1165,322,843,843,0,26,408000.0
408,408999,21.52805147888583,36.843779435006496,0.09425560365055263,257.7793686389923,32.423330307006836,140.27442264556885,1168,322,846,846,0,26,409000.0
409,409999,21.530229365756817,36.85361418894112,0.0939250876677179,258.30327105522156,33.22917699813843,140.26966190338135,1177,326,851,851,0,26,410000.0
410,410999,21.53144554850181,36.85479889427743,0.09399152896579621,258.75623989105225,33.296969413757324,140.86686038970947,1183,329,854,854,0,26,411000.0
411,411999,21.531062451080025,36.854298844748385,0.09378563258284034,259.38352251052856,33.367037296295166,141.10350894927979,1187,331,856,856,0,26,412000.0
412,412999,21.52858512264493,36.84607152775139,0.09377898617530633,259.9954056739807,33.43608784675598,141.19031620025635,1191,333,858,858,0,26,413000.0
413,413999,21.52559251105243,36.83456077059046,0.09371655047510119,260.59446692466736,33.50447058677673,141.3492136001587,1195,335,860,860,0,26,414000.0
414,414999,21.526092313612263,36.82524690116118,0.09351657977761196,261.23109340667725,33.57170510292053,141.52237796783447,1198,336,862,862,0,26,415000.0
415,415999,21.525003828079896,36.81579862541594,0.09353007258705293,261.7494125366211,33.64309120178223,142.66719913482666,1198,336,862,862,0,26,416000.0
416,416999,21.52398567539717,36.81012904722971,0.09342666929985766,262.3644154071808,33.71161866188049,143.2649393081665,1198,336,862,862,0,26,417000.0
417,417999,21.522153373300544,36.79703624486277,0.09339058413913259,263.5158324241638,33.7821159362793,140.7812967300415,1205,338,867,867,0,26,418000.0
418,418999,21.521370729404698,36.78450376574628,0.0931909297253275,263.7075524330139,33.84888935089111,143.42661380767822,1205,338,867,867,0,26,419000.0
419,419999,21.52182321855345,36.77518774049018,0.09320471663278018,264.3755192756653,33.916043758392334,142.7753381729126,1211,341,870,870,0,26,420000.0
420,420999,21.522135875340062,36.80613747459533,0.09293493583618473,265.116250038147,33.9821617603302,142.29443454742432,1213,342,871,871,0,26,421000.0
421,421999,21.525979568256812,36.8252580443417,0.09269285128296867,265.611421585083,34.051777601242065,143.62574100494385,1213,342,871,871,0,26,422000.0
422,422999,21.52871658121644,36.82020669120608,0.09252393486611898,266.25638484954834,34.123249769210815,143.58361911773682,1217,344,873,873,0,26,423000.0
423,423999,21.525353903344197,36.80294963835172,0.09248066255526377,267.43186378479004,34.19317102432251,144.59826755523682,1221,346,875,875,0,26,424000.0
424,424999,21.52408896417193,36.78951390563241,0.09244324704314244,268.1923122406006,34.26088786125183,144.21788120269775,1223,347,876,876,0,26,425000.0
425,425999,21.521533713538574,36.77512566674764,0.09240994491505206,269.10825514793396,34.32977890968323,143.25212955474854,1223,347,876,876,0,26,426000.0
426,426999,21.513980701749265,36.75151325084917,0.09232741987043969,269.6695168018341,34.396188259124756,143.82457065582275,1225,348,877,877,0,26,427000.0
427,427999,21.497317542917838,36.72831367654756,0.09233872160998946,270.2003810405731,34.467692613601685,144.64206790924072,1238,349,889,889,0,26,428000.0
428,428999,21.477700441126785,36.69988849783678,0.09244206133046018,270.5278263092041,34.53437948226929,146.45022678375244,1256,350,906,906,0,26,429000.0
429,429999,21.46063083531878,36.67740944297009,0.09251503017701279,270.86116099357605,34.603864669799805,148.14501285552979,1258,351,907,907,0,26,430000.0
430,430999,21.440924478864225,36.6493675558048,0.09260341377127479,271.4066894054413,34.67191433906555,148.7932825088501,1260,352,908,908,0,26,431000.0
431,431999,21.423756473590807,36.621217628037336,0.0926638816472507,271.9981937408447,34.74018573760986,149.44300174713135,1260,352,908,908,0,26,432000.0
432,432999,21.4074071393379,36.60234008932724,0.09268197822492263,272.377729177475,34.81123471260071,151.3133020401001,1260,352,908,908,0,26,433000.0
433,433999,21.38718329383496,36.5723369799605,0.0927914267404617,272.771452665329,34.88194155693054,153.14065647125244,1261,352,909,909,0,26,434000.0
434,434999,21.369133170814806,36.544420033309365,0.09289373562160064,273.5886583328247,34.952149391174316,152.77472019195557,1261,352,909,909,0,26,435000.0
435,435999,21.350787004235958,36.51578813868619,0.0930151023535728,274.19126439094543,35.020291805267334,153.33442783355713,1261,352,909,909,0,26,436000.0
436,436999,21.333127695384555,36.48822462019415,0.09314384146970134,274.61258029937744,35.092506885528564,154.92976474761963,1261,352,909,909,0,26,437000.0
437,437999,21.31500900505422,36.462119650198964,0.0932507398797715,276.17642164230347,35.161823987960815,154.17388248443604,1265,354,911,911,0,26,438000.0
438,438999,21.29850271469527,36.4387536235263,0.09333725285851635,276.6729142665863,35.230262756347656,155.26194858551025,1265,354,911,911,0,26,439000.0
439,439999,21.28091778589967,36.41089390009853,0.0934880991583179,277.67367577552795,35.30130696296692,153.3108377456665,1269,356,913,913,0,26,440000.0
440,440999,21.26326337888856,36.38192508774889,0.09363216697769128,278.3452641963959,35.37672686576843,151.89114475250244,1281,362,919,919,0,26,441000.0
441,441999,21.244673661070365,36.35129898563723,0.09377680894467055,278.7216455936432,35.44843101501465,153.80167484283447,1281,362,919,919,0,26,442000.0
442,442999,21.229049951908227,36.326561343183215,0.09388380332456747,279.3269250392914,35.5191764831543,154.47295475006104,1281,362,919,919,0,26,443000.0
443,443999,21.210891635861472,36.29751322890044,0.09402297793063352,279.92460012435913,35.59090614318848,155.34668827056885,1281,362,919,919,0,26,444000.0
444,444999,21.192743232256735,36.269009369858814,0.09416727925022805,280.74337363243103,35.664122104644775,154.3016061782837,1285,364,921,921,0,26,445000.0
445,445999,21.176774175341905,36.24417774929224,0.09429852457053078,281.2245993614197,35.73626184463501,155.41660404205322,1288,365,923,923,0,26,446000.0
446,446999,21.1588284379394,36.215655356029984,0.09446701657781065,282.00166487693787,35.80777549743652,155.50054264068604,1301,365,936,936,0,26,447000.0
447,447999,21.145183054942684,36.20318680814113,0.09441691231109117,282.26363921165466,35.8769166469574,157.93444919586182,1310,365,945,945,0,26,448000.0
448,448999,21.12547266690622,36.173117178734344,0.09456701450095406,282.4300000667572,35.94461393356323,160.73547458648682,1314,365,949,949,0,26,449000.0
449,449999,21.1075344246376,36.15397317622471,0.09464189802727152,282.78145122528076,36.01386308670044,162.40240573883057,1317,366,951,951,0,26,450000.0
450,450999,21.088991438110366,36.12891927375221,0.0947959587751308,283.38492798805237,36.083139419555664,162.57749271392822,1321,368,953,953,0,26,451000.0
451,451999,21.071836939137583,36.10099393032458,0.09496063975279945,284.0242154598236,36.15890717506409,163.0414514541626,1323,369,954,954,0,26,452000.0
452,452999,21.053761919034887,36.07813182549535,0.09505012634846977,284.46277141571045,36.22953486442566,164.27854251861572,1325,370,955,955,0,26,453000.0
453,453999,21.03428142847564,36.05119296506814,0.09519640682170849,284.86973881721497,37.15727996826172,165.32510471343994,1329,372,957,957,0,26,454000.0
454,454999,21.017130986139133,36.02597558828554,0.09531963157212575,285.2456912994385,37.22970104217529,166.93301486968994,1331,373,958,958,0,26,455000.0
455,455999,20.997969138838286,36.00060088520659,0.09546220992289056,286.27729058265686,37.30070495605469,164.60655307769775,1337,376,961,961,0,26,456000.0
456,456999,20.978510456673117,35.974190786814205,0.09558935651711997,286.7729694843292,37.37096309661865,165.82440280914307,1337,376,961,961,0,26,457000.0
457,457999,20.961607878255307,35.95887259327713,0.0956074014376348,287.40150570869446,37.438841342926025,166.17115879058838,1339,377,962,962,0,26,458000.0
458,458999,20.942242515896744,35.928627702976016,0.09575390893070379,287.88941502571106,37.506145000457764,167.27908420562744,1339,377,962,962,0,26,459000.0
459,459999,20.925977115584548,35.90738048486518,0.09577583062440076,288.22797989845276,37.57358503341675,168.88904666900635,1341,378,963,963,0,26,460000.0
460,460999,20.910871825262333,35.88365945396662,0.09579485516487718,288.9588837623596,37.64196705818176,168.01332187652588,1346,380,966,966,0,26,461000.0
461,461999,20.896209720738593,35.85806159049252,0.09583647637922676,289.78089690208435,37.71473264694214,167.57883548736572,1346,380,966,966,0,26,462000.0
462,462999,20.8821699019699,35.83313406073281,0.09588396012093059,290.58640122413635,37.787598848342896,167.11344242095947,1348,381,967,967,0,26,463000.0
463,463999,20.869375184432474,35.81122998732617,0.09593834546915514,290.7784206867218,37.861292362213135,169.76597690582275,1348,381,967,967,0,26,464000.0
464,464999,20.856082423679414,35.78755625291481,0.09599582330073841,291.67530274391174,37.933791399002075,168.95599460601807,1366,382,984,984,0,26,465000.0
465,465999,20.845021423894956,35.76776882760395,0.09603014753199746,292.44597816467285,38.007731914520264,168.3091745376587,1371,384,987,987,0,26,466000.0
466,466999,20.82738559238199,35.739817410564946,0.09612886623095329,293.0584135055542,38.079537868499756,168.5296106338501,1377,386,991,991,0,26,467000.0
467,467999,20.80999142348524,35.713839732463015,0.09617527234406564,293.49883341789246,38.15371036529541,169.9692850112915,1396,387,1009,1009,0,26,468000.0
468,468999,20.794164901964,35.70253209627782,0.09618151288773147,293.86410784721375,38.23184609413147,171.79617404937744,1415,388,1027,1027,0,26,469000.0
469,469999,20.780344522359865,35.68074280870315,0.09620317283627755,294.2645390033722,39.22702074050903,173.5873498916626,1416,388,1028,1028,0,26,470000.0
470,470999,20.765642866100006,35.65691457689928,0.09629069944905544,294.62907314300537,39.300814151763916,175.27090549468994,1418,389,1029,1029,0,26,471000.0
471,471999,20.754733046740274,35.64953265987873,0.09628596490335828,295.3558452129364,39.37714910507202,174.98272800445557,1422,391,1031,1031,0,26,472000.0
472,472999,20.74170117143034,35.628393492374975,0.096333851754686,295.71300625801086,39.45089817047119,176.64450931549072,1425,392,1033,1033,0,26,473000.0
473,473999,20.728693060925238,35.612250920071396,0.09632655413153357,296.1300902366638,39.52441930770874,178.30196475982666,1425,392,1033,1033,0,26,474000.0
474,474999,20.719855449438814,35.615737892902956,0.09623101584265559,296.6194541454315,39.59875011444092,179.33679294586182,1428,393,1035,1035,0,26,475000.0
475,475999,20.711205492053242,35.605925688455386,0.09615271789510271,297.3322744369507,39.67487597465515,179.32613468170166,1430,394,1036,1036,0,26,476000.0
476,476999,20.702264880445643,35.59763791242236,0.09607407903570209,298.0089581012726,39.75066661834717,179.52227878570557,1432,395,1037,1037,0,26,477000.0
477,477999,20.69089268955392,35.57642702323677,0.09606332056243294,298.7685499191284,39.82695412635803,178.9993600845337,1436,397,1039,1039,0,26,478000.0
478,478999,20.681399352103732,35.56173523772023,0.09589230423610662,299.18985319137573,39.901472330093384,180.70672702789307,1436,397,1039,1039,0,26,479000.0
479,479999,20.672024373583252,35.542691768665094,0.09589077891254538,299.9059360027313,39.97648000717163,180.16419315338135,1442,400,1042,1042,0,26,480000.0
480,480999,20.662037680769046,35.52187026876017,0.09585797198030488,300.4397523403168,40.05113172531128,180.59863376617432,1445,402,1043,1043,0,26,481000.0
481,481999,20.65590133033939,35.509264910496235,0.09578755672274031,301.055148601532,40.12615156173706,180.91519260406494,1448,404,1044,1044,0,26,482000.0
482,482999,20.649822768731205,35.49428785244139,0.09575510596602221,301.5761568546295,40.20056748390198,182.07801914215088,1449,404,1045,1045,0,26,483000.0
483,483999,20.644564555691886,35.48225285123398,0.09569244280487321,302.3105137348175,40.276451587677,182.19870853424072,1449,404,1045,1045,0,26,484000.0
484,484999,20.63884146123553,35.46858576542277,0.09567921979544047,303.27314829826355,40.35252261161804,180.68800449371338,1453,406,1047,1047,0,26,485000.0
485,485999,20.6349735514879,35.45704509038137,0.09558429661469625,303.64038038253784,40.42754817008972,182.30349826812744,1455,407,1048,1048,0,26,486000.0
486,486999,20.63033521392281,35.444111204677256,0.09549855916689165,304.4504163265228,41.481116771698,182.28283786773682,1455,407,1048,1048,0,26,487000.0
487,487999,20.620108424441728,35.428212223513476,0.09534443487287692,304.73515343666077,41.55198955535889,184.66463565826416,1477,407,1070,1070,0,26,488000.0
488,488999,20.61339990626793,35.42857821015803,0.09508120708302759,304.9577057361603,41.6223361492157,186.95835971832275,1482,408,1074,1074,0,26,489000.0
489,489999,20.603143149034164,35.42020646770973,0.09497238656899853,305.2118937969208,41.695509910583496,189.21001529693604,1490,409,1081,1081,0,26,490000.0
490,490999,20.591066562691626,35.397327711586314,0.09502354606279229,305.93695402145386,41.7659809589386,188.83153629302979,1496,411,1085,1085,0,26,491000.0
491,491999,20.58336200394951,35.39613383133727,0.09493011805716922,306.5247323513031,41.83744502067566,188.9091501235962,1513,414,1099,1099,0,26,492000.0
492,492999,20.576647654645825,35.382581278523155,0.09487723362024736,307.107547044754,41.91052436828613,189.51069736480713,1515,415,1100,1100,0,26,493000.0
493,493999,20.568728732227207,35.36826092787935,0.09484397740788475,307.8542790412903,41.98363637924194,189.21228885650635,1519,417,1102,1102,0,26,494000.0
494,494999,20.56124324142026,35.35623330847689,0.09477968010750337,308.6488139629364,42.055010080337524,188.92036533355713,1526,418,1108,1108,0,26,495000.0
495,495999,20.552126184029735,35.33699242680735,0.09472633288845511,308.9687259197235,42.12803268432617,191.0694284439087,1526,418,1108,1108,0,26,496000.0
496,496999,20.545740958970963,35.32564103615163,0.09463965896557391,309.47432041168213,42.20010852813721,191.45193576812744,1532,421,1111,1111,0,26,497000.0
497,497999,20.541062533112587,35.31654593046403,0.0945508127057636,310.06510877609253,42.27194595336914,192.05748844146729,1534,422,1112,1112,0,26,498000.0
498,498999,20.53843340134389,35.30759784094912,0.09452631726116234,310.8593256473541,42.344627380371094,191.82971286773682,1536,423,1113,1113,0,26,499000.0
499,499999,20.5391751910837,35.31344221473937,0.09450941214502839,311.7805058956146,42.418272972106934,190.97398471832275,1540,424,1116,1116,0,26,500000.0
500,500999,20.537632123452195,35.30742507743732,0.09446445054304442,312.1812880039215,42.49119019508362,192.77451419830322,1540,424,1116,1116,0,26,501000.0
501,501999,20.54074475334203,35.314815966809334,0.09446051441049363,312.62037229537964,42.56838536262512,194.3658685684204,1540,424,1116,1116,0,26,502000.0
502,502999,20.551521008627727,35.33379383204165,0.09456123814129791,313.43598079681396,42.640002489089966,193.96095371246338,1542,425,1117,1117,0,26,503000.0
503,503999,20.557536602228396,35.37053479533134,0.0944447503621918,314.1919963359833,42.71568489074707,194.07478427886963,1542,425,1117,1117,0,26,504000.0
504,504999,20.56212512937915,35.377121265964085,0.09441993521466496,315.83352398872375,42.79202461242676,194.33016300201416,1548,427,1121,1121,0,26,505000.0
505,505999,20.56898010921476,35.38707125608994,0.09450413592543572,316.46587467193604,42.863770723342896,194.00610446929932,1554,430,1124,1124,0,26,506000.0
506,506999,20.57306396946882,35.42026813672948,0.0944181388027463,316.99639081954956,42.93832063674927,195.11193180084229,1554,430,1124,1124,0,26,507000.0
507,507999,20.572268320274667,35.41608077697933,0.09454317860999595,317.57803869247437,43.01413083076477,196.11348056793213,1554,430,1124,1124,0,26,508000.0
508,508999,20.56532588620418,35.42196794380736,0.09460980983823719,318.01048374176025,43.08600854873657,197.50302982330322,1572,431,1141,1141,0,26,509000.0
509,509999,20.555601053063942,35.40906123148429,0.0948943580442525,318.56124353408813,43.15642976760864,198.18328952789307,1583,432,1151,1151,0,26,510000.0
510,510999,20.545842641244253,35.40003714306834,0.09501148138626259,319.0795359611511,43.23032999038696,199.33794498443604,1585,432,1153,1153,0,26,511000.0
511,511999,20.537711842248314,35.386379435373755,0.09509690789671921,319.917010307312,43.30635643005371,199.03479862213135,1585,432,1153,1153,0,26,512000.0
512,512999,20.531390681442808,35.381332101216096,0.09525633329158256,320.4472301006317,43.378615617752075,200.1156930923462,1585,432,1153,1153,0,26,513000.0
513,513999,20.523631617177557,35.37007036432154,0.09524224260598901,321.0878384113312,43.45164680480957,200.10445499420166,1589,434,1155,1155,0,26,514000.0
514,514999,20.516566156851354,35.355615880148584,0.09531026276603471,321.58895778656006,43.52390480041504,201.05035495758057,1590,435,1155,1155,0,26,515000.0
515,515999,20.507188740319947,35.33935600660812,0.09527740637943571,322.20213747024536,43.59661602973938,201.26474857330322,1595,437,1158,1158,0,26,516000.0
516,516999,20.499548897022112,35.32685177659599,0.09538728983189881,322.5740180015564,43.67071294784546,202.40174198150635,1615,440,1175,1175,0,26,517000.0
517,517999,20.49169141412515,35.31264215549816,0.09542586903055661,322.85688614845276,43.744792222976685,204.85206699371338,1616,440,1176,1176,0,26,518000.0
518,518999,20.482449178442852,35.29712142960824,0.09564375059521724,323.46262311935425,43.82521986961365,205.62298679351807,1637,441,1196,1196,0,26,519000.0
519,519999,20.472660549642836,35.278534261381445,0.09574232007143957,324.0303249359131,43.90186285972595,206.35103702545166,1639,442,1197,1197,0,26,520000.0
520,520999,20.46840628897086,35.321698004822736,0.09546343416988556,324.73296880722046,43.97593712806702,206.4613733291626,1641,443,1198,1198,0,26,521000.0
521,521999,20.463670411845317,35.30925560558106,0.09558997289383286,325.5706424713135,44.0514075756073,206.15458011627197,1641,443,1198,1198,0,26,522000.0
522,522999,20.457413172120685,35.309901316689746,0.0955229284868877,325.87725591659546,44.12479829788208,208.3165521621704,1641,443,1198,1198,0,26,523000.0
523,523999,20.44635945834156,35.290566033491,0.09564684799734458,327.7126512527466,44.20228290557861,208.47069644927979,1641,443,1198,1198,0,26,524000.0
524,524999,20.436078565171936,35.270957289036595,0.09573142063255857,328.1984188556671,44.27768540382385,209.6239252090454,1643,444,1199,1199,0,26,525000.0
525,525999,20.456338122531488,35.321675099363894,0.09401029816821171,328.6049129962921,44.35721755027771,210.85809421539307,1665,446,1219,1219,0,27,526000.0
526,526999,20.45042284293875,35.30911659593392,0.0937990344873948,329.00018978118896,44.4372353553772,212.68533420562744,1671,446,1225,1225,0,27,527000.0
527,527999,20.446388046205538,35.300995443817136,0.09357185854293115,329.3620207309723,44.51820087432861,214.28628635406494,1674,447,1227,1227,0,27,528000.0
528,528999,20.44011597908923,35.29169946256878,0.09335259819248087,329.8325300216675,44.59802174568176,215.43480777740479,1677,448,1229,1229,0,27,529000.0
529,529999,20.436873019653678,35.285911329759514,0.09309407569437389,330.55463123321533,44.68042302131653,215.24715518951416,1681,450,1231,1231,0,27,530000.0
530,530999,20.43408076024697,35.29000542929732,0.09280847763802536,331.20714831352234,44.76414632797241,215.34939670562744,1709,452,1257,1257,0,27,531000.0
531,531999,20.426713382058985,35.28246327216002,0.09264399300027393,331.7981388568878,44.846187114715576,215.93467044830322,1711,453,1258,1258,0,27,532000.0
532,532999,20.420396999043795,35.306503866677104,0.09232943349316447,332.28256940841675,44.92909836769104,217.00754642486572,1713,454,1259,1259,0,27,533000.0
533,533999,20.415534142814685,35.3050224888262,0.09213688344816784,332.7678656578064,45.01137971878052,218.0175256729126,1714,455,1259,1259,0,28,534000.0
534,534999,20.41048512598293,35.29131648584469,0.09205236377270132,333.2551670074463,45.095529317855835,219.1017770767212,1715,456,1259,1259,0,29,535000.0
535,535999,20.40620939004095,35.28821186405999,0.09197630850171024,334.0567581653595,45.18071103096008,218.32396793365479,1719,458,1261,1261,0,29,536000.0
536,536999,20.404588273803533,35.29076611969065,0.09187065113166937,334.70118260383606,45.26418495178223,218.92248630523682,1719,458,1261,1261,0,29,537000.0
537,537999,20.408421688099256,35.296131725484564,0.09186750071163285,335.41222047805786,45.348047494888306,218.9667444229126,1721,459,1262,1262,0,29,538000.0
538,538999,20.411547226345068,35.29829091632615,0.09195130786995542,336.0555679798126,45.43467569351196,219.64170169830322,1721,459,1262,1262,0,29,539000.0
539,539999,20.411476155039963,35.2968571727117,0.09197238071807401,336.6879127025604,45.517274618148804,220.36177921295166,1721,459,1262,1262,0,29,540000.0
540,540999,20.413968780051768,35.31709127127893,0.09201679380026784,337.2460582256317,45.6016731262207,220.85222721099854,1725,461,1264,1264,0,29,541000.0
541,541999,20.414783439249852,35.31127847967363,0.09199665160422088,338.20974230766296,45.68901205062866,219.37133884429932,1728,463,1265,1265,0,30,542000.0
542,542999,20.415238068058358,35.305608414137986,0.09206740986646522,338.66488456726074,45.77605223655701,220.65905857086182,1729,464,1265,1265,0,31,543000.0
543,543999,20.411538348062695,35.29341671242753,0.0920088615578134,339.30246138572693,45.8613646030426,221.28855228424072,1729,464,1265,1265,0,31,544000.0
544,544999,20.40960925811614,35.28792256942793,0.09176931279049794,340.80941939353943,45.937498807907104,223.25696659088135,1754,464,1290,1290,0,31,545000.0
545,545999,20.40040747108026,35.28509202244757,0.09166966154291345,340.974417924881,46.00600028038025,226.14481449127197,1759,464,1295,1295,0,31,546000.0
546,546999,20.390660608930922,35.26695094054205,0.09165223995562555,341.37875294685364,46.07527494430542,227.31335544586182,1766,466,1300,1300,0,31,547000.0
547,547999,20.382151779402935,35.26380277200234,0.09151077459606027,341.8256051540375,46.145482778549194,228.13616275787354,1773,469,1304,1304,0,31,548000.0
548,548999,20.373156122320683,35.248149643589,0.09145287522393286,342.1361083984375,46.21587014198303,229.80122470855713,1777,471,1306,1306,0,31,549000.0
549,549999,20.365892580821015,35.234805307249815,0.09136154532613505,342.9120852947235,46.286925077438354,229.06852054595947,1783,474,1309,1309,0,31,550000.0
550,550999,20.359226659676274,35.22000075314801,0.09132482948446663,343.37751746177673,46.35706305503845,229.61055850982666,1789,477,1312,1312,0,31,551000.0
551,551999,20.35736335474421,35.21443356812465,0.09120991338756224,343.71811294555664,46.428139448165894,231.01468753814697,1793,479,1314,1314,0,31,552000.0
552,552999,20.351812382290515,35.20194855548041,0.09113815563158356,344.51255536079407,46.500362396240234,230.59910678863525,1795,480,1315,1315,0,31,553000.0
553,553999,20.348544034786652,35.19073638590083,0.09115416640859964,344.9322271347046,46.57211232185364,232.27100467681885,1795,480,1315,1315,0,31,554000.0
554,554999,20.345691014616396,35.184017393151514,0.09115747771155447,345.21598505973816,46.64347767829895,234.21477603912354,1797,481,1316,1316,0,31,555000.0
555,555999,20.34195645878003,35.17380270892872,0.09120266577164593,346.27523279190063,46.71576237678528,232.19888401031494,1801,483,1318,1318,0,31,556000.0
556,556999,20.337694402294478,35.16202655031841,0.09128113666414617,346.6181004047394,46.78583383560181,234.01805973052979,1803,484,1319,1319,0,31,557000.0
557,557999,20.331501918927874,35.147998301437575,0.0914192979589682,347.42689180374146,46.85913276672363,233.4964838027954,1807,485,1322,1322,0,31,558000.0
558,558999,20.327926526634016,35.13901305744851,0.09153210659944366,348.1712877750397,46.93049216270447,233.5786828994751,1807,485,1322,1322,0,31,559000.0
559,559999,20.32376524193441,35.12895927032586,0.09162333822835333,348.42987632751465,46.99968671798706,235.66956424713135,1809,486,1323,1323,0,31,560000.0
560,560999,20.319576518962695,35.117509567306385,0.09179300234440468,349.0729706287384,47.07028794288635,235.69237613677979,1813,488,1325,1325,0,31,561000.0
561,561999,20.317973151946532,35.11187635778946,0.09199560276072172,349.82911109924316,47.14405703544617,235.14212894439697,1818,490,1328,1328,0,31,562000.0
562,562999,20.316495375382814,35.1042813576384,0.09209334733250951,351.05943846702576,47.215606689453125,232.642502784729,1820,491,1329,1329,0,31,563000.0
563,563999,20.31477200428713,35.09740369114428,0.0921671182808419,351.4727396965027,47.28537917137146,233.6862497329712,1841,493,1348,1348,0,31,564000.0
564,564999,20.30938195060459,35.08701776715523,0.092074448612122,351.7484886646271,47.35490655899048,236.16345310211182,1853,493,1360,1360,0,31,565000.0
565,565999,20.298295632833224,35.073727026296005,0.09202957624981045,353.39709520339966,47.428155183792114,237.40916538238525,1858,494,1364,1364,0,31,566000.0
566,566999,20.286468704294663,35.05715542798962,0.092063054152139,353.78341841697693,47.49974822998047,239.1714563369751,1863,494,1369,1369,0,31,567000.0
567,567999,20.27625843247062,35.04660223047824,0.09204155619877052,354.3007433414459,47.57384967803955,239.76300144195557,1880,496,1384,1384,0,31,568000.0
568,568999,20.263662359738518,35.026685724303995,0.09208285224444612,354.79730200767517,47.64497470855713,241.13719272613525,1880,496,1384,1384,0,31,569000.0
569,569999,20.252775818798003,35.00990521741342,0.09215585200989385,355.51673460006714,47.71806836128235,240.8856439590454,1884,498,1386,1386,0,31,570000.0
570,570999,20.239795729891917,34.989590164125204,0.09220407937106323,355.976380109787,47.78965783119202,241.99670505523682,1886,499,1387,1387,0,31,571000.0
571,571999,20.228713443403702,34.971810657684756,0.0922574738783789,356.50207591056824,47.862807273864746,243.18040561676025,1887,499,1388,1388,0,31,572000.0
572,572999,20.215985101352906,34.95225328480269,0.09230786585883322,357.01974391937256,47.93357300758362,244.2890329360962,1887,499,1388,1388,0,31,573000.0
573,573999,20.206773844539683,34.935900606435055,0.09231580554781615,357.4919099807739,48.00818967819214,245.45165348052979,1888,500,1388,1388,0,31,574000.0
574,574999,20.195724704249812,34.91643195819019,0.09233869008891171,358.17517614364624,48.08124113082886,245.50550937652588,1890,501,1389,1389,0,31,575000.0
575,575999,20.187851356947423,34.934877369932806,0.09215009418193443,358.86158514022827,48.156498670578,245.74170017242432,1892,502,1390,1390,0,31,576000.0
576,576999,20.175813001868462,34.91435039510867,0.09218280590396277,359.47144985198975,48.22991728782654,246.58492374420166,1892,502,1390,1390,0,31,577000.0
577,577999,20.167645903607173,34.89822127621678,0.09218252437158625,360.2689700126648,48.30420732498169,245.6790246963501,1896,504,1392,1392,0,31,578000.0
578,578999,20.157926390206054,34.88089682694787,0.092175052302507,360.6955349445343,48.377859354019165,247.28350925445557,1896,504,1392,1392,0,31,579000.0
579,579999,20.15090232651349,34.86773312131276,0.0921324063040374,361.38574504852295,48.45266389846802,246.94262790679932,1905,506,1399,1399,0,31,580000.0
580,580999,20.145433447516794,34.87401466424469,0.09200207352925582,362.19996643066406,48.52698636054993,246.45401096343994,1907,507,1400,1400,0,31,581000.0
581,581999,20.136542811834733,34.856337625656955,0.09204150919915066,362.75150656700134,48.60248517990112,246.85286045074463,1910,509,1401,1401,0,31,582000.0
582,582999,20.129237347504258,34.84064253925233,0.09206193718280875,363.3386535644531,48.679261922836304,247.40063571929932,1911,510,1401,1401,0,31,583000.0
583,583999,20.118902348736732,34.8231404117011,0.09211639254667503,363.86155796051025,48.75691103935242,248.53173923492432,1911,510,1401,1401,0,31,584000.0
584,584999,20.11236521751253,34.825378646138994,0.09203944216482363,364.62854170799255,48.83049702644348,248.44300174713135,1937,511,1426,1426,0,31,585000.0
585,585999,20.100698547637847,34.805068492328616,0.09203806056850339,365.0669333934784,48.9047634601593,249.78479862213135,1942,512,1430,1430,0,31,586000.0
586,586999,20.09057287118638,34.800748427227845,0.09202149494706857,365.35865688323975,48.976258993148804,252.1480188369751,1948,512,1436,1436,0,31,587000.0
587,587999,20.080430019732272,34.785811119189596,0.09202769997605931,365.7183699607849,49.04802107810974,253.85538578033447,1951,513,1438,1438,0,31,588000.0
588,588999,20.072169993751952,34.773869203125415,0.09197907196637367,367.5341737270355,49.12073636054993,253.94384860992432,1959,517,1442,1442,0,31,589000.0
589,589999,20.064548004847676,34.76126945295757,0.0919739572481052,367.99487566947937,49.193655014038086,254.7663278579712,1965,520,1445,1445,0,31,590000.0
590,590999,20.056927466689324,34.753752825776786,0.09196078371183347,368.46280312538147,49.26640605926514,255.93623447418213,1967,521,1446,1446,0,31,591000.0
591,591999,20.049263937861696,34.73809273926007,0.09197756125250423,369.26992654800415,49.34045648574829,254.90358066558838,1973,524,1449,1449,0,31,592000.0
592,592999,20.042077864099994,34.72417176106096,0.09200935215247374,369.69311237335205,49.41338920593262,256.6180200576782,1973,524,1449,1449,0,31,593000.0
593,593999,20.033927202315272,34.710400293647226,0.09207020589341963,370.37842416763306,49.48804807662964,256.83967685699463,1976,525,1451,1451,0,31,594000.0
594,594999,20.030514011414496,34.70915548557334,0.09201243452780927,371.0248816013336,49.56161069869995,257.4662027359009,1976,525,1451,1451,0,31,595000.0
595,595999,20.02660088147093,34.705246528366864,0.09191633819103584,371.83240962028503,49.63667440414429,257.01897525787354,1978,526,1452,1452,0,31,596000.0
596,596999,20.02316436872474,34.69499066213512,0.09190382919352247,372.21654891967773,49.71222758293152,258.48926639556885,1980,527,1453,1453,0,31,597000.0
597,597999,20.018981923150648,34.6856828701053,0.09187477124626087,372.8635003566742,49.78545117378235,258.53831577301025,1989,529,1460,1460,0,31,598000.0
598,598999,20.015207486828864,34.67530166996181,0.09182069007842619,373.6113588809967,49.85960912704468,258.6129541397095,1989,529,1460,1460,0,31,599000.0
599,599999,20.01413636251048,34.66842075441125,0.09180153975222294,374.1451344490051,49.93391823768616,259.69941806793213,1989,529,1460,1460,0,31,600000.0
600,600999,20.01118048854963,34.65892458168759,0.09180351199853964,374.76438331604004,50.005942821502686,260.41597080230713,1989,529,1460,1460,0,31,601000.0
601,601999,20.009635809575784,34.64978155599023,0.09174798344478341,375.7786269187927,50.081101179122925,258.979172706604,2014,530,1484,1484,0,31,602000.0
602,602999,20.0054133426897,34.63760268004306,0.09171956609399634,376.4418818950653,50.15534734725952,258.8190698623657,2018,532,1486,1486,0,31,603000.0
603,603999,20.001753322031657,34.633987460286185,0.09159897835929598,376.92423152923584,50.230711698532104,259.85818576812744,2020,533,1487,1487,0,31,604000.0
604,604999,19.996449238258272,34.622127922088524,0.09149441071930886,377.70101857185364,50.30587983131409,259.8284692764282,2031,534,1497,1497,0,31,605000.0
605,605999,19.98931273718387,34.60893288750167,0.09140145866828808,378.2669584751129,50.37101149559021,260.00418186187744,2059,537,1522,1522,0,31,606000.0
606,606999,19.98304177237642,34.59644814324065,0.09131564548740934,378.43174505233765,50.43546152114868,262.974892616272,2064,537,1527,1527,0,31,607000.0
607,607999,19.975793182720476,34.58408912159462,0.09126989862068013,378.73968029022217,50.4996919631958,264.6831521987915,2074,539,1535,1535,0,31,608000.0
608,608999,19.970707958396694,34.57333468836514,0.09119945130315721,379.39314365386963,50.565184116363525,265.06456089019775,2076,540,1536,1536,0,31,609000.0
609,609999,19.96636902276441,34.56198970761781,0.0911571057554258,379.77347207069397,50.62951421737671,267.0094385147095,2078,540,1538,1538,0,31,610000.0
610,610999,19.962806074835264,34.558733341362554,0.09107652155455781,380.13565135002136,50.69359016418457,268.6412134170532,2080,541,1539,1539,0,31,611000.0
611,611999,19.956816817711562,34.545711651064465,0.0910452496335078,381.08574509620667,50.76085376739502,267.14700412750244,2084,543,1541,1541,0,31,612000.0
612,612999,19.953228967666426,34.53873564068528,0.09096064221996591,382.85621786117554,50.82668209075928,268.80010318756104,2084,543,1541,1541,0,31,613000.0
613,613999,19.94833436570848,34.527524061131054,0.09091107842319901,383.6283428668976,50.89348745346069,268.76106357574463,2085,543,1542,1542,0,31,614000.0
614,614999,19.94741989430303,34.52376914803485,0.09083612873772617,384.30886030197144,50.959625482559204,268.9111566543579,2087,544,1543,1543,0,31,615000.0
615,615999,19.949315306186403,34.52260670436536,0.09076058006508525,384.7358479499817,51.02450680732727,270.5532922744751,2087,544,1543,1543,0,31,616000.0
616,616999,19.955403608280484,34.53006658543504,0.09070068776126639,385.70920157432556,51.09024477005005,269.3177881240845,2089,545,1544,1544,0,31,617000.0
617,617999,19.969089497180953,34.57701081949957,0.0905538753405275,386.19128370285034,51.15600109100342,270.4575128555298,2091,546,1545,1545,0,31,618000.0
618,618999,19.981282033468005,34.595515620178794,0.09053958576063448,386.7754580974579,51.22116708755493,271.01353549957275,2093,547,1546,1546,0,31,619000.0
619,619999,19.996915251601102,34.620270155938066,0.0905580673616776,387.41013383865356,51.286508083343506,271.0612573623657,2097,549,1548,1548,0,31,620000.0
620,620999,20.010267157192065,34.63469593708199,0.0907517655393304,388.00984144210815,51.353463888168335,271.6108560562134,2099,550,1549,1549,0,31,621000.0
621,621999,20.01950774141903,34.6414200591162,0.0908545996297564,388.5648136138916,51.41839575767517,271.8662118911743,2103,552,1551,1551,0,31,622000.0
622,622999,20.03213613983866,34.65437935605716,0.09099151527684146,389.2909677028656,51.48389029502869,272.00889682769775,2103,552,1551,1551,0,31,623000.0
623,623999,20.03957982509136,34.65452022542191,0.09105022277443764,389.9704008102417,51.551676750183105,272.16455936431885,2105,553,1552,1552,0,31,624000.0
624,624999,20.04311750691965,34.64863648256037,0.090817747596179,390.5687503814697,51.61648774147034,272.9782953262329,2117,553,1564,1564,0,31,625000.0
625,625999,20.04341156071847,34.6405129127953,0.09066973107558507,390.80825757980347,51.68288516998291,275.2577829360962,2129,554,1575,1575,0,31,626000.0
626,626999,20.04447139144812,34.63812511478603,0.0905081435177536,391.63991928100586,51.748953104019165,274.59393405914307,2132,555,1577,1577,0,31,627000.0
627,627999,20.044441679310037,34.632189716786236,0.09030699164552902,391.9993488788605,51.81369996070862,276.2433023452759,2134,556,1578,1578,0,31,628000.0
628,628999,20.04406092931558,34.631496531758394,0.0902027799476196,392.6697015762329,51.880619049072266,276.58826541900635,2136,557,1579,1579,0,31,629000.0
629,629999,20.04369712781531,34.622458773028775,0.09007757249046644,393.25445652008057,51.947277307510376,277.2469644546509,2138,558,1580,1580,0,31,630000.0
630,630999,20.042549990704135,34.61404772360024,0.09000049479274541,394.1222195625305,52.013264894485474,276.1942071914673,2142,560,1582,1582,0,31,631000.0
631,631999,20.043530939453273,34.637501969222775,0.08978454280878079,394.6566219329834,52.08037090301514,277.3112497329712,2142,560,1582,1582,0,31,632000.0
632,632999,20.04471007207193,34.63187300477493,0.08970077567482859,394.96414160728455,52.14499473571777,279.4208765029907,2142,560,1582,1582,0,31,633000.0
633,633999,20.04561476729924,34.63042661489911,0.08961207523282033,395.7921748161316,52.21356964111328,279.23655796051025,2143,560,1583,1583,0,31,634000.0
634,634999,20.046333499972,34.62342637696102,0.08959715324061457,396.51141691207886,52.280763149261475,279.0397424697876,2145,561,1584,1584,0,31,635000.0
635,635999,20.049030509987084,34.62025044269976,0.08956906374455309,397.2658851146698,52.34925842285156,278.5592966079712,2179,563,1616,1616,0,31,636000.0
636,636999,20.054377360346397,34.643877806911334,0.08947054946394739,397.74819016456604,52.41459393501282,279.58155155181885,2181,564,1617,1617,0,31,637000.0
637,637999,20.05711033608528,34.64027776757025,0.08942805202400506,398.88434886932373,52.480790853500366,277.5191659927368,2183,565,1618,1618,0,31,638000.0
638,638999,20.063089725961444,34.64080838903562,0.08948379447597843,400.7364504337311,52.54663372039795,279.0704050064087,2183,565,1618,1618,0,31,639000.0
639,639999,20.071357075792253,34.64914533161108,0.08948982728399102,401.1463508605957,52.612494707107544,280.66040897369385,2183,565,1618,1618,0,31,640000.0
640,640999,20.077864621528796,34.65234289366043,0.08953509361059697,401.91810154914856,52.67814874649048,280.037880897522,2187,567,1620,1620,0,31,641000.0
641,641999,20.08422673146974,34.6532702563744,0.089510454671347,402.4983720779419,52.744625091552734,280.6124505996704,2189,568,1621,1621,0,31,642000.0
642,642999,20.09365122563313,34.659105835087544,0.08955017497087003,403.08164501190186,52.81164336204529,281.16758823394775,2191,569,1622,1622,0,31,643000.0
643,643999,20.098749158083482,34.65570314967126,0.0895628151996225,403.84004521369934,52.8805615901947,281.16233921051025,2191,569,1622,1622,0,31,644000.0
644,644999,20.10221741000468,34.6515041316391,0.0893743248437956,404.55562233924866,52.947452783584595,281.39041233062744,2199,569,1630,1630,0,31,645000.0
645,645999,20.10581003361359,34.66194076997101,0.08913807414477026,405.16943287849426,53.01216268539429,282.0820245742798,2200,569,1631,1631,0,31,646000.0
646,646999,20.107464197158038,34.65681901489852,0.08902686305665752,405.73099088668823,53.08088231086731,282.461220741272,2207,571,1636,1636,0,31,647000.0
647,647999,20.106706764390992,34.65304273503539,0.08902418113280319,406.3305835723877,53.1472864151001,283.4030771255493,2207,571,1636,1636,0,31,648000.0
648,648999,20.10595623372219,34.64347587313518,0.08889733011231926,406.5916163921356,53.21186423301697,285.5212869644165,2210,572,1638,1638,0,31,649000.0
649,649999,20.106990056156437,34.63678180664911,0.08879235744862313,407.3007950782776,53.27794909477234,285.59744358062744,2212,573,1639,1639,0,31,650000.0
650,650999,20.108902648086566,34.630969758247545,0.08866274022247989,407.89545798301697,53.345218658447266,286.2357187271118,2214,574,1640,1640,0,31,651000.0
651,651999,20.109621931362202,34.62859488892866,0.08853948854367844,408.74957728385925,53.415164947509766,284.8488473892212,2220,577,1643,1643,0,31,652000.0
652,652999,20.111427892193483,34.632953793692735,0.08848941951724965,409.3777210712433,53.48112082481384,285.52847385406494,2220,577,1643,1643,0,31,653000.0
653,653999,20.11562333846118,34.63332443036959,0.08846439981664223,410.01408410072327,53.548829078674316,286.13477420806885,2220,577,1643,1643,0,31,654000.0
654,654999,20.119643691116774,34.63462864760008,0.08844439486830646,410.52591252326965,53.61484479904175,287.049355506897,2222,578,1644,1644,0,31,655000.0
655,655999,20.12276203063116,34.6303066323485,0.08839052896542321,411.2115604877472,53.68179774284363,287.1674509048462,2225,579,1646,1646,0,31,656000.0
656,656999,20.128214357595446,34.63332941191592,0.0884044941280383,412.16501116752625,53.748502016067505,286.27474308013916,2225,579,1646,1646,0,31,657000.0
657,657999,20.136883951159337,34.64463303928763,0.08840760664076885,413.1808567047119,53.815041303634644,284.73346042633057,2227,580,1647,1647,0,31,658000.0
658,658999,20.147827290779976,34.67502443905828,0.08821724584990331,413.59199237823486,53.88005876541138,286.3395929336548,2227,580,1647,1647,0,31,659000.0
659,659999,20.155328786622565,34.69472046080479,0.08806081246464958,414.1152858734131,53.94793725013733,287.40486240386963,2227,580,1647,1647,0,31,660000.0
660,660999,20.160445852262548,34.69409568501663,0.08791014766133476,414.75502729415894,54.01658797264099,287.899582862854,2227,580,1647,1647,0,31,661000.0
661,661999,20.161360831449592,34.69679086524663,0.08774980858168901,415.1391680240631,54.08248329162598,289.73472690582275,2238,580,1658,1658,0,31,662000.0
662,662999,20.163077351387912,34.703928863488656,0.08761249675940863,415.6425361633301,54.14926600456238,290.960732460022,2240,580,1660,1660,0,31,663000.0
663,663999,20.162078251748746,34.70618308070819,0.08747002528067271,416.11824893951416,54.21501970291138,292.0701913833618,2242,581,1661,1661,0,31,664000.0
664,664999,20.161474666282906,34.70227569506053,0.08734933442460113,416.58501172065735,54.2813458442688,293.19341373443604,2244,582,1662,1662,0,31,665000.0
665,665999,20.159863206592675,34.69270990517358,0.08731646464776677,418.6626787185669,54.3499071598053,293.7596826553345,2247,583,1664,1664,0,31,666000.0
666,666999,20.159539501772848,34.68760201026458,0.08719452084729984,419.3349630832672,54.41544795036316,293.93492221832275,2249,584,1665,1665,0,31,667000.0
667,667999,20.16015853199298,34.6871178977113,0.08707703148074153,419.8095464706421,54.4839506149292,295.00403690338135,2251,585,1666,1666,0,31,668000.0
668,668999,20.159869006235077,34.68037324887086,0.08703880614381487,420.23636531829834,54.550052642822266,296.5986108779907,2251,585,1666,1666,0,31,669000.0
669,669999,20.160964104146306,34.68518060328698,0.08689371234472454,420.8306407928467,54.617515563964844,297.1479425430298,2254,586,1668,1668,0,31,670000.0
670,670999,20.162274958479564,34.70140846861311,0.08674634146305826,421.76620221138,54.68433928489685,296.1034631729126,2269,587,1682,1682,0,31,671000.0
671,671999,20.16266594463024,34.695467877788516,0.0866940206504292,422.61228799819946,54.750195026397705,295.756386756897,2269,587,1682,1682,0,31,672000.0
672,672999,20.16352391850834,34.691548712077285,0.08657452491839357,423.1368443965912,54.82017707824707,296.8341073989868,2269,587,1682,1682,0,31,673000.0
673,673999,20.16216664959996,34.68457527970873,0.08650336664440916,423.6487503051758,54.88795280456543,297.90789127349854,2269,587,1682,1682,0,31,674000.0
674,674999,20.164484248821466,34.707251800876534,0.08632902338616288,424.49053859710693,54.954392433166504,297.4327325820923,2269,587,1682,1682,0,31,675000.0
675,675999,20.16538095782073,34.705145699928586,0.08629470177050946,425.3083391189575,55.02199339866638,296.2464380264282,2278,590,1688,1688,0,31,676000.0
676,676999,20.16670657439827,34.69932567546574,0.0862735972615003,426.1327774524689,55.08979916572571,296.177170753479,2278,590,1688,1688,0,31,677000.0
677,677999,20.17059122483467,34.70918917796995,0.08619681840535254,426.49430656433105,55.16019153594971,297.69448947906494,2280,591,1689,1689,0,31,678000.0
678,678999,20.171514656380054,34.70320431025615,0.08615910903285195,427.0075135231018,55.22623944282532,298.7812280654907,2280,591,1689,1689,0,31,679000.0
679,679999,20.17070184966594,34.69570637573924,0.08616296255803613,427.58224606513977,55.29508709907532,299.28931522369385,2284,592,1692,1692,0,31,680000.0
680,680999,20.173268243040432,34.69622233771589,0.0858928417512459,427.96829557418823,55.36391472816467,301.1325693130493,2294,592,1702,1702,0,31,681000.0
681,681999,20.17406242606697,34.69811218171036,0.08565408056798873,428.57066440582275,55.43007302284241,301.8954095840454,2295,592,1703,1703,0,31,682000.0
682,682999,20.174922809057023,34.69643679467236,0.08539494341710452,428.96723890304565,55.496042251586914,303.60150241851807,2298,592,1706,1706,0,31,683000.0
683,683999,20.176387707819384,34.69478205392076,0.08518792178560397,429.6037449836731,55.562843561172485,303.71223545074463,2302,594,1708,1708,0,31,684000.0
684,684999,20.17773806921244,34.69392623854299,0.08500883987257002,430.1314263343811,55.62803363800049,304.248459815979,2306,596,1710,1710,0,31,685000.0
685,685999,20.179975021291945,34.6913854871989,0.08491440901843827,430.82592129707336,55.69411087036133,303.75762271881104,2312,599,1713,1713,0,31,686000.0
686,686999,20.179084235609793,34.6823839056606,0.08485907731286424,431.18726348876953,55.759193420410156,305.32042026519775,2314,600,1714,1714,0,31,687000.0
687,687999,20.182451983792827,34.68887529472269,0.08473854478787435,431.98994183540344,55.82726335525513,304.9229669570923,2316,601,1715,1715,0,31,688000.0
688,688999,20.18631396093216,34.693269381757155,0.08470353161146638,432.7399923801422,55.89363217353821,304.99180698394775,2316,601,1715,1715,0,31,689000.0
689,689999,20.186836629873124,34.687321726854265,0.08466636694308705,433.21210408210754,55.96135950088501,306.0457010269165,2322,602,1720,1720,0,31,690000.0
690,690999,20.191322802712303,34.68723427710718,0.08475341582823248,433.73930263519287,56.02851605415344,307.13531589508057,2322,602,1720,1720,0,31,691000.0
691,691999,20.194739885182756,34.687278798251725,0.08468012143048542,434.4887492656708,56.09683442115784,307.1858911514282,2322,602,1720,1720,0,31,692000.0
692,692999,20.19838143978832,34.68544371634536,0.08469286092265438,435.39670062065125,56.164514780044556,306.15860080718994,2325,603,1722,1722,0,31,693000.0
693,693999,20.203005184818476,34.68638364505312,0.08464910369024226,437.6989378929138,56.231695890426636,306.20262241363525,2325,603,1722,1722,0,31,694000.0
694,694999,20.20909066934799,34.689224633819904,0.08466952553573348,438.2086548805237,56.29939913749695,307.2610788345337,2325,603,1722,1722,0,31,695000.0
695,695999,20.216510271706248,34.693262374668635,0.08473486205966174,438.5779836177826,56.365174531936646,308.8066339492798,2330,604,1726,1726,0,31,696000.0
696,696999,20.22383677740572,34.69671406048863,0.08476951187993764,439.207790851593,56.43257212638855,309.35635471343994,2330,604,1726,1726,0,31,697000.0
697,697999,20.22777887316534,34.69410445132532,0.08477046153201151,439.8372848033905,56.501163959503174,309.8950204849243,2330,604,1726,1726,0,31,698000.0
698,698999,20.234007640360005,34.69333621592137,0.08472141857306614,440.57301783561707,56.56997060775757,309.9143075942993,2330,604,1726,1726,0,31,699000.0
699,699999,20.237129423217194,34.689524667978326,0.08466167606100328,441.1713445186615,56.63946270942688,309.65875339508057,2340,607,1733,1733,0,31,700000.0
700,700999,20.237708616360123,34.68534216319228,0.08455967860638758,441.67099690437317,56.706456661224365,311.007119178772,2353,607,1746,1746,0,31,701000.0
701,701999,20.232229271842527,34.677086371689846,0.08451738408361498,441.94047474861145,56.77284836769104,313.38678073883057,2354,607,1747,1747,0,31,702000.0
702,702999,20.22657093219281,34.6691196908761,0.08451944270280287,442.5336022377014,56.84051299095154,314.2945947647095,2357,607,1750,1750,0,31,703000.0
703,703999,20.220669559276445,34.66549766270732,0.08452170779541446,442.95277523994446,56.907658100128174,315.4144525527954,2361,609,1752,1752,0,31,704000.0
704,704999,20.222599591306093,34.70553108020072,0.08445820746926203,443.66169691085815,56.97381901741028,314.90794467926025,2367,612,1755,1755,0,31,705000.0
705,705999,20.227471222096543,34.71572396229729,0.08456801319934915,444.42511653900146,57.04081583023071,314.50433444976807,2371,614,1757,1757,0,31,706000.0
706,706999,20.23572705013719,34.74058981935881,0.08474067789313733,445.17867708206177,57.11311388015747,313.9948740005493,2377,617,1760,1760,0,31,707000.0
707,707999,20.246523810637214,34.770071272087186,0.08520749071014144,445.54011821746826,57.179760694503784,315.63238620758057,2380,618,1762,1762,0,31,708000.0
708,708999,20.25793867248797,34.79905100187678,0.08552866862580577,446.0634412765503,57.24838089942932,316.7718439102173,2380,618,1762,1762,0,31,709000.0
709,709999,20.26916686673711,34.83582386038148,0.08573600836968132,446.5093574523926,57.31566071510315,317.8203134536743,2385,620,1765,1765,0,31,710000.0
710,710999,20.281935427347925,34.87169952303445,0.08629619642359565,447.3543565273285,57.38312125205994,316.53804111480713,2391,623,1768,1768,0,31,711000.0
711,711999,20.29347252465172,34.901956865256274,0.08656172448508603,447.6203935146332,57.452279806137085,318.6912622451782,2393,624,1769,1769,0,31,712000.0
712,712999,20.30409853202544,34.921165410435705,0.0869016492414737,448.41174840927124,57.52028799057007,318.3665475845337,2395,625,1770,1770,0,31,713000.0
713,713999,20.31405498900886,34.94056426865139,0.08729835867647173,449.0405833721161,57.589744567871094,318.97638416290283,2396,625,1771,1771,0,31,714000.0
714,714999,20.32443573212284,34.954084263367946,0.08766655880853313,449.6943271160126,57.65821623802185,318.45070362091064,2433,629,1804,1804,0,31,715000.0
715,715999,20.337398732012296,34.97725058559159,0.08771150259699023,450.36645698547363,57.72751021385193,318.6615343093872,2464,630,1834,1834,0,31,716000.0
716,716999,20.35005276312672,34.99492740272635,0.08790701643548282,450.6765058040619,57.796077251434326,320.7925157546997,2464,630,1834,1834,0,31,717000.0
717,717999,20.361660653169544,35.00896362144256,0.08812735522671977,451.59234070777893,57.863548040390015,319.79748249053955,2466,631,1835,1835,0,31,718000.0
718,718999,20.372403811221858,35.01911026584541,0.08830385519646111,452.23205375671387,57.93194580078125,320.3506212234497,2466,631,1835,1835,0,31,719000.0
719,719999,20.376965079551017,35.0201026631154,0.08804269864150682,452.7263264656067,57.99762749671936,321.7188310623169,2478,631,1847,1847,0,31,720000.0
720,720999,20.37870090337319,35.030633864484074,0.08786454879861338,452.99798917770386,58.0641565322876,324.0868272781372,2478,631,1847,1847,0,31,721000.0
721,721999,20.379079901591002,35.027228278322106,0.08775448126126795,453.35073351860046,58.12895107269287,325.7908296585083,2480,632,1848,1848,0,31,722000.0
722,722999,20.38035438198508,35.02960383580767,0.08760669945104671,455.3163061141968,58.19535040855408,327.45124530792236,2484,634,1850,1850,0,31,723000.0
723,723999,20.38201750336435,35.02872088795135,0.08751511576892168,456.02353620529175,58.26374697685242,327.4493227005005,2488,636,1852,1852,0,31,724000.0
724,724999,20.38269416049147,35.025163150885,0.08741091298085424,456.82865500450134,58.33108425140381,326.4641237258911,2494,639,1855,1855,0,31,725000.0
725,725999,20.383776619904474,35.021238937767585,0.08731413939098298,457.3524124622345,58.39775800704956,327.013783454895,2499,641,1858,1858,0,31,726000.0
726,726999,20.38457626992248,35.01489138324212,0.08724202199180187,457.66790080070496,58.46609306335449,329.1813631057739,2499,641,1858,1858,0,31,727000.0
727,727999,20.383186736924856,35.007579447995184,0.08716733368833629,458.3615474700928,58.53285098075867,329.1993455886841,2501,642,1859,1859,0,31,728000.0
728,728999,20.3830167223969,35.003296313837616,0.08709946782538147,458.8348972797394,58.6009316444397,329.8543519973755,2506,644,1862,1862,0,31,729000.0
729,729999,20.381967584229468,34.99799182864985,0.08702088812225883,459.6826493740082,58.668460845947266,329.4484910964966,2506,644,1862,1862,0,31,730000.0
730,730999,20.379392309855128,34.98859389606219,0.08698107372069663,460.64060831069946,58.735894441604614,328.5277147293091,2506,644,1862,1862,0,31,731000.0
731,731999,20.38050565478656,35.00936519917265,0.08680927680702433,461.2112560272217,58.8033664226532,329.0756502151489,2513,645,1868,1868,0,31,732000.0
732,732999,20.37850928257692,35.00218831826754,0.08676819151305959,461.51060676574707,58.86985802650452,331.19445514678955,2513,645,1868,1868,0,31,733000.0
733,733999,20.37817457362257,34.99406804937084,0.08673590443092627,462.11354422569275,58.93626546859741,331.9853792190552,2513,645,1868,1868,0,31,734000.0
734,734999,20.37597674423855,34.98301509027292,0.08676217452527546,462.8078773021698,59.004528522491455,332.03558826446533,2544,646,1898,1898,0,31,735000.0
735,735999,20.376912594056073,34.97841603432965,0.08678073275976927,463.54786109924316,59.07127499580383,332.0829744338989,2544,646,1898,1898,0,31,736000.0
736,736999,20.377228108882193,34.97158883032923,0.08677760091711995,464.2608172893524,59.139992475509644,331.85448932647705,2546,647,1899,1899,0,31,737000.0
737,737999,20.375247648351042,34.96260280437011,0.08678871329373739,464.8850076198578,59.20767903327942,332.42667865753174,2546,647,1899,1899,0,31,738000.0
738,738999,20.373993254529847,34.954470561690506,0.08669497818857375,465.2916705608368,59.275564193725586,334.00502490997314,2546,647,1899,1899,0,31,739000.0
739,739999,20.377011026863478,34.979856914032396,0.0864165301669062,465.5546531677246,59.34335112571716,336.50262928009033,2558,647,1911,1911,0,31,740000.0
740,740999,20.375554733066153,35.011359179531844,0.08621120289013973,465.82934069633484,59.409870862960815,338.8397035598755,2558,647,1911,1911,0,31,741000.0
741,741999,20.371315307702236,35.01699581572582,0.08613556064118255,466.19190406799316,59.47740912437439,340.5280656814575,2566,648,1918,1918,0,31,742000.0
742,742999,20.36811414520756,35.023121622573036,0.08627703293107392,466.9953188896179,59.544795513153076,339.5358781814575,2572,651,1921,1921,0,31,743000.0
743,743999,20.363730237603185,35.01658303055693,0.08632265086489499,467.85118412971497,59.61235475540161,339.0611391067505,2574,652,1922,1922,0,31,744000.0
744,744999,20.35902405681838,35.007881510926005,0.08612520765304565,468.45121717453003,59.67822313308716,339.426983833313,2578,654,1924,1924,0,31,745000.0
745,745999,20.35691903066284,35.01223238400907,0.08613269621312214,468.9147927761078,59.74370765686035,341.0385408401489,2579,654,1925,1925,0,31,746000.0
746,746999,20.352789247686324,35.00728598534061,0.08586694896298896,469.3930039405823,59.810521841049194,342.06969928741455,2581,655,1926,1926,0,31,747000.0
747,747999,20.350867966219624,35.01049025271588,0.0856109152466964,469.80958008766174,59.87811779975891,343.68620014190674,2581,655,1926,1926,0,31,748000.0
748,748999,20.345888145740037,35.005421828136,0.08551488811665686,470.31133794784546,59.94677734375,344.58034229278564,2584,656,1928,1928,0,31,749000.0
749,749999,20.34472937104268,35.00452174713415,0.08550430425191446,471.2538731098175,60.013511180877686,343.2774324417114,2586,657,1929,1929,0,31,750000.0
750,750999,20.342530989502762,35.00244190597836,0.08567956678392596,472.1315748691559,60.0824248790741,342.051495552063,2590,659,1931,1931,0,31,751000.0
751,751999,20.338098794464855,34.9927758005832,0.08566926487123894,472.6473331451416,60.14854860305786,343.19728565216064,2590,659,1931,1931,0,31,752000.0
752,752999,20.335578106045393,34.989101031840114,0.0854486987936447,473.30714559555054,60.21543884277344,343.36333179473877,2628,661,1967,1967,0,31,753000.0
753,753999,20.33570198527152,34.990794586964434,0.0853173297210561,475.7396500110626,60.281824588775635,343.6176652908325,2630,662,1968,1968,0,31,754000.0
754,754999,20.335393551758433,34.98896991584058,0.0852552080274549,476.50320625305176,60.35411739349365,343.66564655303955,2630,662,1968,1968,0,31,755000.0
755,755999,20.336467796827943,34.988930533201334,0.08516327456737305,477.0215747356415,60.42278456687927,344.75849628448486,2630,662,1968,1968,0,31,756000.0
756,756999,20.337964995555925,34.98875247955081,0.08503699122887554,477.6547648906708,60.4897141456604,345.3010606765747,2630,662,1968,1968,0,31,757000.0
757,757999,20.338489916934154,34.98707117545649,0.08498925797798618,478.38429498672485,60.557050704956055,345.3373918533325,2630,662,1968,1968,0,31,758000.0
758,758999,20.337212445266715,34.98279583311566,0.08489361145903718,478.8904333114624,60.62554883956909,346.47642993927,2630,662,1968,1968,0,31,759000.0
759,759999,20.337806138790576,34.982106053734995,0.08468605757248482,479.23405361175537,60.69529914855957,348.283429145813,2651,663,1988,1988,0,31,760000.0
760,760999,20.33346856333676,34.97697755567123,0.08458767296113523,479.78677916526794,60.76254057884216,349.1256456375122,2660,664,1996,1996,0,31,761000.0
761,761999,20.327108259058335,34.9646008919302,0.0845601167156369,480.181663274765,60.83023142814636,350.89482593536377,2660,664,1996,1996,0,31,762000.0
762,762999,20.322555995701812,34.97030976437085,0.08444226197840765,480.6393744945526,60.898133754730225,352.066143989563,2662,665,1997,1997,0,31,763000.0
763,763999,20.318140183884744,34.96653561519178,0.08434336662728814,481.1599383354187,60.96619153022766,353.2444658279419,2662,665,1997,1997,0,31,764000.0
764,764999,20.3132820795839,34.95948247086816,0.08427403353815,481.5879158973694,61.03479981422424,354.33556842803955,2666,667,1999,1999,0,31,765000.0
765,765999,20.310770796742347,34.956627748529854,0.08421014098876534,482.28361916542053,61.10286545753479,354.41308307647705,2671,669,2002,2002,0,31,766000.0
766,766999,20.30780020322167,34.954065156552076,0.08412330775523447,482.7558581829071,61.170456409454346,355.5007600784302,2673,670,2003,2003,0,31,767000.0
767,767999,20.305060592339878,34.950433969458715,0.08403841197082007,483.4986460208893,61.237910985946655,355.58378314971924,2673,670,2003,2003,0,31,768000.0
768,768999,20.301739706117278,34.94405399123541,0.08396431324682474,483.86209058761597,61.30494952201843,357.1707887649536,2675,671,2004,2004,0,31,769000.0
769,769999,20.301045628618787,34.94334585039578,0.0838658745590618,484.29521226882935,61.371659994125366,358.7960329055786,2676,671,2005,2005,0,31,770000.0
770,770999,20.30115354284353,34.941375017651815,0.08378284132596059,485.41509795188904,61.44045948982239,356.78027057647705,2684,672,2012,2012,0,31,771000.0
771,771999,20.300509610900598,34.944701914098246,0.08365703721415707,486.18672704696655,61.50997471809387,355.63923358917236,2690,675,2015,2015,0,31,772000.0
772,772999,20.299412611259726,34.9422636410795,0.08357355674244094,486.880007982254,61.577138900756836,355.73725605010986,2721,676,2045,2045,0,31,773000.0
773,773999,20.299785158616427,34.93992967809029,0.0835402484764749,487.191109418869,61.64580535888672,357.8364381790161,2721,676,2045,2045,0,31,774000.0
774,774999,20.30173480570701,34.94318532771275,0.08347297176886803,488.0287232398987,61.714226484298706,357.52409839630127,2721,676,2045,2045,0,31,775000.0
775,775999,20.303145343472444,34.94187811701178,0.0834537284766177,488.732013463974,61.783663749694824,357.5620241165161,2723,677,2046,2046,0,31,776000.0
776,776999,20.306522860438662,34.97082093732549,0.08327617497273698,489.10486364364624,61.850834369659424,359.13134479522705,2725,678,2047,2047,0,31,777000.0
777,777999,20.309022881399077,34.970456605676574,0.08321290121182401,489.9215278625488,61.9227499961853,358.53744983673096,2727,679,2048,2048,0,31,778000.0
778,778999,20.312001760447668,34.9720578739524,0.08319838369674504,490.76882886886597,61.99230217933655,358.08456897735596,2727,679,2048,2048,0,31,779000.0
779,779999,20.312314460487915,34.97502600848596,0.08309471149997483,491.35322737693787,62.058932065963745,358.59856128692627,2735,680,2055,2055,0,31,780000.0
780,780999,20.312409804413036,34.988392363510705,0.08276398990098655,491.7497115135193,62.12561750411987,359.9466142654419,2756,682,2074,2074,0,31,781000.0
781,781999,20.307465422076696,34.978453978833606,0.08267886328874618,492.1432819366455,62.19314384460449,361.77182483673096,2756,682,2074,2074,0,31,782000.0
782,782999,20.302069810570067,34.97278483782124,0.08258611610473376,492.39584517478943,62.26075553894043,363.9842805862427,2758,683,2075,2075,0,31,783000.0
783,783999,20.297125962778058,34.96631625412981,0.08248218361399262,493.14678478240967,62.32956647872925,363.6709566116333,2791,685,2106,2106,0,31,784000.0
784,784999,20.295047085694442,34.97443146157946,0.08231575670881797,493.6657078266144,62.3968722820282,364.85078144073486,2791,685,2106,2106,0,31,785000.0
785,785999,20.291808206761672,34.966731493461246,0.0822252289045573,494.42756628990173,62.465097427368164,364.78496265411377,2794,686,2108,2108,0,31,786000.0
786,786999,20.289136397559584,34.959368509568534,0.08214312597213591,497.0281240940094,62.53446102142334,364.2377977371216,2800,689,2111,2111,0,31,787000.0
787,787999,20.28671070472851,34.96947479023888,0.08199948340951535,497.42160820961,62.60215139389038,366.1118745803833,2800,689,2111,2111,0,31,788000.0
788,788999,20.28360374361952,34.982146841119324,0.08184386091730089,497.8589656352997,62.6702184677124,367.7305574417114,2800,689,2111,2111,0,31,789000.0
789,789999,20.279324035376284,34.974379112124495,0.0817746780813412,498.6845757961273,62.7373468875885,367.5431184768677,2800,689,2111,2111,0,31,790000.0
790,790999,20.276001876249165,34.96725221621474,0.08170970868028149,499.4071605205536,62.80451822280884,367.38141345977783,2803,690,2113,2113,0,31,791000.0
791,791999,20.273720005354836,34.96455645971313,0.08164250214230884,499.7153625488281,62.87184500694275,369.5257387161255,2803,690,2113,2113,0,31,792000.0
792,792999,20.270261214539637,34.95951178990717,0.08159982185695314,500.606036901474,62.94031810760498,368.7448625564575,2805,691,2114,2114,0,31,793000.0
793,793999,20.267712001831175,34.953504919425974,0.08156964950588363,501.29470467567444,63.00950336456299,368.75690174102783,2811,692,2119,2119,0,31,794000.0
794,794999,20.26252564047574,34.941358632686594,0.0815743728473941,501.81067061424255,63.0789954662323,369.8375520706177,2811,692,2119,2119,0,31,795000.0
795,795999,20.258850561489925,34.932333584520094,0.0815888952015813,502.3317403793335,63.14743447303772,371.0144395828247,2811,692,2119,2119,0,31,796000.0
796,796999,20.253226389839273,34.9197558530499,0.08159190722315501,503.03540658950806,63.21480369567871,370.9801912307739,2813,693,2120,2120,0,31,797000.0
797,797999,20.24755686698288,34.908305516478606,0.08157575716775844,503.63435792922974,63.281338691711426,371.9621858596802,2827,693,2134,2134,0,31,798000.0
798,798999,20.23896767841685,34.89263269606092,0.08161799915970924,503.91844940185547,63.34794497489929,374.30644702911377,2827,693,2134,2134,0,31,799000.0
799,799999,20.23235626051271,34.896130233907975,0.08153570366512064,504.2152614593506,63.41396403312683,376.53700733184814,2827,693,2134,2134,0,31,800000.0
800,800999,20.22602235985595,34.889438651610114,0.08152411791614633,504.71557450294495,63.482022762298584,377.85358905792236,2827,693,2134,2134,0,31,801000.0
801,801999,20.221633383165475,34.88792361796558,0.0814616900612335,505.4462833404541,63.54954290390015,377.69797229766846,2833,695,2138,2138,0,31,802000.0
802,802999,20.215176354060198,34.876190934904244,0.0814397481979452,506.14099979400635,63.61588191986084,377.80246448516846,2836,696,2140,2140,0,31,803000.0
803,803999,20.207636849266557,34.86321966740236,0.08143613915666081,506.677836894989,63.68193697929382,378.34940814971924,2840,698,2142,2142,0,31,804000.0
804,804999,20.201744359336402,34.85565397627704,0.08139266266936684,507.0300269126892,63.74891138076782,379.75226306915283,2844,700,2144,2144,0,31,805000.0
805,805999,20.197258425724495,34.84781201648708,0.08131571747624378,507.8398766517639,63.81856393814087,379.311505317688,2846,701,2145,2145,0,31,806000.0
806,806999,20.193014039981634,34.8422500266633,0.08124885120832859,508.66515374183655,63.887184619903564,378.625714302063,2848,702,2146,2146,0,31,807000.0
807,807999,20.190234883733268,34.85201315858254,0.08110666894645013,508.9329333305359,63.95526695251465,380.7613191604614,2850,703,2147,2147,0,31,808000.0
808,808999,20.18556020903659,34.845531289975156,0.08103086411698901,509.56437492370605,64.02336502075195,381.45354175567627,2850,703,2147,2147,0,31,809000.0
809,809999,20.181321814247717,34.83914787695614,0.08098188796499428,510.5294544696808,64.09143114089966,380.0888719558716,2883,705,2178,2178,0,31,810000.0
810,810999,20.17702460405319,34.835145012803636,0.0808988560322269,510.88996601104736,64.16002154350281,382.27592182159424,2883,705,2178,2178,0,31,811000.0
811,811999,20.174387282655665,34.831146425813344,0.08081511017881648,511.56577825546265,64.22923755645752,382.4938020706177,2885,706,2179,2179,0,31,812000.0
812,812999,20.170316740679283,34.82342916955066,0.08076314547385877,512.2081401348114,64.29850935935974,383.0721712112427,2885,706,2179,2179,0,31,813000.0
813,813999,20.168218994543327,34.81903518104369,0.08069796631243753,512.9399399757385,64.36692428588867,382.8397798538208,2887,707,2180,2180,0,31,814000.0
814,814999,20.165066975394858,34.811027514324735,0.08064831165760988,514.0186364650726,64.43612217903137,381.31058979034424,2887,707,2180,2180,0,31,815000.0
815,815999,20.160135030292377,34.80011658918277,0.08061013449428422,514.7058737277985,64.50625944137573,381.31252002716064,2889,708,2181,2181,0,31,816000.0
816,816999,20.164053746722953,34.82873232211438,0.07963172148755471,514.9866716861725,64.57268595695496,383.70233631134033,2901,708,2193,2193,0,31,817000.0
817,817999,20.158049431730866,34.81677635789371,0.07958953294639914,515.4206771850586,64.64029121398926,384.8149766921997,2914,710,2204,2204,0,31,818000.0
818,818999,20.152501408898935,34.80677656057117,0.07959623526617932,515.721461057663,64.70607018470764,387.0882616043091,2914,710,2204,2204,0,31,819000.0
819,819999,20.14811894002112,34.79597054066339,0.07958888189076174,516.4640307426453,64.7738709449768,386.7182893753052,2918,712,2206,2206,0,31,820000.0
820,820999,20.145193391882646,34.79179402986371,0.07960416604759946,518.8124415874481,64.84125185012817,388.50227069854736,2920,713,2207,2207,0,31,821000.0
821,821999,20.143689100628176,34.78586845819165,0.0796207556944808,519.4518468379974,64.91012120246887,388.7313356399536,2924,715,2209,2209,0,31,822000.0
822,822999,20.14229161827092,34.780194870876926,0.07970087993236852,520.0787169933319,64.97918677330017,389.38505268096924,2925,715,2210,2210,0,31,823000.0
823,823999,20.14363668338402,34.778705594421304,0.07979423593940005,520.4534120559692,65.04550552368164,390.9785737991333,2927,716,2211,2211,0,31,824000.0
824,824999,20.14581787208955,34.78971448454658,0.07975836625186572,520.9831082820892,65.11301684379578,392.0804109573364,2927,716,2211,2211,0,31,825000.0
825,825999,20.14898409480171,34.79263394520235,0.07984197301722085,521.7244865894318,65.18105053901672,391.9736452102661,2938,717,2221,2221,0,31,826000.0
826,826999,20.15385989887546,34.80154620070555,0.08000590408876895,522.6864244937897,65.24998688697815,390.1451005935669,2946,721,2225,2225,0,31,827000.0
827,827999,20.156867322060396,34.80465039724093,0.08003111176085043,523.4980745315552,65.3174467086792,389.72074604034424,2948,722,2226,2226,0,31,828000.0
828,828999,20.161037164598845,34.805946611715534,0.08013959619513478,524.136646270752,65.38458609580994,390.3100938796997,2948,722,2226,2226,0,31,829000.0
829,829999,20.165092545102283,34.81198790163291,0.08025485970731105,524.7648637294769,65.45735740661621,390.2486162185669,2954,725,2229,2229,0,31,830000.0
830,830999,20.17046131206653,34.818969931760144,0.08041453881168181,525.1807944774628,65.52672410011292,391.8724489212036,2954,725,2229,2229,0,31,831000.0
831,831999,20.175485727385453,34.82348658348014,0.08049285936359185,525.7465298175812,65.59574508666992,392.6333818435669,2956,726,2230,2230,0,31,832000.0
832,832999,20.182109024557118,34.83168047968121,0.08062772919491923,526.4985785484314,65.66389679908752,392.69281482696533,2956,726,2230,2230,0,31,833000.0
833,833999,20.189419012516623,34.83886533668413,0.08078255550939106,527.197014093399,65.7316107749939,392.7133913040161,2958,727,2231,2231,0,31,834000.0
834,834999,20.192248227649667,34.8379139977084,0.08094092600718339,528.177369594574,65.80289959907532,391.73164081573486,2958,727,2231,2231,0,31,835000.0
835,835999,20.19319416384862,34.83276067698742,0.08101569522631813,528.652774810791,65.87225079536438,392.7657136917114,2969,728,2241,2241,0,31,836000.0
836,836999,20.196722734796946,34.83946980675577,0.08038281367003985,529.2112936973572,65.93992590904236,393.55170154571533,2983,729,2254,2254,0,31,837000.0
837,837999,20.197668213280966,34.84624348959985,0.08022247377662972,529.5005967617035,66.00815320014954,395.8363313674927,2983,729,2254,2254,0,31,838000.0
838,838999,20.198663848043243,34.850736984278555,0.0800491009509744,530.1818976402283,66.0751724243164,395.9973268508911,2986,730,2256,2256,0,31,839000.0
839,839999,20.200330519160907,34.85308960940277,0.07993405785459562,530.4485268592834,66.14463424682617,398.57147693634033,2986,730,2256,2256,0,31,840000.0
840,840999,20.202594336401358,34.851856470352786,0.0799273188138977,531.027046918869,66.2127914428711,398.8053789138794,2992,733,2259,2259,0,31,841000.0
841,841999,20.205353472734977,34.85923127344114,0.07990915426581335,531.7811393737793,66.28100800514221,398.3361711502075,2996,735,2261,2261,0,31,842000.0
842,842999,20.208057431599364,34.866389815333356,0.07995757138390625,532.1457262039185,66.34956741333008,399.95184803009033,2999,736,2263,2263,0,31,843000.0
843,843999,20.21583496997993,34.89940858111135,0.07985294766484208,532.4704537391663,66.4168484210968,402.0990571975708,2999,736,2263,2263,0,31,844000.0
844,844999,20.223479379708564,34.92725518131981,0.08003124900522673,533.3008296489716,66.48520636558533,401.4419527053833,3001,737,2264,2264,0,31,845000.0
845,845999,20.236412214345116,34.97581906058841,0.0803648692333786,533.9834051132202,66.5528883934021,401.6547212600708,3003,738,2265,2265,0,31,846000.0
846,846999,20.248936064606028,35.026060316960155,0.08042543981591577,534.5988659858704,66.62274670600891,402.4760103225708,3003,738,2265,2265,0,31,847000.0
847,847999,20.264824087826394,35.07457788182423,0.08079686602003266,535.7762830257416,66.69441723823547,400.65119647979736,3003,738,2265,2265,0,31,848000.0
848,848999,20.278267698658702,35.109469860726115,0.08120034114196018,536.1415865421295,66.76539278030396,402.25866413116455,3005,739,2266,2266,0,31,849000.0
849,849999,20.2955209158983,35.1565697749852,0.08168686732089225,536.9150099754333,66.83298397064209,401.1664094924927,3013,743,2270,2270,0,31,850000.0
850,850999,20.31142695257166,35.20556743336157,0.08218106927907931,537.4310736656189,66.9003427028656,402.3660554885864,3013,743,2270,2270,0,31,851000.0
851,851999,20.32995799122296,35.25023971154552,0.08272735791513552,538.2330651283264,66.97033524513245,401.8520174026489,3015,744,2271,2271,0,31,852000.0
852,852999,20.34089501299185,35.26952551502617,0.08266397259037273,538.7009208202362,67.03700184822083,403.0839204788208,3029,745,2284,2284,0,31,853000.0
853,853999,20.358647049504643,35.35827897403485,0.08243188507553745,539.0863609313965,67.1070625782013,404.86349964141846,3030,745,2285,2285,0,31,854000.0
854,854999,20.383115755476407,35.46583389564569,0.08239636682692175,539.6911427974701,67.17278718948364,405.6486864089966,3031,745,2286,2286,0,31,855000.0
855,855999,20.403080153202552,35.541326011878446,0.08244928171049892,540.2200946807861,67.23913073539734,406.25082874298096,3035,747,2288,2288,0,31,856000.0
856,856999,20.424328735073438,35.614611928491215,0.082527307045548,542.8073208332062,67.30774211883545,406.740345954895,3041,750,2291,2291,0,31,857000.0
857,857999,20.440849022571843,35.66351658121649,0.08264488909536627,543.3137125968933,67.37524437904358,407.67364978790283,3075,752,2323,2323,0,31,858000.0
858,858999,20.458805435411314,35.70454478736665,0.08312423865199015,544.0507597923279,67.44579720497131,407.421612739563,3079,754,2325,2325,0,31,859000.0
859,859999,20.476472405317416,35.74625055853351,0.08329818183779536,544.4711172580719,67.51218891143799,409.05136585235596,3079,754,2325,2325,0,31,860000.0
860,860999,20.494622940477555,35.78263008850385,0.08353821196027766,544.8901069164276,67.58052015304565,410.67973041534424,3079,754,2325,2325,0,31,861000.0
861,861999,20.506623558946963,35.800944118295774,0.08353514596957712,545.6995232105255,67.65023159980774,410.23522663116455,3081,755,2326,2326,0,31,862000.0
862,862999,20.52249342365265,35.83328572010573,0.08372600580392364,546.3126153945923,67.71781015396118,409.67313861846924,3089,759,2330,2330,0,31,863000.0
863,863999,20.539586353408655,35.88866523836086,0.0836406714653658,547.0252449512482,67.78687787055969,409.8314332962036,3091,760,2331,2331,0,31,864000.0
864,864999,20.559817204672115,35.95040963145628,0.0840191595918085,547.6970725059509,67.85583186149597,410.05468463897705,3093,761,2332,2332,0,31,865000.0
865,865999,20.57749398701143,35.978115694274045,0.08406260022820766,548.1742084026337,67.92529559135437,411.13593769073486,3095,762,2333,2333,0,31,866000.0
866,866999,20.59694124446699,36.02214054846628,0.08433763454359977,548.8310601711273,67.99360680580139,411.15305042266846,3109,764,2345,2345,0,31,867000.0
867,867999,20.614285996202977,36.04428970113112,0.08468300017372021,549.6274695396423,68.06134510040283,410.1157121658325,3133,768,2365,2365,0,31,868000.0
868,868999,20.62884387233858,36.07045768918407,0.08457211189585656,550.3662369251251,68.13119077682495,409.9193391799927,3149,770,2379,2379,0,31,869000.0
869,869999,20.64376562684139,36.13278272149456,0.08414517360468676,550.8589828014374,68.19825959205627,411.2257661819458,3153,770,2383,2383,0,31,870000.0
870,870999,20.65442768478241,36.175948280187896,0.0841267763992346,551.2169876098633,68.26631832122803,412.9911470413208,3158,771,2387,2387,0,31,871000.0
871,871999,20.66555171012112,36.20270293236768,0.08428331185976867,551.5891075134277,68.33321523666382,414.7335023880005,3170,772,2398,2398,0,31,872000.0
872,872999,20.67898185865678,36.24113641915354,0.08432840347083637,552.1494235992432,68.40085911750793,414.7090768814087,3179,776,2403,2403,0,31,873000.0
873,873999,20.692737419185303,36.29230931765724,0.08489064151101555,552.52201795578,68.4710066318512,416.41561222076416,3182,777,2405,2405,0,31,874000.0
874,874999,20.703009569002404,36.318227232721085,0.08519303320622706,552.9899756908417,68.53760552406311,417.5986490249634,3185,778,2407,2407,0,31,875000.0
875,875999,20.71752100843898,36.36796766443814,0.08586289875580388,553.8088393211365,68.60490155220032,416.5237817764282,3191,781,2410,2410,0,31,876000.0
876,876999,20.73195838061442,36.40274707422872,0.08641870160516296,554.0196576118469,68.67253303527832,419.21697330474854,3191,781,2410,2410,0,31,877000.0
877,877999,20.75192229776894,36.474026303523445,0.08682010040546062,554.6650230884552,68.7407751083374,419.83565616607666,3191,781,2410,2410,0,31,878000.0
878,878999,20.771012790031726,36.52021743044057,0.08734548368599471,555.6302678585052,68.8102331161499,418.48975467681885,3195,783,2412,2412,0,31,879000.0
879,879999,20.786682347690114,36.552068510825485,0.0879833564645881,556.3699650764465,68.87789750099182,418.2478189468384,3199,785,2414,2414,0,31,880000.0
880,880999,20.80617533763464,36.59854015537942,0.08875208751942687,556.8975872993469,68.94465279579163,419.40609073638916,3199,785,2414,2414,0,31,881000.0
881,881999,20.823363188405775,36.63456650256799,0.0892020909347816,557.5294232368469,69.01298809051514,420.0144968032837,3199,785,2414,2414,0,31,882000.0
882,882999,20.844399212872784,36.68903453679898,0.09012547949423977,558.2606110572815,69.08155179023743,419.7475595474243,3203,787,2416,2416,0,31,883000.0
883,883999,20.862400334715,36.72431593060525,0.09076347884721325,558.5617172718048,69.14946961402893,421.90618228912354,3203,787,2416,2416,0,31,884000.0
884,884999,20.87799802994951,36.747776946816245,0.09135187575103132,559.3046116828918,69.21742582321167,421.653733253479,3231,789,2442,2442,0,31,885000.0
885,885999,20.894260133934207,36.77561472762876,0.09195767007905864,560.5135631561279,69.28578662872314,418.493447303772,3243,793,2450,2450,0,31,886000.0
886,886999,20.9136188941748,36.822607262212024,0.09259836420583478,561.0391235351562,69.35530924797058,419.60540103912354,3243,793,2450,2450,0,31,887000.0
887,887999,20.927279743901984,36.836697617552254,0.09308063041634795,561.6798496246338,69.42290735244751,420.13658237457275,3243,793,2450,2450,0,31,888000.0
888,888999,20.938356893281785,36.857967264601086,0.09317681502711794,562.073080778122,69.48990368843079,421.9720621109009,3259,793,2466,2466,0,31,889000.0
889,889999,20.937260764237806,36.86094079281933,0.09306567125531928,562.3589305877686,69.55696988105774,424.24978733062744,3263,793,2470,2470,0,31,890000.0
890,890999,20.940871089419208,36.88306290720509,0.09296673880892248,562.980489730835,69.62414264678955,424.9591226577759,3265,793,2472,2472,0,31,891000.0
891,891999,20.945173167026105,36.89468181165692,0.09287141980790381,563.3632574081421,69.69646739959717,426.60760593414307,3268,794,2474,2474,0,31,892000.0
892,892999,20.94823711061907,36.902560900991304,0.09274007558087671,563.8553795814514,69.76367664337158,427.0320520401001,3274,797,2477,2477,0,31,893000.0
893,893999,20.95178061232898,36.91055208640888,0.09267312105324832,564.2373113632202,69.8341383934021,428.1414499282837,3284,800,2484,2484,0,31,894000.0
894,894999,20.954169504485137,36.91430629945517,0.09260232266930302,567.4490780830383,69.90548181533813,426.1302423477173,3291,803,2488,2488,0,31,895000.0
895,895999,20.9584399265099,36.922352971820146,0.09258921278228083,568.0565919876099,69.97301006317139,426.936936378479,3292,803,2489,2489,0,31,896000.0
896,896999,20.96222776176132,36.928754775606755,0.09261750284403791,568.3629207611084,70.04030179977417,429.0903558731079,3292,803,2489,2489,0,31,897000.0
897,897999,20.969235408813322,36.9445630267129,0.09274208356135949,568.7450375556946,70.10974025726318,430.6339502334595,3294,804,2490,2490,0,31,898000.0
898,898999,20.977386536620703,36.9594189741468,0.09296527696791457,569.2455158233643,70.17750811576843,431.7197961807251,3296,805,2491,2491,0,31,899000.0
899,899999,20.982466671112057,36.96727174760845,0.09306628391581895,570.1366295814514,70.24655055999756,430.99565982818604,3298,806,2492,2492,0,31,900000.0
900,900999,20.990607329422836,36.978241823070654,0.09329169964744,570.8528888225555,70.31456327438354,430.5160303115845,3304,809,2495,2495,0,31,901000.0
901,901999,20.998790217247183,36.99103086554753,0.0934776060571667,571.2744476795197,70.38457417488098,432.171311378479,3304,809,2495,2495,0,31,902000.0
902,902999,21.010607518994252,37.01064667116555,0.0937597556339217,571.8783659934998,70.4532995223999,432.5557794570923,3306,810,2496,2496,0,31,903000.0
903,903999,21.02351460577618,37.033652888959494,0.09423571293113842,572.5526852607727,70.52249956130981,432.84719944000244,3319,811,2508,2508,0,31,904000.0
904,904999,21.03649105302139,37.05171718823918,0.09457877262794467,573.2726263999939,70.59129500389099,432.28601932525635,3325,814,2511,2511,0,31,905000.0
905,905999,21.048271694746678,37.06671586830198,0.0949494583279612,573.9073493480682,70.65952897071838,432.0633707046509,3331,817,2514,2514,0,31,906000.0
906,906999,21.06201038572767,37.090872235467145,0.0953499383791302,574.7268812656403,70.72798180580139,431.69902896881104,3333,818,2515,2515,0,31,907000.0
907,907999,21.077661848492802,37.11346706981228,0.09596556002647538,575.1429212093353,70.79518604278564,433.38259983062744,3333,818,2515,2515,0,31,908000.0
908,908999,21.08471621586507,37.11706384793014,0.09634999398489397,576.0725328922272,70.86316347122192,432.2029275894165,3335,819,2516,2516,0,31,909000.0
909,909999,21.088031391966542,37.13821664194491,0.0961224427316123,576.4803264141083,70.93124079704285,433.53929233551025,3357,821,2536,2536,0,31,910000.0
910,910999,21.08722562418945,37.13845136843028,0.09607396134106083,577.1651830673218,71.00037407875061,433.77017307281494,3362,822,2540,2540,0,31,911000.0
911,911999,21.089170579139385,37.14234077606626,0.09601823998525016,577.7459523677826,71.07032442092896,434.4106912612915,3366,823,2543,2543,0,31,912000.0
912,912999,21.09268488978209,37.15302017806088,0.09592878150267026,578.2139077186584,71.13708853721619,435.61477756500244,3368,824,2544,2544,0,31,913000.0
913,913999,21.092628632670067,37.15156369910505,0.09594293765129691,578.767107963562,71.2033760547638,436.12286472320557,3372,826,2546,2546,0,31,914000.0
914,914999,21.093469929325348,37.15211539209561,0.09594553594035615,579.2297673225403,71.27045249938965,437.45503330230713,3375,827,2548,2548,0,31,915000.0
915,915999,21.095535624576943,37.15298089791813,0.09592097377369568,579.940788269043,71.33901882171631,437.1135492324829,3435,830,2605,2605,0,31,916000.0
916,916999,21.09771739236997,37.16008328038106,0.09590345779357046,580.6482059955597,71.40612292289734,437.18484592437744,3437,831,2606,2606,0,31,917000.0
917,917999,21.10039778744849,37.16231086528142,0.09590391919370744,580.9812097549438,71.4748923778534,438.7893533706665,3446,833,2613,2613,0,31,918000.0
918,918999,21.107398734030927,37.200184549574125,0.09586282753095632,581.6466581821442,71.54307055473328,438.44000339508057,3452,836,2616,2616,0,31,919000.0
919,919999,21.110642180114787,37.200936848864266,0.09587709445795445,582.475592136383,71.61077952384949,437.7854700088501,3454,837,2617,2617,0,31,920000.0
920,920999,21.11497641797186,37.20481470172926,0.09587515084762332,582.9617593288422,71.68166756629944,438.89275455474854,3456,838,2618,2618,0,31,921000.0
921,921999,21.119892140101395,37.207715864561465,0.09588509908449017,583.6753821372986,71.75344133377075,438.0239725112915,3493,842,2651,2651,0,31,922000.0
922,922999,21.12600431306436,37.22007143620282,0.09598968258472296,584.2180950641632,71.82073283195496,438.5944986343384,3497,844,2653,2653,0,31,923000.0
923,923999,21.130542707935508,37.22186494969149,0.09605518459074669,584.8056898117065,71.88913416862488,439.20195865631104,3499,845,2654,2654,0,31,924000.0
924,924999,21.135300205675307,37.22570464576227,0.09610874123589297,585.2911648750305,71.95671844482422,440.25391483306885,3501,846,2655,2655,0,31,925000.0
925,925999,21.14138970714402,37.22971505001594,0.09620299668848631,586.1001422405243,72.02675557136536,439.7817850112915,3503,847,2656,2656,0,31,926000.0
926,926999,21.138840398660776,37.222344573671144,0.0961789603443649,586.382806301117,72.09477519989014,442.20797061920166,3523,847,2676,2676,0,31,927000.0
927,927999,21.135118171388285,37.21970232766493,0.09610359591079987,586.9851734638214,72.16261506080627,442.96868991851807,3526,847,2679,2679,0,31,928000.0
928,928999,21.13298173449314,37.216343637990576,0.0960045920403203,587.2572295665741,72.22940754890442,445.39544010162354,3528,847,2681,2681,0,31,929000.0
929,929999,21.12842756272415,37.206758941660055,0.09599255547144125,587.6551518440247,72.29600191116333,447.1599588394165,3528,847,2681,2681,0,31,930000.0
930,930999,21.125699650187027,37.199947736287065,0.09597281818625814,588.1989786624908,72.3635847568512,447.7353677749634,3533,849,2684,2684,0,31,931000.0
931,931999,21.121276968473314,37.19217618989634,0.09595235407591973,588.7091269493103,72.43150019645691,448.54351902008057,3539,851,2688,2688,0,31,932000.0
932,932999,21.11647978661161,37.18320272589866,0.095928320653202,589.3919863700867,72.49883246421814,449.1513910293579,3540,851,2689,2689,0,31,933000.0
933,933999,21.114741293996946,37.19770835465696,0.0957999205230069,592.3369495868683,72.56671452522278,449.6256265640259,3542,852,2690,2690,0,31,934000.0
934,934999,21.111377175073944,37.18826470605223,0.09575774428420758,592.881165266037,72.6342875957489,450.16018772125244,3546,854,2692,2692,0,31,935000.0
935,935999,21.109375923656046,37.185791234911264,0.0956823580349675,593.5128717422485,72.70217037200928,450.76838779449463,3546,854,2692,2692,0,31,936000.0
936,936999,21.105945108231683,37.17832997005311,0.09563852631366931,593.9993169307709,72.76960396766663,452.11180210113525,3548,855,2693,2693,0,31,937000.0
937,937999,21.106524410622903,37.17868791242942,0.09555968830131667,594.7205979824066,72.8442234992981,452.20337772369385,3550,856,2694,2694,0,31,938000.0
938,938999,21.106995202514007,37.18490057932849,0.09541056208765186,595.4451715946198,72.91481804847717,451.4953622817993,3556,859,2697,2697,0,31,939000.0
939,939999,21.109107140686476,37.18696157645917,0.09533690989923038,595.9552965164185,72.98229122161865,453.03147983551025,3556,859,2697,2697,0,31,940000.0
940,940999,21.111994712511034,37.192429606216905,0.09523382654248125,596.1587791442871,73.05024361610413,455.6725778579712,3556,859,2697,2697,0,31,941000.0
941,941999,21.112468797978188,37.19066069245988,0.09514610597855999,596.7332456111908,73.11861538887024,456.4441156387329,3558,860,2698,2698,0,31,942000.0
942,942999,21.11521013406952,37.19201231550796,0.09505310375148512,597.8576321601868,73.18916440010071,454.28457736968994,3563,862,2701,2701,0,31,943000.0
943,943999,21.115112277444567,37.18903021344397,0.09499544865742005,598.8124806880951,73.257315158844,453.3189630508423,3563,862,2701,2701,0,31,944000.0
944,944999,21.116087678969436,37.192655633131906,0.09490109922872247,599.1831812858582,73.32427644729614,454.8786401748657,3565,863,2702,2702,0,31,945000.0
945,945999,21.11649535309791,37.190322172087306,0.09482183148542178,599.6184120178223,73.3925416469574,456.53621768951416,3577,863,2714,2714,0,31,946000.0
946,946999,21.11670748299529,37.19974074748235,0.09458765309241657,599.9628028869629,73.4590756893158,458.32400608062744,3591,864,2727,2727,0,31,947000.0
947,947999,21.11145681882489,37.191216761092136,0.09455638331690186,600.4730563163757,73.52489948272705,459.56074619293213,3595,864,2731,2731,0,31,948000.0
948,948999,21.10624103688285,37.18151021314904,0.09451161699550314,600.8563015460968,73.59125232696533,460.65205478668213,3602,867,2735,2735,0,31,949000.0
949,949999,21.104063174271253,37.18093743180526,0.09441314369111453,601.1525986194611,73.65876531600952,462.92591190338135,3602,867,2735,2735,0,31,950000.0
950,950999,21.09979202535202,37.17316947351265,0.09436952342456228,601.9254333972931,73.72592496871948,462.7978525161743,3605,868,2737,2737,0,31,951000.0
951,951999,21.096226596158168,37.16467485174723,0.09429767320841864,602.4950175285339,73.79299449920654,463.5381555557251,3607,869,2738,2738,0,31,952000.0
952,952999,21.092716021657242,37.1572147062854,0.09422746354737788,603.0176794528961,73.85956358909607,464.23267459869385,3613,871,2742,2742,0,31,953000.0
953,953999,21.08929067585433,37.14912961791108,0.09416212008466829,603.770644903183,73.92737889289856,464.3436517715454,3613,871,2742,2742,0,31,954000.0
954,954999,21.08648854349277,37.14580537290623,0.09407135641707398,604.3051624298096,73.99734377861023,464.52204990386963,3633,874,2759,2759,0,31,955000.0
955,955999,21.084653418991984,37.140116183919325,0.09400324219184109,604.8570024967194,74.0661792755127,465.1236810684204,3637,876,2761,2761,0,31,956000.0
956,956999,21.083004971419697,37.13535968559082,0.09393121374350033,606.1021111011505,74.1381003856659,461.39385318756104,3650,882,2768,2768,0,31,957000.0
957,957999,21.082660146210376,37.13208735476502,0.093883216882234,606.4166276454926,74.20523571968079,463.5899362564087,3650,882,2768,2768,0,31,958000.0
958,958999,21.082042477288823,37.126933735473,0.09381440640833649,606.9016721248627,74.27608132362366,464.7108087539673,3652,883,2769,2769,0,31,959000.0
959,959999,21.084083102127252,37.12719310947761,0.09376369435779708,607.7943334579468,74.34743237495422,464.2179117202759,3652,883,2769,2769,0,31,960000.0
960,960999,21.087564047104056,37.13218375590519,0.09370721550436634,608.4293067455292,74.41533970832825,464.78913974761963,3652,883,2769,2769,0,31,961000.0
961,961999,21.08990247205732,37.13323556921386,0.09363459088312731,608.909464597702,74.4852089881897,465.8471689224243,3654,884,2770,2770,0,31,962000.0
962,962999,21.091530888597973,37.13113816068041,0.09363504759987717,609.6997876167297,74.5531485080719,465.5849084854126,3656,885,2771,2771,0,31,963000.0
963,963999,21.094464599291136,37.13066826721327,0.09363590566546465,610.2880821228027,74.62108254432678,466.11402225494385,3658,886,2772,2772,0,31,964000.0
964,964999,21.097831897613986,37.12952308803003,0.09361063097098865,611.0523865222931,74.6903944015503,465.58406925201416,3662,888,2774,2774,0,31,965000.0
965,965999,21.09740112125409,37.12280036339467,0.09362568008975525,611.6424114704132,74.75857639312744,466.14570713043213,3664,889,2775,2775,0,31,966000.0
966,966999,21.100392586218558,37.12855939517226,0.0933244690567967,611.9860043525696,74.82537770271301,467.92317295074463,3679,890,2789,2789,0,31,967000.0
967,967999,21.09792915887186,37.123682162940526,0.09306871295293162,612.156436920166,74.89159679412842,470.6908884048462,3682,890,2792,2792,0,31,968000.0
968,968999,21.09648721342923,37.119663730402756,0.09269544610061464,612.6213526725769,74.95955634117126,471.88226413726807,3687,891,2796,2796,0,31,969000.0
969,969999,21.094267186577316,37.11535621895264,0.09245205354798058,613.0287883281708,75.02567148208618,473.56480503082275,3688,891,2797,2797,0,31,970000.0
970,970999,21.091154748668867,37.1083392175765,0.09223531752346836,613.661598443985,75.09371781349182,473.36807346343994,3698,895,2803,2803,0,31,971000.0
971,971999,21.0868435465986,37.098335578559436,0.09209003936838933,614.1304268836975,75.1620614528656,474.5528268814087,3700,896,2804,2804,0,31,972000.0
972,972999,21.083546963175515,37.09080568833267,0.09186319334042159,614.7714533805847,75.23141479492188,474.5984582901001,3704,898,2806,2806,0,31,973000.0
973,973999,21.07979552272236,37.08235310583956,0.09172373524773636,615.4794237613678,75.30062937736511,475.0020914077759,3706,898,2808,2808,0,31,974000.0
974,974999,21.07634825619984,37.07350487798175,0.09155060677660554,616.0212082862854,75.37087082862854,475.5352487564087,3712,900,2812,2812,0,31,975000.0
975,975999,21.072537134223005,37.06472771386742,0.09139666138106595,619.1725206375122,75.44121766090393,475.29568576812744,3717,902,2815,2815,0,31,976000.0
976,976999,21.069361114887954,37.06059125460938,0.09127019841991879,619.8899092674255,75.50952291488647,475.57222080230713,3717,902,2815,2815,0,31,977000.0
977,977999,21.065174617284196,37.05055798170702,0.09116710690584673,620.8274142742157,75.57855606079102,474.82896518707275,3717,902,2815,2815,0,31,978000.0
978,978999,21.063159017862187,37.0675124873408,0.09093697363933984,621.4146077632904,75.64761328697205,475.42852878570557,3748,903,2845,2845,0,31,979000.0
979,979999,21.05959257976478,37.05944951403197,0.0908446518767565,621.8343567848206,75.71467661857605,477.0390100479126,3748,903,2845,2845,0,31,980000.0
980,980999,21.055491650234917,37.04964467193196,0.09077136690385834,622.3449363708496,75.78453183174133,477.935471534729,3750,904,2846,2846,0,31,981000.0
981,981999,21.05391801190507,37.04501609789114,0.0906889880842906,622.9315567016602,75.85165667533875,478.4910593032837,3752,905,2847,2847,0,31,982000.0
982,982999,21.05219470394009,37.03903256264622,0.09057017784681431,623.2386951446533,75.91842675209045,480.60513401031494,3752,905,2847,2847,0,31,983000.0
983,983999,21.04819034307811,37.029629349046296,0.09052926085801627,624.4105327129364,75.98793983459473,478.3283472061157,3756,907,2849,2849,0,31,984000.0
984,984999,21.04534975480017,37.02155046353118,0.09048047581354468,625.0453262329102,76.05713105201721,478.89495182037354,3756,907,2849,2849,0,31,985000.0
985,985999,21.04160061558624,37.012498729639354,0.09040939861385577,625.5708677768707,76.12600779533386,479.9630289077759,3756,907,2849,2849,0,31,986000.0
986,986999,21.037001357979612,37.00234106999989,0.09035954380155253,626.6058809757233,76.19497990608215,478.10456943511963,3789,910,2879,2879,0,31,987000.0
987,987999,21.039727215424577,37.01961258423218,0.09019992045345793,627.1836757659912,76.26266407966614,478.8618173599243,3815,912,2903,2903,0,31,988000.0
988,988999,21.046204001105103,37.05056099118828,0.09008077366032563,627.4683861732483,76.32907557487488,481.1833429336548,3817,912,2905,2905,0,31,989000.0
989,989999,21.056045755732008,37.10700160821615,0.08997925296105469,627.7713236808777,76.3954541683197,483.47154331207275,3819,912,2907,2907,0,31,990000.0
990,990999,21.05734663201667,37.10977714394129,0.09006052154854616,628.5303409099579,76.46546363830566,482.6561975479126,3828,916,2912,2912,0,31,991000.0
991,991999,21.060008284303304,37.11191682256267,0.09001028505723196,628.8792350292206,76.53609108924866,484.19668674468994,3832,918,2914,2914,0,31,992000.0
992,992999,21.06623758472732,37.123672714871674,0.089858146605313,629.5742182731628,76.6055896282196,483.2034921646118,3845,924,2921,2921,0,31,993000.0
993,993999,21.06978812665829,37.12837727492722,0.08971715318809725,629.8841888904572,76.67407011985779,485.46173191070557,3847,924,2923,2923,0,31,994000.0
994,994999,21.07222376574166,37.133529174192056,0.08966577291525657,630.6299004554749,76.74282217025757,485.24237155914307,3852,926,2926,2926,0,31,995000.0
995,995999,21.075154722728954,37.13626023900776,0.08957794990423629,631.2171411514282,76.81326508522034,485.8784189224243,3854,927,2927,2927,0,31,996000.0
996,996999,21.076892007051384,37.13804136409397,0.08950939267752323,631.6862103939056,76.88304448127747,487.1850519180298,3885,928,2957,2957,0,31,997000.0
997,997999,21.07913970976927,37.13663370121415,0.08940848926245526,632.5110709667206,76.95572280883789,486.81153202056885,3887,929,2958,2958,0,31,998000.0
998,998999,21.08101256726287,37.1385759464624,0.08931717956921659,633.0636892318726,77.02506136894226,487.3800210952759,3891,931,2960,2960,0,31,999000.0
999,999999,21.084677201232,37.14379316691634,0.08917740794573448,633.8383479118347,77.09537720680237,486.91331577301025,3896,933,2963,2963,0,31,1000000.0
1000,1000999,21.085717005788318,37.14199247722105,0.0890353117924404,634.476047039032,77.16466856002808,487.65837955474854,3896,933,2963,2963,0,31,1001000.0
1001,1001999,21.08857630595261,37.15243743999812,0.08889505232842165,634.9113984107971,77.2324743270874,488.74908542633057,3929,935,2994,2994,0,31,1002000.0
1002,1002999,21.09083653701637,37.15267902616715,0.08880036780780598,635.5107133388519,77.3020589351654,489.28486728668213,3931,936,2995,2995,0,31,1003000.0
1003,1003999,21.091852230687966,37.1499877519405,0.08873689118533801,636.3693079948425,77.37031030654907,488.5495386123657,3935,938,2997,2997,0,31,1004000.0
1004,1004999,21.094137288226253,37.14722235143978,0.08865470717192458,636.8911082744598,77.44167566299438,489.64329624176025,3935,938,2997,2997,0,31,1005000.0
1005,1005999,21.095712533490047,37.144719077741314,0.08852843638531949,637.3292319774628,77.51029419898987,490.7075662612915,3955,940,3015,3015,0,31,1006000.0
1006,1006999,21.097550475652397,37.14895697829926,0.08841658950358255,638.1580288410187,77.57864212989807,490.0523386001587,3957,941,3016,3016,0,31,1007000.0
1007,1007999,21.09699062406901,37.143972264226115,0.08830899126598946,638.5070140361786,77.64785289764404,491.97061252593994,3981,942,3039,3039,0,31,1008000.0
1008,1008999,21.094884352769686,37.1432372798128,0.08813403564338496,638.8887147903442,77.71411657333374,493.8254861831665,3986,942,3044,3044,0,31,1009000.0
1009,1009999,21.091089070891677,37.13767280179852,0.08805679593656845,639.2032322883606,77.78076219558716,495.5526132583618,3993,944,3049,3049,0,31,1010000.0
1010,1010999,21.087553862159464,37.132837474915696,0.08801024713211414,639.6306240558624,77.84810256958008,496.73291873931885,3998,946,3052,3052,0,31,1011000.0
1011,1011999,21.085000299532663,37.127512305818954,0.08795261451856606,640.0385270118713,77.91661643981934,498.0384912490845,4002,948,3054,3054,0,31,1012000.0
1012,1012999,21.081231556775325,37.12002302177881,0.08792694410992952,640.3728997707367,77.98316407203674,500.02066135406494,4004,949,3055,3055,0,31,1013000.0
1013,1013999,21.0782816272794,37.11302377427959,0.08789345374259283,641.0824604034424,78.05357575416565,499.5199365615845,4011,952,3059,3059,0,31,1014000.0
1014,1014999,21.075242885663478,37.10820901778588,0.08786519911375734,641.603048324585,78.12137341499329,500.3440408706665,4045,954,3091,3091,0,31,1015000.0
1015,1015999,21.071643850144177,37.10110715666975,0.08785606241124921,642.2989480495453,78.19129252433777,499.64260959625244,4068,958,3110,3110,0,31,1016000.0
1016,1016999,21.069680548999795,37.09634980845187,0.08785189428945006,642.8940980434418,78.26051878929138,500.2599878311157,4070,959,3111,3111,0,31,1017000.0
1017,1017999,21.070982539222793,37.09550927257738,0.08797138124037296,643.5174686908722,78.32898378372192,499.78650760650635,4078,963,3115,3115,0,31,1018000.0
1018,1018999,21.07365406436025,37.10010890005528,0.08802233617958655,644.2574350833893,78.39781904220581,500.0068597793579,4078,963,3115,3115,0,31,1019000.0
1019,1019999,21.075536597663515,37.10067019322782,0.08810886472364765,647.3387088775635,78.4673056602478,501.0144205093384,4082,965,3117,3117,0,31,1020000.0
1020,1020999,21.07711178658802,37.101253392846495,0.08815183176640473,647.9964673519135,78.53590369224548,501.1258707046509,4106,967,3139,3139,0,31,1021000.0
1021,1021999,21.081152696784603,37.10474083471306,0.08822297578773053,648.6082112789154,78.60574245452881,501.5448160171509,4108,968,3140,3140,0,31,1022000.0
1022,1022999,21.084898086041505,37.107657433910845,0.08829656454307355,649.1275277137756,78.67437148094177,502.76617527008057,4108,968,3140,3140,0,31,1023000.0
1023,1023999,21.088667225761903,37.107904665872546,0.08833553299837682,649.8952858448029,78.74395656585693,502.2634744644165,4112,970,3142,3142,0,31,1024000.0
1024,1024999,21.092074073238106,37.10766020272632,0.08834786823896679,650.4776930809021,78.81252551078796,502.93611240386963,4114,971,3143,3143,0,31,1025000.0
1025,1025999,21.09717646868193,37.11143609690808,0.08836995296005146,650.9739382266998,78.88068413734436,503.91648960113525,4116,972,3144,3144,0,31,1026000.0
1026,1026999,21.099582488449755,37.11056704264272,0.08837076011655398,651.722757101059,78.95009732246399,503.98347568511963,4116,972,3144,3144,0,31,1027000.0
1027,1027999,21.09955618933517,37.10567237805628,0.08837607154371951,652.630273103714,79.01891136169434,502.99041080474854,4118,973,3145,3145,0,31,1028000.0
1028,1028999,21.094140097920995,37.097895546116,0.08833484662602498,653.0074903964996,79.08854055404663,505.1150064468384,4147,973,3174,3174,0,31,1029000.0
1029,1029999,21.088870728076607,37.091551090845535,0.0883109716263486,653.3564326763153,79.15726804733276,506.9017572402954,4152,974,3178,3178,0,31,1030000.0
1030,1030999,21.083882736574278,37.08322278663263,0.08831192088252471,653.611095905304,79.22440004348755,509.1875925064087,4160,975,3185,3185,0,31,1031000.0
1031,1031999,21.07782117044542,37.072921437283334,0.08833728242983518,654.1459698677063,79.29355883598328,509.86399936676025,4164,977,3187,3187,0,31,1032000.0
1032,1032999,21.072252591434108,37.06421098609123,0.08831631330540479,654.5833373069763,79.36323404312134,510.9914255142212,4168,979,3189,3189,0,31,1033000.0
1033,1033999,21.067625010108067,37.0564034845416,0.08831465533647964,655.2623357772827,79.43203902244568,510.87201023101807,4174,982,3192,3192,0,31,1034000.0
1034,1034999,21.063081537387276,37.049370772579984,0.08828508648595401,655.6289029121399,79.4998049736023,512.5488595962524,4177,983,3194,3194,0,31,1035000.0
1035,1035999,21.05858576567404,37.04444241827629,0.0882380476166984,656.1668193340302,79.56991505622864,513.1418313980103,4182,985,3197,3197,0,31,1036000.0
1036,1036999,21.05486171093886,37.04055045353569,0.0881923552377134,656.5439472198486,79.63723349571228,514.7990808486938,4190,986,3204,3204,0,31,1037000.0
1037,1037999,21.052011402432385,37.034791956065526,0.0881427121239513,657.2693178653717,79.70785593986511,513.8351907730103,4200,991,3209,3209,0,31,1038000.0
1038,1038999,21.049888485503523,37.028383062755005,0.08811501319113901,657.7128658294678,79.7752456665039,514.9518899917603,4204,993,3211,3211,0,31,1039000.0
1039,1039999,21.047726543250757,37.02350982726609,0.08806710341312396,658.5407032966614,79.844158411026,514.8387537002563,4204,993,3211,3211,0,31,1040000.0
1040,1040999,21.047295293356772,37.02221311024722,0.0880173540630459,659.0298290252686,79.91220045089722,516.0364770889282,4206,994,3212,3212,0,31,1041000.0
1041,1041999,21.0462927726858,37.01799113515327,0.08794886149670222,659.337584733963,79.98025965690613,518.188042640686,4206,994,3212,3212,0,31,1042000.0
1042,1042999,21.04721391906993,37.01665418319058,0.0878966782476096,659.9344828128815,80.04896664619446,519.1174325942993,4206,994,3212,3212,0,31,1043000.0
1043,1043999,21.049587432144136,37.01838672347267,0.0878617091167373,660.6132555007935,80.11703538894653,519.3793573379517,4208,995,3213,3213,0,31,1044000.0
1044,1044999,21.05006703101275,37.0177308057909,0.0878340757381828,661.2053887844086,80.18608784675598,520.3693552017212,4208,995,3213,3213,0,31,1045000.0
1045,1045999,21.05178129801767,37.017828499472465,0.0877515655057658,661.9889588356018,80.25454378128052,520.1805658340454,4210,996,3214,3214,0,31,1046000.0
1046,1046999,21.054698116985634,37.0199286862599,0.08771896948698754,662.8155591487885,80.32438468933105,519.6175851821899,4212,997,3215,3215,0,31,1047000.0
1047,1047999,21.057291267837442,37.019722843211376,0.08766914965506856,663.5069334506989,80.39604806900024,519.2112588882446,4216,999,3217,3217,0,31,1048000.0
1048,1048999,21.055270105913692,37.01230514714331,0.08765550338755301,664.2031216621399,80.46337151527405,519.3867883682251,4218,1000,3218,3218,0,31,1049000.0
1049,1049999,21.053689874776435,37.010972076441405,0.08751397395350835,664.5054845809937,80.53042387962341,521.9506540298462,4247,1000,3247,3247,0,31,1050000.0
1050,1050999,21.05054208634337,37.00417083381137,0.08750254942818803,664.7503778934479,80.59622764587402,524.3675470352173,4255,1001,3254,3254,0,31,1051000.0
1051,1051999,21.044545404542948,36.99355739985286,0.0875162093175692,664.9415459632874,80.66281318664551,527.2399606704712,4257,1001,3256,3256,0,31,1052000.0
1052,1052999,21.041948242931454,36.986854441575154,0.08747013293467742,665.3301079273224,80.73180961608887,528.491250038147,4264,1004,3260,3260,0,31,1053000.0
1053,1053999,21.03756079260804,36.977764627452075,0.08746320738640967,665.82013463974,80.80020523071289,529.1205759048462,4270,1007,3263,3263,0,31,1054000.0
1054,1054999,21.03635661662137,36.979721934020326,0.08741323362007525,666.2607901096344,80.8681070804596,530.6090021133423,4274,1008,3266,3266,0,31,1055000.0
1055,1055999,21.036430029842084,36.98848780020682,0.08735538812147492,667.0599749088287,80.93726253509521,529.8233804702759,4309,1011,3298,3298,0,31,1056000.0
1056,1056999,21.037774347745746,37.00050012550216,0.08731685576143577,667.527016878128,81.00445938110352,531.1227960586548,4311,1012,3299,3299,0,31,1057000.0
1057,1057999,21.045259699488913,37.0528300123073,0.08731535182173622,668.1581690311432,81.07461261749268,531.3742151260376,4315,1014,3301,3301,0,31,1058000.0
1058,1058999,21.05029930301015,37.06553053738315,0.08733570292013615,668.9053771495819,81.14766049385071,530.7164163589478,4321,1017,3304,3304,0,31,1059000.0
1059,1059999,21.054612588375203,37.09235069580665,0.08732160100636677,669.270384311676,81.21537137031555,531.9779901504517,4325,1019,3306,3306,0,31,1060000.0
1060,1060999,21.05974779892361,37.1152431413198,0.0873774398140833,669.7333288192749,81.28310775756836,532.9998331069946,4358,1021,3337,3337,0,31,1061000.0
1061,1061999,21.069046523066124,37.149719326498015,0.08765469994900676,670.7401828765869,81.35514974594116,531.695122718811,4362,1023,3339,3339,0,31,1062000.0
1062,1062999,21.078015727503477,37.17498141365244,0.08783056309392667,671.0108850002289,81.42516732215881,533.8166284561157,4364,1024,3340,3340,0,31,1063000.0
1063,1063999,21.087815363971043,37.205278586086926,0.08783172142246742,671.551515340805,81.49262762069702,533.9940958023071,4370,1027,3343,3343,0,31,1064000.0
1064,1064999,21.092945879992193,37.21670576348143,0.08769631487981666,672.1507420539856,81.56202125549316,534.5735559463501,4392,1028,3364,3364,0,31,1065000.0
1065,1065999,21.09680604429415,37.23095026748376,0.08760660934203612,675.2921161651611,81.63051748275757,536.4510202407837,4400,1028,3372,3372,0,31,1066000.0
1066,1066999,21.10118467150785,37.24654298652,0.08751809079900996,675.6806569099426,81.69807291030884,538.332200050354,4403,1028,3375,3375,0,31,1067000.0
1067,1067999,21.105222845979565,37.2635695736001,0.0875212830482035,675.9379920959473,81.76615309715271,540.5470743179321,4406,1029,3377,3377,0,31,1068000.0
1068,1068999,21.10798143352407,37.26744630276677,0.08749104538658814,676.5242385864258,81.83437967300415,541.1963510513306,4409,1030,3379,3379,0,31,1069000.0
1069,1069999,21.112234570588885,37.280627707102916,0.08794416834725405,677.1877512931824,81.90453457832336,541.9087762832642,4411,1030,3381,3381,0,31,1070000.0
1070,1070999,21.116327229628748,37.29357238908098,0.0880178927398686,677.6011781692505,81.97227215766907,543.1421060562134,4415,1032,3383,3383,0,31,1071000.0
1071,1071999,21.119990509016613,37.29956488762478,0.08824752599155117,678.0981550216675,82.04114723205566,544.5264902114868,4415,1032,3383,3383,0,31,1072000.0
1072,1072999,21.124731104094796,37.30620184997278,0.0883795582182294,678.7154455184937,82.10924744606018,545.0497598648071,4417,1033,3384,3384,0,31,1073000.0
1073,1073999,21.132920544001514,37.33274587505366,0.08837411894862335,679.4391026496887,82.17695045471191,544.5411310195923,4424,1036,3388,3388,0,31,1074000.0
1074,1074999,21.14433261171882,37.37347415788857,0.08846757520061765,680.1603350639343,82.24433660507202,544.0720911026001,4431,1039,3392,3392,0,31,1075000.0
1075,1075999,21.153981359027025,37.389781460684134,0.08856031730911706,680.6938583850861,82.31403636932373,544.7860345840454,4441,1041,3400,3400,0,31,1076000.0
1076,1076999,21.16697377777977,37.41449656363398,0.08876429931289842,681.2266972064972,82.38165092468262,545.2134637832642,4451,1044,3407,3407,0,31,1077000.0
1077,1077999,21.18000225884988,37.441211274300464,0.0891130479046286,681.6737406253815,82.44868969917297,546.8099069595337,4451,1044,3407,3407,0,31,1078000.0
1078,1078999,21.194721654035988,37.48228763385907,0.08933784310726933,682.5270254611969,82.51757836341858,545.9083261489868,4455,1046,3409,3409,0,31,1079000.0
1079,1079999,21.21033125531662,37.519814857080824,0.08966108751930124,683.4059722423553,82.58507418632507,545.2492151260376,4457,1047,3410,3410,0,31,1080000.0
1080,1080999,21.22831110107803,37.56320422050247,0.09013243303902874,683.9725043773651,82.65453505516052,546.0404672622681,4479,1048,3431,3431,0,31,1081000.0
1081,1081999,21.246731325215748,37.62107771882884,0.09050566096816381,684.5837075710297,82.72208285331726,546.1302576065063,4483,1050,3433,3433,0,31,1082000.0
1082,1082999,21.254073816993404,37.637288222004464,0.09021532326860215,684.7513415813446,82.78934383392334,549.1584253311157,4507,1050,3457,3457,0,31,1083000.0
1083,1083999,21.253522623067138,37.63964174206787,0.0901312319520674,685.2061212062836,82.85618019104004,550.3675317764282,4515,1051,3464,3464,0,31,1084000.0
1084,1084999,21.25449265504226,37.65327615392116,0.09006242483321991,685.4527535438538,82.9227728843689,552.6778268814087,4522,1052,3470,3470,0,31,1085000.0
1085,1085999,21.25555820819384,37.65850370124536,0.09001916713868174,685.9625506401062,82.99052906036377,553.5964593887329,4526,1054,3472,3472,0,31,1086000.0
1086,1086999,21.255959018301485,37.65882450646999,0.09004973406123307,686.486141204834,83.05847239494324,554.3578653335571,4530,1056,3474,3474,0,31,1087000.0
1087,1087999,21.25775456718745,37.679412462563384,0.08995501238174086,687.1069452762604,83.12783455848694,554.6556177139282,4534,1058,3476,3476,0,31,1088000.0
1088,1088999,21.259891280195866,37.68374018384732,0.09000322668780603,687.9792082309723,83.19525861740112,553.5732355117798,4544,1061,3483,3483,0,31,1089000.0
1089,1089999,21.261756592458276,37.68623452087174,0.09005145492011246,688.1799204349518,83.26191735267639,556.2646570205688,4544,1061,3483,3483,0,31,1090000.0
1090,1090999,21.266193366059664,37.69542578114217,0.09008847441919565,688.6842436790466,83.33455276489258,557.3464212417603,4546,1062,3484,3484,0,31,1091000.0
1091,1091999,21.271787448107553,37.70700310262702,0.09018490114083744,689.7262461185455,83.40317487716675,555.2470178604126,4552,1065,3487,3487,0,31,1092000.0
1092,1092999,21.278179430064757,37.715411568110326,0.0903552607884367,690.2983961105347,83.47455143928528,554.7942743301392,4564,1070,3494,3494,0,31,1093000.0
1093,1093999,21.284415396337117,37.72657749466478,0.09053447817529203,690.6159060001373,83.54227828979492,557.0194253921509,4564,1070,3494,3494,0,31,1094000.0
1094,1094999,21.29079011233265,37.73346498177791,0.09073873499162843,691.0960595607758,83.60968708992004,558.1152124404907,4567,1071,3496,3496,0,31,1095000.0
1095,1095999,21.29914856803894,37.75778875401191,0.09097971674416916,691.6508314609528,83.67693781852722,559.0198602676392,4569,1072,3497,3497,0,31,1096000.0
1096,1096999,21.308429260961372,37.77213439005114,0.09128110188928673,692.1440336704254,83.74501466751099,560.0805444717407,4571,1073,3498,3498,0,31,1097000.0
1097,1097999,21.317405513693128,37.78235355100153,0.09149326515663869,692.6671075820923,83.81219577789307,561.2010507583618,4571,1073,3498,3498,0,31,1098000.0
1098,1098999,21.324112939713483,37.78825147308728,0.09177286436523258,693.476532459259,83.88134574890137,560.7190942764282,4573,1074,3499,3499,0,31,1099000.0
1099,1099999,21.332348738607653,37.79670946132887,0.09195408402490746,694.2378752231598,83.9518654346466,560.5811624526978,4575,1075,3500,3500,0,31,1100000.0
1100,1100999,21.338106638173212,37.79920336394918,0.09217028479319267,694.8486080169678,84.01932835578918,560.7605981826782,4580,1077,3503,3503,0,31,1101000.0
1101,1101999,21.342302382958565,37.800053304037846,0.09230466651476377,695.431040763855,84.08644938468933,561.3346261978149,4583,1078,3505,3505,0,31,1102000.0
1102,1102999,21.342307460919915,37.79784888313565,0.09223301840810061,696.3523690700531,84.15459823608398,560.9153451919556,4604,1078,3526,3526,0,31,1103000.0
1103,1103999,21.33872427292296,37.79630862435572,0.09218991036778035,696.5284733772278,84.22170805931091,563.7506494522095,4609,1078,3531,3531,0,31,1104000.0
1104,1104999,21.335483089064766,37.79052275691432,0.0921228207811875,696.8243100643158,84.28948283195496,566.0674524307251,4613,1078,3535,3535,0,31,1105000.0
1105,1105999,21.334185226835334,37.789154743691924,0.09204192809436129,697.2527401447296,84.35643529891968,567.2278146743774,4618,1080,3538,3538,0,31,1106000.0
1106,1106999,21.334163580112,37.78957422053768,0.09198314761306348,697.8194930553436,84.42472863197327,567.2303247451782,4626,1084,3542,3542,0,31,1107000.0
1107,1107999,21.33331897955273,37.78673161780285,0.09191516569808345,698.469929933548,84.49512195587158,567.4423379898071,4632,1086,3546,3546,0,31,1108000.0
1108,1108999,21.332697598983124,37.78479743321945,0.09185230541002476,698.9659233093262,84.56716704368591,568.6028985977173,4637,1087,3550,3550,0,31,1109000.0
1109,1109999,21.3314343283207,37.779810863350356,0.09181913775376205,699.4277949333191,84.63803029060364,570.0015115737915,4640,1088,3552,3552,0,31,1110000.0
1110,1110999,21.329263610970724,37.77298613544222,0.09176942260096765,699.8089234828949,84.70823931694031,571.6345453262329,4642,1089,3553,3553,0,31,1111000.0
1111,1111999,21.329164978938977,37.76935058915847,0.0917303711956543,701.1709079742432,84.77770638465881,568.1344919204712,4650,1092,3558,3558,0,31,1112000.0
1112,1112999,21.330692623788977,37.7689259059694,0.09171470632772782,701.661721944809,84.84886646270752,569.2604837417603,4652,1093,3559,3559,0,31,1113000.0
1113,1113999,21.328380286109784,37.762729946968626,0.09169312097802873,702.317006111145,84.91977286338806,569.0799493789673,4658,1096,3562,3562,0,31,1114000.0
1114,1114999,21.329262463741674,37.7632015484642,0.09165218413346965,705.6138117313385,84.98768973350525,571.1534738540649,4658,1096,3562,3562,0,31,1115000.0
1115,1115999,21.328205663248866,37.75659494351697,0.09161102128204501,706.4101905822754,85.0575110912323,570.8723077774048,4662,1097,3565,3565,0,31,1116000.0
1116,1116999,21.3270564877302,37.752873101234435,0.091596365616738,707.1489703655243,85.12797617912292,570.3126153945923,4668,1100,3568,3568,0,31,1117000.0
1117,1117999,21.325465812787098,37.74585635478794,0.09157972184008822,707.4342679977417,85.19888973236084,572.3961114883423,4672,1101,3571,3571,0,31,1118000.0
1118,1118999,21.324247031644255,37.73890136344194,0.0915613375756853,708.2340502738953,85.26866126060486,572.0337076187134,4676,1103,3573,3573,0,31,1119000.0
1119,1119999,21.321861396476088,37.73161934395489,0.09152683596525091,709.3270196914673,85.33900260925293,569.7037897109985,4684,1106,3578,3578,0,31,1120000.0
1120,1120999,21.32053696534304,37.72531486428115,0.09149504028667332,709.9321405887604,85.40864586830139,570.1889657974243,4686,1107,3579,3579,0,31,1121000.0
1121,1121999,21.317617872533017,37.71617178143825,0.0914586028661224,710.3504750728607,85.47604703903198,571.8828744888306,4686,1107,3579,3579,0,31,1122000.0
1122,1122999,21.315652135002637,37.70905583003706,0.09138890215596529,710.7573344707489,85.5442008972168,573.7399454116821,4707,1107,3600,3600,0,31,1123000.0
1123,1123999,21.31267273766667,37.70881002740286,0.09126820900376631,710.9877398014069,85.61262893676758,575.9899835586548,4717,1108,3609,3609,0,31,1124000.0
1124,1124999,21.305706039201507,37.7023129631421,0.0912664476170455,711.2706952095032,85.67948460578918,578.3284921646118,4721,1108,3613,3613,0,31,1125000.0
1125,1125999,21.29992100455594,37.69552933309663,0.09127885790680479,711.6933166980743,85.7483217716217,579.8875360488892,4726,1109,3617,3617,0,31,1126000.0
1126,1126999,21.294212023533913,37.69001004389546,0.09127759489124554,712.1903319358826,85.81585741043091,580.5140314102173,4732,1112,3620,3620,0,31,1127000.0
1127,1127999,21.287916017068913,37.68057189081918,0.09126588384700085,712.7106251716614,85.88491749763489,581.2991647720337,4736,1114,3622,3622,0,31,1128000.0
1128,1128999,21.281551850594955,37.66999212293137,0.09129093590402071,713.6235904693604,85.95582747459412,579.8031320571899,4767,1118,3649,3649,0,31,1129000.0
1129,1129999,21.275777711880348,37.662139991006896,0.09128881759129726,714.1291522979736,86.02673888206482,580.376519203186,4775,1121,3654,3654,0,31,1130000.0
1130,1130999,21.271096835418746,37.65929271648673,0.09124142709268979,714.5590107440948,86.1000075340271,582.0583276748657,4775,1121,3654,3654,0,31,1131000.0
1131,1131999,21.265244677007956,37.64959019912411,0.09124129121893798,715.1302363872528,86.16761207580566,582.6419305801392,4779,1123,3656,3656,0,31,1132000.0
1132,1132999,21.25990259505017,37.64034222502518,0.0912375326879572,715.802791595459,86.237309217453,582.5306100845337,4783,1125,3658,3658,0,31,1133000.0
1133,1133999,21.255169116428892,37.6322188645255,0.0912222114183544,716.4070608615875,86.30892395973206,582.1426553726196,4791,1129,3662,3662,0,31,1134000.0
1134,1134999,21.250542856540154,37.623868098017404,0.09121450041884405,716.6187627315521,86.38228988647461,584.9071741104126,4791,1129,3662,3662,0,31,1135000.0
1135,1135999,21.24697663909624,37.61864532545213,0.09119775906449468,717.2809879779816,86.45286822319031,585.0160150527954,4807,1131,3676,3676,0,31,1136000.0
1136,1136999,21.243706801827813,37.61479789268627,0.09114531578166285,718.134527683258,86.52141904830933,584.6057825088501,4807,1131,3676,3676,0,31,1137000.0
1137,1137999,21.23926575338122,37.6051610246889,0.09111397601730586,718.8985130786896,86.59099650382996,584.1399164199829,4811,1133,3678,3678,0,31,1138000.0
1138,1138999,21.23798520872679,37.602571487877164,0.09105425964836877,719.2664377689362,86.66002774238586,585.7339181900024,4813,1134,3679,3679,0,31,1139000.0
1139,1139999,21.23582008000736,37.59584402079019,0.09101842456305542,719.926896572113,86.7287130355835,585.7452173233032,4817,1136,3681,3681,0,31,1140000.0
1140,1140999,21.23539986551203,37.592367989693756,0.09094143901115448,720.6642742156982,86.79995346069336,585.8559274673462,4817,1136,3681,3681,0,31,1141000.0
1141,1141999,21.233329577978854,37.58591702616673,0.09091826811121784,721.4073631763458,86.86969923973083,585.9030466079712,4817,1136,3681,3681,0,31,1142000.0
1142,1142999,21.231664826834752,37.5797943593989,0.09088977993915548,721.8210153579712,86.93781208992004,587.4962854385376,4817,1136,3681,3681,0,31,1143000.0
1143,1143999,21.231988776590363,37.58391135100644,0.09078644279435755,722.456901550293,87.00888967514038,587.6452417373657,4822,1138,3684,3684,0,31,1144000.0
1144,1144999,21.233582266102935,37.58867508719138,0.09066632457606105,723.0683135986328,87.07323265075684,588.346848487854,4822,1138,3684,3684,0,31,1145000.0
1145,1145999,21.235325092093134,37.59051890492782,0.09058607503128313,723.6417660713196,87.13819599151611,588.9480447769165,4824,1139,3685,3685,0,31,1146000.0
1146,1146999,21.23905687320162,37.60091176994404,0.09051074166777062,724.3988580703735,87.20380687713623,588.4813394546509,4830,1141,3689,3689,0,31,1147000.0
1147,1147999,21.240183369293245,37.60638248468116,0.09046703660034927,725.0791637897491,87.27125573158264,588.5359506607056,4832,1142,3690,3690,0,31,1148000.0
1148,1148999,21.24382030366975,37.61341974923204,0.0905664384355993,725.6930546760559,87.33878302574158,589.2390909194946,4832,1142,3690,3690,0,31,1149000.0
1149,1149999,21.249669168496347,37.62516275005622,0.0907183087446416,726.1680929660797,87.40409135818481,590.3065195083618,4834,1143,3691,3691,0,31,1150000.0
1150,1150999,21.257502431469995,37.64297940687705,0.09100154996264265,726.8693225383759,87.47105526924133,590.2853174209595,4835,1144,3691,3691,0,31,1151000.0
1151,1151999,21.26461016144878,37.65217960915808,0.0910693952740601,727.4933683872223,87.53709316253662,590.8832101821899,4835,1144,3691,3691,0,31,1152000.0
1152,1152999,21.274433682493637,37.67064574305574,0.09140344477798146,728.1233968734741,87.60245871543884,591.4350290298462,4835,1144,3691,3691,0,31,1153000.0
1153,1153999,21.28679372940652,37.69099389761994,0.09180425005755533,728.7219319343567,87.66905355453491,591.9587259292603,4836,1145,3691,3691,0,31,1154000.0
1154,1154999,21.29673453782277,37.70488482228422,0.0921829458996154,729.337165594101,87.73643374443054,592.4297952651978,4838,1146,3692,3692,0,31,1155000.0
1155,1155999,21.305876238364572,37.71765255839872,0.09237853543090335,730.1916592121124,87.8032238483429,592.0540781021118,4838,1146,3692,3692,0,31,1156000.0
1156,1156999,21.31682071156661,37.73366726608301,0.09261490594734811,730.8533020019531,87.86967253684998,591.9210290908813,4841,1148,3693,3693,0,31,1157000.0
1157,1157999,21.331671381138403,37.76537631975587,0.09286119197518283,731.7374858856201,87.93729329109192,590.9678201675415,4850,1150,3700,3700,0,31,1158000.0
1158,1158999,21.345669121923063,37.79543442886051,0.09316192566459147,732.3758797645569,88.0062403678894,591.5653772354126,4850,1150,3700,3700,0,31,1159000.0
1159,1159999,21.3622398536028,37.82698705040548,0.09341761936307169,733.1962218284607,88.07686686515808,591.0053033828735,4851,1151,3700,3700,0,31,1160000.0
1160,1160999,21.377500232114656,37.848230669130686,0.09363762171370205,733.7222945690155,88.14378952980042,592.1541833877563,4851,1151,3700,3700,0,31,1161000.0
1161,1161999,21.393991363458625,37.87182139656308,0.09384512158592373,734.4441089630127,88.21179866790771,592.4992074966431,4851,1151,3700,3700,0,31,1162000.0
1162,1162999,21.408351868690264,37.894498917487,0.09397272820267322,735.1837015151978,88.28242087364197,592.5750970840454,4851,1151,3700,3700,0,31,1163000.0
1163,1163999,21.41857318853987,37.91266235618613,0.09339720531296491,735.5447237491608,88.35098314285278,594.0967950820923,4853,1152,3701,3701,0,31,1164000.0
1164,1164999,21.421913373773858,37.92292338550703,0.09317847598405216,736.2048759460449,88.41951155662537,593.937310218811,4886,1154,3732,3732,0,31,1165000.0
1165,1165999,21.426938051440725,37.930828015489595,0.09297677535521065,736.9715623855591,88.48838472366333,593.4074487686157,4890,1156,3734,3734,0,31,1166000.0
1166,1166999,21.431462601003204,37.93877280796063,0.09290534640064663,737.8010513782501,88.5567479133606,593.2620706558228,4890,1156,3734,3734,0,31,1167000.0
1167,1167999,21.435667411429563,37.95930360572434,0.09274563975686911,738.7360420227051,88.62754201889038,592.2522058486938,4921,1157,3764,3764,0,31,1168000.0
1168,1168999,21.43970783311499,37.96165081344574,0.09276067557511336,739.4655163288116,88.6985776424408,592.2156763076782,4952,1158,3794,3794,0,31,1169000.0
1169,1169999,21.445522620445747,37.96979025050867,0.09286077840424056,740.042013168335,91.91065764427185,592.5781488418579,4955,1160,3795,3795,0,31,1170000.0
1170,1170999,21.4514003041147,37.977550887860744,0.09298634516832105,740.5520749092102,91.98405504226685,593.2485513687134,5003,1163,3840,3840,0,31,1171000.0
1171,1171999,21.45602749429462,37.98302051554697,0.09308703368471039,740.9704296588898,92.05634880065918,595.0153894424438,5004,1163,3841,3841,0,31,1172000.0
1172,1172999,21.46513427207672,37.99855947614845,0.09335830775215614,741.5743818283081,92.12871265411377,595.7018899917603,5007,1164,3843,3843,0,31,1173000.0
1173,1173999,21.476306711921445,38.01863098103351,0.09373096924163338,742.4274725914001,92.20458984375,594.6481561660767,5042,1167,3875,3875,0,31,1174000.0
1174,1174999,21.484050052132357,38.027449850213635,0.09407865802715565,742.8999557495117,92.27540755271912,595.5548105239868,5046,1169,3877,3877,0,31,1175000.0
1175,1175999,21.493838333604423,38.04463557578727,0.09437914392257563,743.2397217750549,92.34560585021973,597.720009803772,5046,1169,3877,3877,0,31,1176000.0
1176,1176999,21.504578373248133,38.06515475048061,0.09450541958235781,744.2381157875061,92.4170835018158,596.3099069595337,5050,1171,3879,3879,0,31,1177000.0
1177,1177999,21.517749629556402,38.09314220628762,0.09487034008467155,744.9787032604218,92.48816776275635,595.7524652481079,5056,1174,3882,3882,0,31,1178000.0
1178,1178999,21.525424916596684,38.10221767450064,0.0951375134685547,745.5011930465698,92.55896711349487,597.0722970962524,5056,1174,3882,3882,0,31,1179000.0
1179,1179999,21.534704930232557,38.12044612520638,0.09545671318219628,746.2803494930267,92.63146424293518,596.5916986465454,5072,1176,3896,3896,0,31,1180000.0
1180,1180999,21.546418582064508,38.137694838566496,0.09596593646858687,746.5961842536926,92.70143556594849,598.7568826675415,5072,1176,3896,3896,0,31,1181000.0
1181,1181999,21.55593704965223,38.146987449669474,0.09621224590355093,747.4120905399323,92.77548575401306,598.305890083313,5075,1177,3898,3898,0,31,1182000.0
1182,1182999,21.562987513547785,38.154230226196375,0.0963415257853476,748.3357195854187,92.84662652015686,597.3405046463013,5077,1178,3899,3899,0,31,1183000.0
1183,1183999,21.56786864686607,38.16629606191761,0.09588431136798203,748.8982329368591,92.91584849357605,598.0644807815552,5080,1179,3901,3901,0,31,1184000.0
1184,1184999,21.569584413893583,38.16687555166515,0.09576430017424553,749.4047377109528,92.98662042617798,599.3503007888794,5080,1179,3901,3901,0,31,1185000.0
1185,1185999,21.57104006175227,38.16937406941795,0.09561391480900416,749.8087446689606,93.05532217025757,601.0240755081177,5080,1179,3901,3901,0,31,1186000.0
1186,1186999,21.572069465033167,38.16942519988658,0.09550221231789247,750.6193313598633,93.12377142906189,600.9098253250122,5080,1179,3901,3901,0,31,1187000.0
1187,1187999,21.572728727704078,38.16752527604652,0.09538920663138473,751.4801316261292,93.19390606880188,600.5049867630005,5080,1179,3901,3901,0,31,1188000.0
1188,1188999,21.572590670890314,38.16431299307782,0.09526136826175902,752.0076293945312,93.26422762870789,601.5691499710083,5080,1179,3901,3901,0,31,1189000.0
1189,1189999,21.57256681494033,38.162814527822775,0.09515394171406288,752.8516688346863,93.33721470832825,601.0828905105591,5080,1179,3901,3901,0,31,1190000.0
1190,1190999,21.572387921878452,38.161726831086305,0.09510158876801711,753.4511053562164,93.40676546096802,601.5230226516724,5081,1180,3901,3901,0,31,1191000.0
1191,1191999,21.573666281257683,38.16924600706536,0.09498009099921645,754.0672991275787,93.47774910926819,601.5248765945435,5086,1183,3903,3903,0,31,1192000.0
1192,1192999,21.5743289907264,38.16535257271153,0.0949317347462022,754.9139311313629,93.5489730834961,601.0826768875122,5086,1183,3903,3903,0,31,1193000.0
1193,1193999,21.57480402351062,38.1608491775209,0.09494409643017854,755.5672829151154,93.62087774276733,601.6336259841919,5086,1183,3903,3903,0,31,1194000.0
1194,1194999,21.575951411814636,38.157653081441055,0.0948993813041149,756.2166509628296,93.6946382522583,602.1845903396606,5086,1183,3903,3903,0,31,1195000.0
1195,1195999,21.57696256095446,38.153561043105,0.09483809580969738,756.977255821228,93.76504468917847,602.2089891433716,5086,1183,3903,3903,0,31,1196000.0
1196,1196999,21.578705010292587,38.15022818467528,0.09482812275522756,757.5155870914459,93.8385078907013,603.264874458313,5087,1183,3904,3904,0,31,1197000.0
1197,1197999,21.580072402975436,38.14547821591545,0.09474037233941701,758.1116955280304,93.90886211395264,603.6864290237427,5088,1184,3904,3904,0,31,1198000.0
1198,1198999,21.580211061196273,38.14091571570172,0.09469492781009692,758.5583343505859,93.98098182678223,604.7257356643677,5103,1186,3917,3917,0,31,1199000.0
1199,1199999,21.58061935706645,38.137001820374536,0.09467525305000668,759.3943040370941,94.05326461791992,604.439305305481,5105,1186,3919,3919,0,31,1200000.0
1200,1200999,21.58118560036065,38.14011148688458,0.09447849192374902,759.7722742557526,94.12614750862122,606.0444765090942,5108,1187,3921,3921,0,31,1201000.0
1201,1201999,21.57959528289082,38.148769286712024,0.0943315003404418,760.3624165058136,94.19522476196289,606.7057237625122,5110,1188,3922,3922,0,31,1202000.0
1202,1202999,21.57805289163266,38.14760828812068,0.09419253012377027,760.9836478233337,94.26344299316406,607.347638130188,5110,1188,3922,3922,0,31,1203000.0
1203,1203999,21.5744136414233,38.14077231554562,0.09414159144482848,761.8249244689941,94.33202695846558,606.929051399231,5110,1188,3922,3922,0,31,1204000.0
1204,1204999,21.571170651612984,38.13787026815578,0.0940642277421182,762.573579788208,94.40358424186707,607.2044343948364,5110,1188,3922,3922,0,31,1205000.0
1205,1205999,21.56820914334285,38.13342055061751,0.0939611463847908,763.1566143035889,94.47394132614136,607.3672380447388,5114,1190,3924,3924,0,31,1206000.0
1206,1206999,21.56431035806575,38.12686138327123,0.0938666122691062,763.8658223152161,94.54633831977844,607.346661567688,5116,1191,3925,3925,0,31,1207000.0
1207,1207999,21.55987359286276,38.118225149913165,0.09379994288954707,764.4902992248535,94.61553144454956,607.165280342102,5121,1194,3927,3927,0,31,1208000.0
1208,1208999,21.556532841400255,38.110905539405394,0.09371670735136362,764.9635648727417,94.68695616722107,608.3001375198364,5122,1195,3927,3927,0,31,1209000.0
1209,1209999,21.552220692327978,38.10203992733869,0.09367200846564694,765.5981817245483,94.7565336227417,608.8922700881958,5122,1195,3927,3927,0,31,1210000.0
1210,1210999,21.549530300224568,38.09594576438543,0.09355070577917901,766.2401766777039,94.82753777503967,609.453236579895,5122,1195,3927,3927,0,31,1211000.0
1211,1211999,21.546718300028797,38.09013741089311,0.09346985035811195,767.3021838665009,94.90074849128723,607.6729860305786,5124,1196,3928,3928,0,31,1212000.0
1212,1212999,21.544858851123426,38.0861149369529,0.09338084342328623,768.0490522384644,94.97175788879395,607.7236223220825,5124,1196,3928,3928,0,31,1213000.0
1213,1213999,21.543286965293458,38.08314532418735,0.09329693765432023,768.7643194198608,95.04353880882263,607.647213935852,5126,1197,3929,3929,0,31,1214000.0
1214,1214999,21.543161732653772,38.079894252791625,0.09321309253184396,769.1489539146423,95.11486387252808,609.2339067459106,5127,1198,3929,3929,0,31,1215000.0
1215,1215999,21.54223240779081,38.07473870026392,0.09317267734216361,770.0075764656067,95.18759298324585,608.8047075271606,5127,1198,3929,3929,0,31,1216000.0
1216,1216999,21.54199929720014,38.07175382354985,0.09312251400086657,770.9783306121826,95.26131582260132,607.8249788284302,5127,1198,3929,3929,0,31,1217000.0
1217,1217999,21.540899985884277,38.066589950077315,0.09308129529121145,771.5147109031677,95.33571553230286,608.8836488723755,5127,1198,3929,3929,0,31,1218000.0
1218,1218999,21.54029135724406,38.06181884527886,0.0930317778768267,772.3696513175964,95.4158661365509,608.3521089553833,5129,1199,3930,3930,0,31,1219000.0
1219,1219999,21.53881646456474,38.056244249448106,0.09303068596828279,773.0194871425629,95.48762130737305,608.9019823074341,5129,1199,3930,3930,0,31,1220000.0
1220,1220999,21.53829556002179,38.055277602904084,0.0929171217016519,773.9225573539734,95.55821919441223,608.0039339065552,5132,1200,3932,3932,0,31,1221000.0
1221,1221999,21.534922765801706,38.04946869693361,0.09282009614942499,774.5730822086334,95.62829375267029,608.0260896682739,5148,1202,3946,3946,0,31,1222000.0
1222,1222999,21.531852156652032,38.04518723182785,0.0927107329143596,775.1688272953033,95.7001085281372,608.2757844924927,5155,1205,3950,3950,0,31,1223000.0
1223,1223999,21.527148581763203,38.036103320758336,0.09268994348022896,775.4707009792328,95.76937055587769,610.5418901443481,5155,1205,3950,3950,0,31,1224000.0
1224,1224999,21.522294566915317,38.027778385665655,0.09265936971010491,775.9900295734406,95.8383903503418,611.7217531204224,5156,1205,3951,3951,0,31,1225000.0
1225,1225999,21.518351462743187,38.01920511719122,0.0926060967538408,776.8278684616089,95.90861105918884,611.5338411331177,5156,1205,3951,3951,0,31,1226000.0
1226,1226999,21.51446138773058,38.012284567147184,0.09257946330264977,777.1436810493469,95.97786355018616,613.6706972122192,5156,1205,3951,3951,0,31,1227000.0
1227,1227999,21.51012029723157,38.00347154377085,0.09254335586909135,777.9245202541351,96.0493848323822,613.1296663284302,5161,1207,3954,3954,0,31,1228000.0
1228,1228999,21.50660894139517,37.99921543025523,0.09249251844138906,778.641517162323,96.11869931221008,613.4501390457153,5161,1207,3954,3954,0,31,1229000.0
1229,1229999,21.502541645175523,37.99062394073027,0.09247137806586914,782.533605337143,96.1890766620636,613.9730043411255,5161,1207,3954,3954,0,31,1230000.0
1230,1230999,21.501678391174423,37.98881395600506,0.09239913872474792,783.4918868541718,96.25949597358704,613.0416994094849,5161,1207,3954,3954,0,31,1231000.0
1231,1231999,21.500259065785343,37.987422577187424,0.09234457356149028,784.0211906433105,96.32854866981506,614.1314668655396,5161,1207,3954,3954,0,31,1232000.0
1232,1232999,21.498522476984267,37.98311563813703,0.09229924733283079,784.6922936439514,96.40035128593445,614.0453462600708,5165,1209,3956,3956,0,31,1233000.0
1233,1233999,21.496661633411517,37.97943658604541,0.0922822635978785,785.1781463623047,96.46947121620178,615.1193056106567,5167,1210,3957,3957,0,31,1234000.0
1234,1234999,21.49570725375402,37.977921941190026,0.092272152043682,786.0176846981049,96.54151582717896,615.1174364089966,5167,1210,3957,3957,0,31,1235000.0
1235,1235999,21.49595189760071,37.97890222481302,0.09227416939989186,786.6586649417877,96.61239743232727,615.6706438064575,5167,1210,3957,3957,0,31,1236000.0
1236,1236999,21.495218546053287,37.97631825336739,0.09229923090974301,787.4683420658112,96.68381094932556,615.161129951477,5169,1211,3958,3958,0,31,1237000.0
1237,1237999,21.494844489243377,37.973531721416165,0.09229594453361867,787.8882741928101,96.75613808631897,616.7647371292114,5169,1211,3958,3958,0,31,1238000.0
1238,1238999,21.494479921992,37.97156923521595,0.09234098922617207,788.593677520752,96.82618570327759,616.8335542678833,5171,1212,3959,3959,0,31,1239000.0
1239,1239999,21.4935612034127,37.9681303841256,0.09237071422318521,789.2631986141205,96.89932990074158,616.7724733352661,5175,1214,3961,3961,0,31,1240000.0
1240,1240999,21.49203234103009,37.97084639433249,0.09236874152528651,790.051432132721,96.9697675704956,616.1282243728638,5179,1216,3963,3963,0,31,1241000.0
1241,1241999,21.490395148829627,37.96627796677175,0.0922102720006176,790.5407071113586,97.03728294372559,617.4336061477661,5181,1216,3965,3965,0,31,1242000.0
1242,1242999,21.48686163435014,37.96041539029735,0.09211448042698711,791.1963217258453,97.10618352890015,617.4421510696411,5197,1218,3979,3979,0,31,1243000.0
1243,1243999,21.483076542943774,37.95290430186355,0.09204081694331678,791.482503414154,97.17409110069275,619.7700700759888,5199,1218,3981,3981,0,31,1244000.0
1244,1244999,21.480111370033086,37.946875966524004,0.09194164365252722,791.8383507728577,97.24281239509583,621.6239748001099,5202,1219,3983,3983,0,31,1245000.0
1245,1245999,21.476331073329366,37.93892417779422,0.09187392873910394,792.3120009899139,97.31262707710266,622.7463426589966,5204,1220,3984,3984,0,31,1246000.0
1246,1246999,21.471744971543323,37.931113504079896,0.09183645176904365,792.892594575882,97.38308668136597,623.4369401931763,5206,1221,3985,3985,0,31,1247000.0
1247,1247999,21.467759081145807,37.923691966544084,0.09180348292836205,793.3100776672363,97.45229887962341,625.0729722976685,5206,1221,3985,3985,0,31,1248000.0
1248,1248999,21.464187317442143,37.91665581893159,0.09175835291881485,794.2999532222748,97.52374744415283,623.5673570632935,5210,1223,3987,3987,0,31,1249000.0
1249,1249999,21.459566070601245,37.908479339218246,0.09175578077025326,795.1050515174866,97.59328651428223,623.2371797561646,5212,1224,3988,3988,0,31,1250000.0
1250,1250999,21.455851843367668,37.90373826601469,0.09174636174764961,795.5246474742889,97.66336965560913,624.8830919265747,5212,1224,3988,3988,0,31,1251000.0
1251,1251999,21.452784217296962,37.897050081575266,0.09173578963088402,796.4008769989014,97.73465967178345,623.9395418167114,5216,1226,3990,3990,0,31,1252000.0
1252,1252999,21.449705125126172,37.89152210547292,0.0917167601329616,796.7875962257385,97.80535387992859,625.4899034500122,5218,1227,3991,3991,0,31,1253000.0
1253,1253999,21.445901570373625,37.886308048596376,0.09170934459354985,797.5965032577515,97.87646508216858,625.0953416824341,5220,1228,3992,3992,0,31,1254000.0
1254,1254999,21.44299063558988,37.88026030932436,0.09170662519239081,798.3898346424103,97.94620704650879,624.495099067688,5224,1230,3994,3994,0,31,1255000.0
1255,1255999,21.44103416825502,37.87583876691952,0.09172462587192387,799.0188536643982,98.0199806690216,625.0802659988403,5224,1230,3994,3994,0,31,1256000.0
1256,1256999,21.43967845312244,37.884477224921326,0.09166548025825094,799.7609112262726,98.09136509895325,625.1889925003052,5224,1230,3994,3994,0,31,1257000.0
1257,1257999,21.438411728820007,37.88012538326294,0.09165496842363074,800.6350431442261,98.16440749168396,624.137677192688,5228,1232,3996,3996,0,31,1258000.0
1258,1258999,21.436778200055368,37.87577987723044,0.09165296817307245,801.164701461792,98.23783469200134,625.2153902053833,5228,1232,3996,3996,0,31,1259000.0
1259,1259999,21.434453685914054,37.87049224144723,0.09167366202603877,801.7891302108765,98.30970740318298,625.9381227493286,5228,1232,3996,3996,0,31,1260000.0
1260,1260999,21.4324215827384,37.86454076114267,0.09168990784732822,802.7233762741089,98.38166546821594,624.8106737136841,5230,1233,3997,3997,0,31,1261000.0
1261,1261999,21.429733475557967,37.85759640276523,0.09170075763461527,803.245299577713,98.45247673988342,625.93150806427,5231,1233,3998,3998,0,31,1262000.0
1262,1262999,21.427411013888495,37.851975189708696,0.09163399379555504,803.9254815578461,98.52137589454651,626.03697681427,5233,1234,3999,3999,0,31,1263000.0
1263,1263999,21.425563832408248,37.845843209702586,0.09161008275801319,804.1716792583466,98.59045243263245,628.3311891555786,5247,1235,4012,4012,0,31,1264000.0
1264,1264999,21.424166323152473,37.84049292060969,0.09158334355561748,804.7143054008484,98.66012692451477,628.9603853225708,5252,1237,4015,4015,0,31,1265000.0
1265,1265999,21.425328611797525,37.84051525117904,0.09155762326383066,805.1276264190674,98.73063468933105,630.6789216995239,5253,1237,4016,4016,0,31,1266000.0
1266,1266999,21.4280193831294,37.84228573648717,0.09155962504911541,805.6730422973633,98.79985809326172,631.3180589675903,5257,1239,4018,4018,0,31,1267000.0
1267,1267999,21.430214932622498,37.84374241633997,0.09155519096760989,806.327424287796,98.86964130401611,631.3833818435669,5261,1241,4020,4020,0,31,1268000.0
1268,1268999,21.432257498833906,37.844975683516886,0.09157326286609369,807.1995017528534,98.9403429031372,630.3894472122192,5271,1243,4028,4028,0,31,1269000.0
1269,1269999,21.43458557091539,37.84655904993273,0.09159710089151951,807.7960772514343,99.0119366645813,630.96715259552,5273,1244,4029,4029,0,31,1270000.0
1270,1270999,21.436376749953396,37.84860760956485,0.09160466197100281,808.144983291626,99.08167481422424,632.4749116897583,5277,1246,4031,4031,0,31,1271000.0
1271,1271999,21.43964301769955,37.85195286335621,0.09162218886856532,809.0954558849335,99.15171933174133,631.5552263259888,5277,1246,4031,4031,0,31,1272000.0
1272,1272999,21.44194086849609,37.854980928330825,0.09168901120924611,809.6386384963989,99.22524333000183,632.7349901199341,5277,1246,4031,4031,0,31,1273000.0
1273,1273999,21.443924010352823,37.85421285536424,0.0917921729511898,810.4471671581268,99.29858350753784,632.4127702713013,5279,1247,4032,4032,0,31,1274000.0
1274,1274999,21.44652348212906,37.85475002273502,0.09185438957264158,811.2592175006866,99.36920762062073,632.0482835769653,5281,1248,4033,4033,0,31,1275000.0
1275,1275999,21.449268488827464,37.85634597215141,0.09192250431353621,811.8964648246765,99.43904709815979,632.6117296218872,5281,1248,4033,4033,0,31,1276000.0
1276,1276999,21.452254215761375,37.85812873063725,0.09199183856849757,812.3174788951874,99.51074075698853,634.1950197219849,5281,1248,4033,4033,0,31,1277000.0
1277,1277999,21.455405560635825,37.86444160853134,0.0920604965884051,813.2333390712738,99.58216786384583,633.1634340286255,5283,1249,4034,4034,0,31,1278000.0
1278,1278999,21.457958947940828,37.87009733415516,0.09214357175760624,813.8088934421539,99.65263652801514,633.8571443557739,5285,1250,4035,4035,0,31,1279000.0
1279,1279999,21.460304592342286,37.87048407134505,0.09221709932522582,814.5225267410278,99.72536277770996,633.9133577346802,5287,1251,4036,4036,0,31,1280000.0
1280,1280999,21.46264031144387,37.870288355484014,0.09231918253823701,815.0594096183777,99.79623508453369,634.9944124221802,5287,1251,4036,4036,0,31,1281000.0
1281,1281999,21.46252952030346,37.86680840871482,0.09237853760441717,815.7697429656982,99.8670494556427,634.9647951126099,5289,1252,4037,4037,0,31,1282000.0
1282,1282999,21.46919860487507,37.87436072654458,0.09169864369822134,816.3552315235138,99.93864035606384,635.5470399856567,5291,1253,4038,4038,0,31,1283000.0
1283,1283999,21.474478742923285,37.87728754716288,0.0912036978116827,816.8522386550903,100.00555801391602,636.6632814407349,5291,1253,4038,4038,0,31,1284000.0
1284,1284999,21.476678444323284,37.87687448877958,0.09084194449042782,817.3607904911041,100.07467865943909,637.77672290802,5291,1253,4038,4038,0,31,1285000.0
1285,1285999,21.478433439234973,37.87800358385213,0.09062466671679403,818.1568372249603,100.14458751678467,637.3798036575317,5293,1254,4039,4039,0,31,1286000.0
1286,1286999,21.475156232941302,37.870710413720104,0.09050774862073174,822.3123509883881,100.21483707427979,636.2661256790161,5329,1258,4071,4071,0,31,1287000.0
1287,1287999,21.47096340186181,37.862943383165,0.0904096929792404,823.235188961029,100.28493976593018,635.3558320999146,5360,1259,4101,4101,0,31,1288000.0
1288,1288999,21.46833025413549,37.8574780849892,0.09024347860871818,823.7595255374908,100.35517907142639,636.4318895339966,5360,1259,4101,4101,0,31,1289000.0
1289,1289999,21.465497768549703,37.8569290043537,0.09013766999805806,824.5714569091797,100.42707014083862,635.8608980178833,5361,1260,4101,4101,0,31,1290000.0
1290,1290999,21.461805810833003,37.85008119380174,0.09005867049363236,825.3205950260162,100.49707341194153,635.9322862625122,5361,1260,4101,4101,0,31,1291000.0
1291,1291999,21.45850458739525,37.845736221752745,0.08997638872085945,825.8555793762207,100.56727981567383,637.0077562332153,5361,1260,4101,4101,0,31,1292000.0
1292,1292999,21.45642551581833,37.84637371229938,0.08986209239586307,826.8757920265198,100.63931560516357,635.122654914856,5364,1262,4102,4102,0,31,1293000.0
1293,1293999,21.45374867731282,37.84087664762872,0.08976219609002523,827.4131145477295,100.71181082725525,636.2797136306763,5364,1262,4102,4102,0,31,1294000.0
1294,1294999,21.451316733524664,37.83605752665897,0.08967002782555722,828.1302678585052,100.78506922721863,636.3103075027466,5366,1263,4103,4103,0,31,1295000.0
1295,1295999,21.449435210808797,37.83317057403719,0.08959581332585809,828.7624859809875,100.85778522491455,636.6848344802856,5367,1264,4103,4103,0,31,1296000.0
1296,1296999,21.447644171231744,37.82844694883784,0.0895172448596453,829.6375207901001,100.93062400817871,636.3372621536255,5367,1264,4103,4103,0,31,1297000.0
1297,1297999,21.447003051644234,37.82522041558634,0.08945131326455602,830.25656914711,101.00219321250916,636.8396425247192,5369,1265,4104,4104,0,31,1298000.0
1298,1298999,21.446140828666195,37.820885828758485,0.0893706732649715,830.8805298805237,101.07918620109558,637.3837633132935,5371,1266,4105,4105,0,31,1299000.0
1299,1299999,21.4461228411349,37.818051969696775,0.08928392893118442,831.7114133834839,101.15264344215393,636.790150642395,5372,1267,4105,4105,0,31,1300000.0
1300,1300999,21.444677268398774,37.81319694528755,0.08923187394876231,832.3157324790955,101.22553491592407,637.370457649231,5374,1268,4106,4106,0,31,1301000.0
1301,1301999,21.44476063159101,37.811160434483675,0.08916310608458367,833.0783851146698,101.30029535293579,637.4086198806763,5374,1268,4106,4106,0,31,1302000.0
1302,1302999,21.443749790404045,37.80652246895002,0.08911848834808478,834.008759021759,101.37945747375488,636.2920351028442,5375,1269,4106,4106,0,31,1303000.0
1303,1303999,21.44482564101072,37.80398320958597,0.08884471983057207,834.3014967441559,101.45163559913635,638.4715394973755,5375,1269,4106,4106,0,31,1304000.0
1304,1304999,21.45125344594785,37.80754920049807,0.08831587662614293,834.8040270805359,101.52166676521301,638.9337129592896,5381,1272,4109,4109,0,31,1305000.0
1305,1305999,21.453220795776296,37.80899637765557,0.08801312458819377,835.6013205051422,101.59532856941223,638.73570728302,5383,1273,4110,4110,0,31,1306000.0
1306,1306999,21.45459907180628,37.80801179225094,0.08775364520806628,836.3898911476135,101.66985058784485,638.304669380188,5387,1275,4112,4112,0,31,1307000.0
1307,1307999,21.453074779067425,37.80263939186489,0.08759383887966177,837.1240515708923,101.74104237556458,637.8389940261841,5393,1278,4115,4115,0,31,1308000.0
1308,1308999,21.451441964653405,37.79644976540848,0.08747094370124353,837.7335138320923,101.81426620483398,638.3717241287231,5395,1279,4116,4116,0,31,1309000.0
1309,1309999,21.450597383455356,37.79061724433744,0.08730652473323575,838.2427678108215,101.88716864585876,639.4173173904419,5397,1280,4117,4117,0,31,1310000.0
1310,1310999,21.447447987976485,37.7830233090403,0.08719240286159491,839.0730822086334,101.95997595787048,638.9510774612427,5399,1281,4118,4118,0,31,1311000.0
1311,1311999,21.445458391298416,37.778394605145046,0.08709175146076176,839.3565719127655,102.0344512462616,641.0340089797974,5401,1282,4119,4119,0,31,1312000.0
1312,1312999,21.44286140670394,37.77357793505056,0.08699907769388415,840.0730302333832,102.10811734199524,641.0924196243286,5403,1283,4120,4120,0,31,1313000.0
1313,1313999,21.440453522070978,37.7679767688556,0.08691084919663261,840.8778605461121,102.18225860595703,640.4262742996216,5407,1285,4122,4122,0,31,1314000.0
1314,1314999,21.43820033086838,37.7612161166486,0.08681865873737271,841.4340193271637,102.25537109375,641.5150880813599,5407,1285,4122,4122,0,31,1315000.0
1315,1315999,21.435378517687585,37.75456354731531,0.086757297405881,842.0783705711365,102.33166217803955,642.0819139480591,5409,1286,4123,4123,0,31,1316000.0
1316,1316999,21.43192033145614,37.74710928562629,0.08670610580803573,842.8343851566315,102.40314149856567,642.151463508606,5409,1286,4123,4123,0,31,1317000.0
1317,1317999,21.42989383189628,37.741138774510915,0.0866437958747458,843.146990776062,102.47340202331543,644.2569627761841,5409,1286,4123,4123,0,31,1318000.0
1318,1318999,21.428404952186998,37.741000285710996,0.08659093486308889,843.9013514518738,102.54917454719543,644.2953386306763,5409,1286,4123,4123,0,31,1319000.0
1319,1319999,21.427163699079344,37.736384002055814,0.08655482496307254,844.6060025691986,102.62280201911926,644.29039478302,5411,1287,4124,4124,0,31,1320000.0
1320,1320999,21.426392616125487,37.73442213263693,0.08656803677910685,845.1173341274261,102.69428968429565,645.1379594802856,5413,1288,4125,4125,0,31,1321000.0
1321,1321999,21.424977109611177,37.73043843538011,0.0865795054464763,845.7635180950165,102.7685194015503,645.6846971511841,5413,1288,4125,4125,0,31,1322000.0
1322,1322999,21.424794372546305,37.7274717004853,0.08659812140078182,846.5088407993317,102.84114289283752,645.23375415802,5426,1291,4135,4135,0,31,1323000.0
1323,1323999,21.42281846946303,37.723676592443944,0.08660765984314245,847.5237910747528,102.91359210014343,643.4558305740356,5430,1293,4137,4137,0,31,1324000.0
1324,1324999,21.419253668017337,37.715731573477804,0.08660088354303375,848.596108675003,102.9865174293518,642.1184358596802,5430,1293,4137,4137,0,31,1325000.0
1325,1325999,21.4176751997287,37.71797692144457,0.08652593275821674,849.4337310791016,103.0604178905487,641.8001680374146,5430,1293,4137,4137,0,31,1326000.0
1326,1326999,21.414367090328813,37.71982886552267,0.08647532434163807,849.8767998218536,103.13343214988708,642.9567995071411,5440,1295,4145,4145,0,31,1327000.0
1327,1327999,21.409705443550493,37.7133262511974,0.08646237268369239,850.506204366684,103.20710253715515,643.6986742019653,5440,1295,4145,4145,0,31,1328000.0
1328,1328999,21.404929188197737,37.708566375480856,0.08645627723184979,851.2516257762909,103.28131079673767,643.8976716995239,5440,1295,4145,4145,0,31,1329000.0
1329,1329999,21.400027969066898,37.69974078220045,0.08645153296834207,851.8932695388794,103.35552453994751,643.8390855789185,5448,1298,4150,4150,0,31,1330000.0
1330,1330999,21.394738238917046,37.69093145223927,0.0864594729469923,852.7521409988403,103.43017673492432,643.4940462112427,5448,1298,4150,4150,0,31,1331000.0
1331,1331999,21.389443492621815,37.68235340384889,0.08645787969325236,853.2149794101715,103.50495171546936,644.535008430481,5453,1300,4153,4153,0,31,1332000.0
1332,1332999,21.384037960343452,37.67262399801927,0.08647043665622922,854.0017528533936,103.5784764289856,644.5075044631958,5453,1300,4153,4153,0,31,1333000.0
1333,1333999,21.37881800957169,37.664180137690984,0.08647714820110586,854.6624982357025,103.65184926986694,645.0731325149536,5453,1300,4153,4153,0,31,1334000.0
1334,1334999,21.375313349882592,37.65894627855546,0.08646921907435168,855.6400609016418,103.72765231132507,644.1149187088013,5453,1300,4153,4153,0,31,1335000.0
1335,1335999,21.372792782067723,37.6577960407463,0.08642875373880432,856.4853272438049,103.80247354507446,643.5076265335083,5455,1301,4154,4154,0,31,1336000.0
1336,1336999,21.370266022055063,37.653592532317965,0.08641486145010113,857.1345965862274,103.87503218650818,644.07408618927,5455,1301,4154,4154,0,31,1337000.0
1337,1337999,21.367506493951343,37.6483124568302,0.08640966071903289,857.4571559429169,103.95097017288208,646.1773042678833,5455,1301,4154,4154,0,31,1338000.0
1338,1338999,21.367190813922566,37.64771328805572,0.08639192897831438,858.1737105846405,104.02765035629272,646.1813707351685,5457,1302,4155,4155,0,31,1339000.0
1339,1339999,21.365893559591782,37.64867440518869,0.08637347158764297,858.8408997058868,104.10239744186401,646.1720552444458,5461,1304,4157,4157,0,31,1340000.0
1340,1340999,21.363636299144435,37.645437413951264,0.08637069194405755,859.9188940525055,104.17583847045898,644.6748933792114,5461,1304,4157,4157,0,31,1341000.0
1341,1341999,21.360387248056735,37.638457249272484,0.08639367356711669,860.4523799419403,104.25202775001526,645.7369203567505,5461,1304,4157,4157,0,31,1342000.0
1342,1342999,21.35708072496112,37.6313178382608,0.0863894439602999,860.8614201545715,104.32455348968506,647.3468599319458,5461,1304,4157,4157,0,31,1343000.0
1343,1343999,21.352140002742903,37.62430604487751,0.08642352314600954,861.2297596931458,104.3974666595459,648.8519792556763,5463,1305,4158,4158,0,31,1344000.0
1344,1344999,21.347635316968006,37.61675334536833,0.08643810324839385,861.8592138290405,104.46863603591919,649.4605531692505,5463,1305,4158,4158,0,31,1345000.0
1345,1345999,21.343625633622956,37.61660345774059,0.08641044436113543,862.9506747722626,104.54253578186035,647.4339570999146,5467,1307,4160,4160,0,31,1346000.0
1346,1346999,21.34036438640276,37.60982398336101,0.08640922788377903,863.6958527565002,104.61493921279907,647.5969362258911,5467,1307,4160,4160,0,31,1347000.0
1347,1347999,21.337169969353234,37.60312422015315,0.08640143974997871,864.451422214508,104.68738293647766,647.2250566482544,5471,1309,4162,4162,0,31,1348000.0
1348,1348999,21.33342929527524,37.59614301493021,0.08639289302273256,868.6164152622223,104.76236081123352,647.254246711731,5471,1309,4162,4162,0,31,1349000.0
1349,1349999,21.33076576668313,37.59434272217909,0.08635020577860919,869.2908627986908,104.83914852142334,647.192967414856,5475,1311,4164,4164,0,31,1350000.0
1350,1350999,21.328860669974425,37.594286987648644,0.08632362340085797,869.8277459144592,104.91589045524597,647.4264650344849,5481,1314,4167,4167,0,31,1351000.0
1351,1351999,21.325830020257257,37.58835439530761,0.08631532211790538,870.3678913116455,104.99206256866455,648.5586671829224,5481,1314,4167,4167,0,31,1352000.0
1352,1352999,21.322538818933324,37.58119344233557,0.08630029475583822,871.0223486423492,105.06772804260254,649.1417512893677,5481,1314,4167,4167,0,31,1353000.0
1353,1353999,21.320698250945796,37.577826963889436,0.08626566638606459,872.0172221660614,105.14341354370117,648.1603670120239,5481,1314,4167,4167,0,31,1354000.0
1354,1354999,21.31940684721213,37.58509498977632,0.08618583421755444,872.6404006481171,105.22187900543213,648.6843996047974,5483,1315,4168,4168,0,31,1355000.0
1355,1355999,21.318015006867924,37.58047793574199,0.08617373702056141,873.5769975185394,105.30113983154297,647.6491060256958,5485,1316,4169,4169,0,31,1356000.0
1356,1356999,21.31639726250772,37.57625956828636,0.08614937097676956,874.0901052951813,105.3759515285492,648.5957231521606,5486,1317,4169,4169,0,31,1357000.0
1357,1357999,21.31730080570392,37.583457060332826,0.0860825092213805,874.702082157135,105.45349526405334,649.0826082229614,5487,1318,4169,4169,0,31,1358000.0
1358,1358999,21.31681612529408,37.58072820841606,0.08604399163600385,875.4546897411346,105.52946019172668,649.1950197219849,5487,1318,4169,4169,0,31,1359000.0
1359,1359999,21.316494651689954,37.577862946656744,0.08601348403509468,876.2045993804932,105.60687184333801,649.3937196731567,5487,1318,4169,4169,0,31,1360000.0
1360,1360999,21.31608206816509,37.574005403776184,0.08598020556328112,876.9507265090942,105.68251872062683,649.6081819534302,5487,1318,4169,4169,0,31,1361000.0
1361,1361999,21.314806952063716,37.568471564300744,0.08594984420259477,877.7026283740997,105.76296663284302,649.800145149231,5487,1318,4169,4169,0,31,1362000.0
1362,1362999,21.314931463407678,37.566752523138376,0.0858916360544022,878.3698627948761,105.83716130256653,649.822850227356,5491,1320,4171,4171,0,31,1363000.0
1363,1363999,21.313233570631866,37.56311334126342,0.08582033504138609,879.2200922966003,105.90710186958313,648.9322481155396,5493,1321,4172,4172,0,31,1364000.0
1364,1364999,21.312258633190204,37.56269238189509,0.08576842140589203,879.8218095302582,105.97970819473267,649.5257844924927,5495,1322,4173,4173,0,31,1365000.0
1365,1365999,21.31022703610021,37.558957991145185,0.08579656609826602,880.4135949611664,106.04973149299622,649.485692024231,5503,1326,4177,4177,0,31,1366000.0
1366,1366999,21.308567642564576,37.555827462764746,0.08578049262797549,881.1776938438416,106.12351727485657,649.73424243927,5503,1326,4177,4177,0,31,1367000.0
1367,1367999,21.309485114383946,37.55787602667396,0.08573931846776517,881.4632139205933,106.19393610954285,651.8033113479614,5505,1327,4178,4178,0,31,1368000.0
1368,1368999,21.308040299031425,37.555252777671924,0.08574343317835253,882.2041771411896,106.26606917381287,651.6617479324341,5507,1328,4179,4179,0,31,1369000.0
1369,1369999,21.307976947312973,37.554275362393426,0.085752652107697,882.936933517456,106.33706569671631,650.9249467849731,5533,1332,4201,4201,0,31,1370000.0
1370,1370999,21.30721508468029,37.55061230128255,0.08577925147922683,883.9505927562714,106.41177034378052,649.14293384552,5539,1335,4204,4204,0,31,1371000.0
1371,1371999,21.3057844688452,37.54532172373546,0.08581242453678928,884.9387028217316,106.48415637016296,648.2056245803833,5539,1335,4204,4204,0,31,1372000.0
1372,1372999,21.305337113677382,37.543213332487696,0.08583691713618014,885.5737164020538,106.55819416046143,648.9409303665161,5539,1335,4204,4204,0,31,1373000.0
1373,1373999,21.304149458621133,37.53931809891637,0.08583157006644859,886.0811817646027,106.63001418113708,649.9673051834106,5542,1336,4206,4206,0,31,1374000.0
1374,1374999,21.30340381423979,37.537257355651256,0.08585685862989345,886.9570708274841,106.701411485672,649.5219163894653,5542,1336,4206,4206,0,31,1375000.0
1375,1375999,21.301678687724323,37.530956217629054,0.08583988222391636,887.5330641269684,106.77395510673523,649.8816270828247,5547,1338,4209,4209,0,31,1376000.0
1376,1376999,21.300072901534655,37.52650965744605,0.08583559206396374,888.3964755535126,106.84544491767883,649.4118776321411,5547,1338,4209,4209,0,31,1377000.0
1377,1377999,21.29877970854421,37.52201422111668,0.08587036216377408,888.8206996917725,106.91934108734131,650.9946336746216,5547,1338,4209,4209,0,31,1378000.0
1378,1378999,21.298226336197427,37.520258898566695,0.08586866318268027,889.3496804237366,106.98861789703369,652.060772895813,5547,1338,4209,4209,0,31,1379000.0
1379,1379999,21.297350197946493,37.51496927755318,0.08586153082673464,889.9654543399811,107.06162357330322,652.5825548171997,5549,1339,4210,4210,0,31,1380000.0
1380,1380999,21.29632340189607,37.50934526498461,0.08588713614544807,890.611261844635,107.13249087333679,653.1279344558716,5549,1339,4210,4210,0,31,1381000.0
1381,1381999,21.293956718898013,37.50209314887131,0.08588174332917753,891.2590887546539,107.2067940235138,653.6676836013794,5549,1339,4210,4210,0,31,1382000.0
1382,1382999,21.29120822012557,37.494606454120444,0.08586874596444238,892.111275434494,107.28102421760559,653.1760606765747,5549,1339,4210,4210,0,31,1383000.0
1383,1383999,21.28951780828132,37.49147319011733,0.08575037278060482,892.6143214702606,107.35287809371948,654.3925981521606,5550,1339,4211,4211,0,31,1384000.0
1384,1384999,21.288486268894353,37.48710787162642,0.08557400905757184,893.5866253376007,107.42513823509216,652.895733833313,5555,1341,4214,4214,0,31,1385000.0
1385,1385999,21.28678595995395,37.48334813443307,0.08542917225114832,894.0726327896118,107.49631571769714,653.9728212356567,5557,1342,4215,4215,0,31,1386000.0
1386,1386999,21.285953358995428,37.4815865766804,0.08525451511596249,894.7738800048828,107.56789541244507,654.0189485549927,5559,1343,4216,4216,0,31,1387000.0
1387,1387999,21.283307810500236,37.47462279292815,0.08517788618071775,895.1219177246094,107.6376223564148,655.609715461731,5574,1345,4229,4229,0,31,1388000.0
1388,1388999,21.281026704034428,37.46873536089278,0.08512842376443774,895.8497121334076,107.70938229560852,654.3888597488403,5585,1350,4235,4235,0,31,1389000.0
1389,1389999,21.278081775171902,37.46197269782421,0.08504965423765565,896.7077598571777,107.78019976615906,653.961163520813,5585,1350,4235,4235,0,31,1390000.0
1390,1390999,21.274566257780823,37.45408132982523,0.08503444568053053,897.6206345558167,107.85151076316833,652.100209236145,5625,1355,4270,4270,0,31,1391000.0
1391,1391999,21.271378818825664,37.44811275137091,0.08498149353423523,898.2447881698608,107.92446565628052,652.662823677063,5627,1356,4271,4271,0,31,1392000.0
1392,1392999,21.267650002370793,37.440475899616416,0.08497486862808856,899.2213134765625,107.99672412872314,651.807957649231,5627,1356,4271,4271,0,31,1393000.0
1393,1393999,21.26451510332413,37.434246634505236,0.08494150008038293,899.7615065574646,108.06726694107056,652.9030809402466,5627,1356,4271,4271,0,31,1394000.0
1394,1394999,21.262132850695195,37.431761870293,0.08487789573280646,900.2594153881073,108.13931274414062,654.028172492981,5629,1357,4272,4272,0,31,1395000.0
1395,1395999,21.261822013038618,37.435556546499704,0.0847815475969027,900.8116819858551,108.21053910255432,655.1195039749146,5629,1357,4272,4272,0,31,1396000.0
1396,1396999,21.264395764462,37.44552324363862,0.08462851464872734,901.6852927207947,108.28546667098999,654.6878328323364,5629,1357,4272,4272,0,31,1397000.0
1397,1397999,21.268070523316094,37.457658823691155,0.08445238339452565,902.3672511577606,108.35855603218079,654.6278429031372,5633,1359,4274,4274,0,31,1398000.0
1398,1398999,21.272075747586374,37.46956210832872,0.08430273038684621,903.3211879730225,108.43075132369995,653.2059831619263,5639,1362,4277,4277,0,31,1399000.0
1399,1399999,21.274884348324985,37.47441502924125,0.084198155341903,903.9888370037079,108.5013599395752,653.2594194412231,5644,1364,4280,4280,0,31,1400000.0
1400,1400999,21.279570394031325,37.484379734797855,0.08414867222564781,904.4573287963867,108.5733413696289,654.26695728302,5659,1366,4293,4293,0,31,1401000.0
1401,1401999,21.281412794595038,37.48655615253753,0.08411220936241326,905.1769504547119,108.64640879631042,654.3503999710083,5661,1367,4294,4294,0,31,1402000.0
1402,1402999,21.283569912866316,37.488634481136835,0.08412799233133095,905.8263468742371,108.71861934661865,654.9256258010864,5661,1367,4294,4294,0,31,1403000.0
1403,1403999,21.284931466402476,37.49245793846351,0.0840692165410567,906.4452660083771,108.7903573513031,655.4571580886841,5663,1368,4295,4295,0,31,1404000.0
1404,1404999,21.28723465215101,37.491241161830885,0.08375893194693607,907.3794219493866,108.86163473129272,654.2349519729614,5666,1369,4297,4297,0,31,1405000.0
1405,1405999,21.292615605445853,37.49260933946893,0.0832904762691119,907.9344494342804,108.93356657028198,654.7231111526489,5672,1371,4301,4301,0,31,1406000.0
1406,1406999,21.296496716943448,37.491370270285955,0.08293196080259713,908.309413433075,109.00476288795471,656.3465394973755,5674,1372,4302,4302,0,31,1407000.0
1407,1407999,21.29905258761997,37.4921446449415,0.08253618689342834,909.1506814956665,109.07569122314453,655.3728075027466,5681,1375,4306,4306,0,31,1408000.0
1408,1408999,21.2988740894031,37.488406645571914,0.08232005811296039,909.5400547981262,109.14595365524292,656.9830904006958,5683,1376,4307,4307,0,31,1409000.0
1409,1409999,21.298168946782265,37.485061261155664,0.08212128398613927,909.9651262760162,109.21666836738586,657.9560060501099,5689,1379,4310,4310,0,31,1410000.0
1410,1410999,21.295775447359897,37.47910274677403,0.08200011751738567,914.3483231067657,109.28916239738464,657.2109041213989,5693,1381,4312,4312,0,31,1411000.0
1411,1411999,21.294536230789515,37.4750994237443,0.08185926100867658,914.8391439914703,109.36135458946228,658.2860536575317,5695,1382,4313,4313,0,31,1412000.0
1412,1412999,21.29271523275493,37.47163210525739,0.08176870377241341,915.5219292640686,109.43558549880981,658.2523241043091,5699,1384,4315,4315,0,31,1413000.0
1413,1413999,21.290830056863726,37.4685926473907,0.08169430575037917,916.1224727630615,109.50663447380066,658.892804145813,5702,1385,4317,4317,0,31,1414000.0
1414,1414999,21.2920426528537,37.47762775041692,0.08166410184379291,916.9148018360138,109.57854270935059,658.4060564041138,5706,1387,4319,4319,0,31,1415000.0
1415,1415999,21.293390006565136,37.492601684731945,0.08156839528981186,917.6088840961456,109.65259099006653,658.2739686965942,5721,1389,4332,4332,0,31,1416000.0
1416,1416999,21.294067735862086,37.49595198963971,0.08155980013021402,918.3634312152863,109.72413897514343,658.368504524231,5721,1389,4332,4332,0,31,1417000.0
1417,1417999,21.296847324445004,37.50767640740739,0.08149602310268678,918.9969375133514,109.79637455940247,658.9450273513794,5721,1389,4332,4332,0,31,1418000.0
1418,1418999,21.300218428115613,37.51996744026042,0.08135849541020868,919.6381952762604,109.86745429039001,659.5063219070435,5721,1389,4332,4332,0,31,1419000.0
1419,1419999,21.302742005913395,37.5254137891619,0.08126956042736977,920.4534769058228,109.9406988620758,659.0197114944458,5723,1390,4333,4333,0,31,1420000.0
1420,1420999,21.309514830365565,37.545166506374265,0.08114242007451444,920.8945710659027,110.01934695243835,660.5947694778442,5723,1390,4333,4333,0,31,1421000.0
1421,1421999,21.315025706276355,37.55595493980713,0.08109089130227298,921.6069099903107,110.09180402755737,660.6281862258911,5725,1391,4334,4334,0,31,1422000.0
1422,1422999,21.320045391763504,37.564255203665724,0.08106706260088836,922.2471370697021,110.16457653045654,661.1853837966919,5725,1391,4334,4334,0,31,1423000.0
1423,1423999,21.326855545255604,37.57568625895043,0.08094899395786903,922.9883787631989,110.23724865913391,661.2685594558716,5725,1391,4334,4334,0,31,1424000.0
1424,1424999,21.32840233512601,37.57564017385625,0.08088134010420767,923.6342484951019,110.3132438659668,661.8035707473755,5725,1391,4334,4334,0,31,1425000.0
1425,1425999,21.33453597309235,37.588725520244736,0.08026442863620686,924.1555120944977,110.38665676116943,662.9232988357544,5726,1391,4335,4335,0,31,1426000.0
1426,1426999,21.338033427224406,37.595899216055436,0.07979428708790892,924.9931766986847,110.46224164962769,661.8716402053833,5736,1394,4342,4342,0,31,1427000.0
1427,1427999,21.340392865633444,37.59888911193942,0.07938207186115687,925.5925569534302,110.53618454933167,662.510365486145,5738,1395,4343,4343,0,31,1428000.0
1428,1428999,21.342360569932683,37.60280478170218,0.07902433858592717,926.2256388664246,110.6098952293396,662.4475984573364,5745,1398,4347,4347,0,31,1429000.0
1429,1429999,21.342718795605425,37.60290676401274,0.07880814610285625,926.8667521476746,110.68443274497986,663.0492601394653,5745,1398,4347,4347,0,31,1430000.0
1430,1430999,21.343075009382854,37.6012347672077,0.07859783572937384,927.4187016487122,110.76109743118286,664.1427049636841,5745,1398,4347,4347,0,31,1431000.0
1431,1431999,21.343119584832955,37.599901691397385,0.07842251715849269,928.160790681839,110.83432173728943,664.194806098938,5745,1398,4347,4347,0,31,1432000.0
1432,1432999,21.343793581305146,37.60070154294503,0.07813273013056987,928.9885611534119,110.91086053848267,663.2261018753052,5750,1401,4349,4349,0,31,1433000.0
1433,1433999,21.344320530881756,37.59981780937617,0.0779142832150147,929.7650871276855,110.98620772361755,662.6497316360474,5772,1404,4368,4368,0,31,1434000.0
1434,1434999,21.343677370489686,37.59706977418979,0.0778150807006176,930.491054058075,111.06246018409729,662.6863832473755,5774,1405,4369,4369,0,31,1435000.0
1435,1435999,21.343874789202374,37.5950129519664,0.07767875895058907,931.1117868423462,111.14157176017761,663.1794481277466,5775,1406,4369,4369,0,31,1436000.0
1436,1436999,21.344050197352285,37.5938987850819,0.07758755003294604,931.8358716964722,111.21835017204285,663.2443056106567,5778,1407,4371,4371,0,31,1437000.0
1437,1437999,21.344521191408397,37.592683498513,0.07745306350706982,932.4875626564026,111.29317593574524,663.8317079544067,5778,1407,4371,4371,0,31,1438000.0
1438,1438999,21.346056142616018,37.59346044402831,0.07735042914370194,933.290819644928,111.37132787704468,663.0702257156372,5782,1409,4373,4373,0,31,1439000.0
1439,1439999,21.347714966657925,37.593045002477304,0.07730088259853496,933.8257827758789,111.45187616348267,664.2239656448364,5782,1409,4373,4373,0,31,1440000.0
1440,1440999,21.349961387547165,37.5954966095539,0.077254193031424,934.7684118747711,111.52931761741638,663.3073854446411,5796,1410,4386,4386,0,31,1441000.0
1441,1441999,21.35315353616537,37.598204883531764,0.0772307383862123,935.3916957378387,111.60722303390503,663.8412828445435,5798,1411,4387,4387,0,31,1442000.0
1442,1442999,21.355268558154727,37.598488212527684,0.07717395901579349,936.0037772655487,111.6848623752594,664.2965440750122,5799,1412,4387,4387,0,31,1443000.0
1443,1443999,21.358441312164693,37.60090818903952,0.07714115786077824,936.8348293304443,111.76286840438843,663.8236513137817,5802,1413,4389,4389,0,31,1444000.0
1444,1444999,21.3623310667048,37.60775518190161,0.07714079279502284,937.402396440506,111.84191751480103,664.330304145813,5808,1415,4393,4393,0,31,1445000.0
1445,1445999,21.3638409093085,37.605953426078344,0.07711692586009133,938.0109009742737,111.92031407356262,664.8355836868286,5810,1416,4394,4394,0,31,1446000.0
1446,1446999,21.36406159372629,37.6051395837133,0.07694932795029596,938.3613104820251,111.99112057685852,666.6855211257935,5828,1417,4411,4411,0,31,1447000.0
1447,1447999,21.365620744911784,37.6119873494512,0.07673793197198742,938.8270320892334,112.06134176254272,667.9279375076294,5832,1418,4414,4414,0,31,1448000.0
1448,1448999,21.365031348455194,37.60805155092692,0.07661398020533439,939.2439630031586,112.13421440124512,669.6185121536255,5833,1418,4415,4415,0,31,1449000.0
1449,1449999,21.364934659621788,37.608922945023544,0.0765069006853848,939.9720199108124,112.20651030540466,668.8321733474731,5845,1423,4422,4422,0,31,1450000.0
1450,1450999,21.364591394037333,37.608163119024006,0.07645784698922253,940.5513210296631,112.27769255638123,669.6504030227661,5847,1424,4423,4423,0,31,1451000.0
1451,1451999,21.363887037581442,37.60839454949154,0.0763753162643388,941.4679973125458,112.35204744338989,668.7940874099731,5849,1425,4424,4424,0,31,1452000.0
1452,1452999,21.364105832282917,37.60696430638966,0.07628258051279213,941.973756313324,112.42280077934265,669.9826402664185,5851,1426,4425,4425,0,31,1453000.0
1453,1453999,21.363933035101663,37.62471321978979,0.07616347449472671,942.4586110115051,112.49400734901428,671.1632966995239,5853,1427,4426,4426,0,31,1454000.0
1454,1454999,21.363888309158078,37.6252819680924,0.07612721732229977,943.1024641990662,112.56629753112793,671.3689699172974,5855,1428,4427,4427,0,31,1455000.0
1455,1455999,21.364576228305257,37.625301647638736,0.07606242972426591,943.7058339118958,112.64053177833557,671.9492540359497,5857,1429,4428,4428,0,31,1456000.0
1456,1456999,21.366111407705606,37.638932277353916,0.07599783753713851,944.418897151947,112.71324729919434,672.0116395950317,5859,1430,4429,4429,0,31,1457000.0
1457,1457999,21.3669954873339,37.64070293888038,0.07594546755143272,945.2155976295471,112.78586292266846,671.3868684768677,5863,1432,4431,4431,0,31,1458000.0
1458,1458999,21.369021391222816,37.65655623784003,0.07587476351913292,945.7027409076691,112.85817170143127,672.4633302688599,5865,1433,4432,4432,0,31,1459000.0
1459,1459999,21.373101395745454,37.679481468242514,0.07578008650808632,946.377028465271,112.93037366867065,672.4819459915161,5870,1435,4435,4435,0,31,1460000.0
1460,1460999,21.376069702283033,37.700179327055956,0.07564492240344434,946.5840861797333,113.0038194656372,675.1078157424927,5870,1435,4435,4435,0,31,1461000.0
1461,1461999,21.37872600285763,37.70566665464332,0.07555073905110687,947.5525925159454,113.07611417770386,674.1267213821411,5870,1435,4435,4435,0,31,1462000.0
1462,1462999,21.38192763655589,37.717181867662624,0.07547167614930761,948.315913438797,113.14948773384094,673.7091646194458,5874,1437,4437,4437,0,31,1463000.0
1463,1463999,21.384654061956617,37.719670657492856,0.07533587271352449,949.0055963993073,113.22190737724304,673.8416337966919,5880,1438,4442,4442,0,31,1464000.0
1464,1464999,21.386492215458574,37.72692608861271,0.0752855851143428,949.9165797233582,113.29424405097961,673.0387163162231,5887,1439,4448,4448,0,31,1465000.0
1465,1465999,21.390624776486796,37.74023202907289,0.07523204261770777,950.2287957668304,113.3677294254303,675.2295045852661,5890,1439,4451,4451,0,31,1466000.0
1466,1466999,21.393920822915064,37.751044120038394,0.07516953045137087,950.7658317089081,113.44139885902405,676.3690996170044,5894,1439,4455,4455,0,31,1467000.0
1467,1467999,21.400165781143286,37.770237431979886,0.07505266773408437,951.4781742095947,113.51447606086731,676.5470628738403,5896,1440,4456,4456,0,31,1468000.0
1468,1468999,21.402857888359936,37.776568051248155,0.0750402665752199,952.2622935771942,113.58858680725098,676.050087928772,5902,1442,4460,4460,0,31,1469000.0
1469,1469999,21.40619754981059,37.784197830624265,0.07503945877185447,952.8374314308167,113.66354727745056,676.5431909561157,5906,1444,4462,4462,0,31,1470000.0
1470,1470999,21.411810725133428,37.79477816337255,0.07501830334110482,953.5173590183258,113.73678588867188,676.4506311416626,5910,1446,4464,4464,0,31,1471000.0
1471,1471999,21.418576078011167,37.80965209401568,0.07499834892621893,954.1343417167664,113.81219911575317,676.9582986831665,5913,1447,4466,4466,0,31,1472000.0
1472,1472999,21.424865370165776,37.832591990533814,0.0750061936498625,954.6827437877655,113.88600492477417,678.0413293838501,5913,1447,4466,4466,0,31,1473000.0
1473,1473999,21.429445568470037,37.840347085198424,0.07500756075532367,958.9373366832733,113.96110343933105,678.573166847229,5916,1448,4468,4468,0,31,1474000.0
1474,1474999,21.436459312480036,37.85628776176596,0.07502081476931599,959.4703097343445,114.03521394729614,679.6650323867798,5916,1448,4468,4468,0,31,1475000.0
1475,1475999,21.44401738327665,37.87365579796857,0.07504598899332249,960.2000784873962,114.11071300506592,679.6340646743774,5921,1449,4472,4472,0,31,1476000.0
1476,1476999,21.451265977077824,37.885864313291606,0.0751865966650499,960.69304728508,114.18782091140747,680.663857460022,5924,1450,4474,4474,0,31,1477000.0
1477,1477999,21.45863617091858,37.89594048582347,0.07523456868279843,961.6184484958649,114.26259303092957,679.6369791030884,5926,1451,4475,4475,0,31,1478000.0
1478,1478999,21.46492567538934,37.9145107198799,0.07525927323453485,962.2525162696838,114.33612442016602,679.5222864151001,5934,1454,4480,4480,0,31,1479000.0
1479,1479999,21.472789405852858,37.929658462004966,0.07537685398780758,963.110184431076,114.4127197265625,679.0610666275024,5934,1454,4480,4480,0,31,1480000.0
1480,1480999,21.474234510006088,37.931490253544105,0.07536773694981602,963.5831122398376,114.485769033432,680.1977701187134,5939,1455,4484,4484,0,31,1481000.0
1481,1481999,21.47239026499297,37.933321767411286,0.07531829863774775,964.0443680286407,114.55906701087952,681.3954019546509,5945,1456,4489,4489,0,31,1482000.0
1482,1482999,21.469697233589972,37.931824181229004,0.07528674196449125,964.5150094032288,114.63253712654114,682.6546487808228,5960,1457,4503,4503,0,31,1483000.0
1483,1483999,21.46601929755707,37.92883313847388,0.07527770614184925,964.811619758606,114.70649600028992,684.9281702041626,5961,1457,4504,4504,0,31,1484000.0
1484,1484999,21.46389733240594,37.92645167438253,0.07525810534611344,965.4143040180206,114.78098034858704,685.2692346572876,5972,1460,4512,4512,0,31,1485000.0
1485,1485999,21.461126071712805,37.92356149521971,0.07526617921300838,966.1902070045471,114.85590648651123,684.8378839492798,5979,1462,4517,4517,0,31,1486000.0
1486,1486999,21.457609265254526,37.9170723292234,0.07527164678718878,966.6834120750427,114.93145513534546,685.9657678604126,5982,1463,4519,4519,0,31,1487000.0
1487,1487999,21.454995372259965,37.913299912965456,0.07526818133187285,967.5182065963745,115.00744819641113,685.8106317520142,5982,1463,4519,4519,0,31,1488000.0
1488,1488999,21.453930792502277,37.9143875945107,0.07527356708121313,968.234082698822,115.08214592933655,685.8185434341431,5986,1465,4521,4521,0,31,1489000.0
1489,1489999,21.453933677061077,37.920946549974786,0.07524399816372163,968.7338788509369,115.15623307228088,686.8802576065063,5988,1466,4522,4522,0,31,1490000.0
1490,1490999,21.45365295828157,37.92283106910824,0.07521975817265558,969.4434430599213,115.23163223266602,686.914719581604,5990,1467,4523,4523,0,31,1491000.0
1491,1491999,21.45266078652519,37.92188606924785,0.07522145917321921,970.2284302711487,115.30864262580872,686.4988565444946,6010,1469,4541,4541,0,31,1492000.0
1492,1492999,21.452840705036767,37.92319072870874,0.07523551971122167,971.0161836147308,115.38328695297241,686.3754739761353,6012,1470,4542,4542,0,31,1493000.0
1493,1493999,21.453432558445385,37.92404150522911,0.07531244723854424,971.4068439006805,115.45733690261841,687.9336938858032,6014,1471,4543,4543,0,31,1494000.0
1494,1494999,21.455025670471684,37.926366088730745,0.07539875425633757,972.0452787876129,115.53224277496338,688.5196695327759,6014,1471,4543,4543,0,31,1495000.0
1495,1495999,21.456950281302102,37.930379498408705,0.07549468521090297,972.6864128112793,115.60596227645874,689.0963830947876,6014,1471,4543,4543,0,31,1496000.0
1496,1496999,21.458046046853852,37.92997455451258,0.07553523911960369,973.3215425014496,115.68165636062622,689.6658487319946,6014,1471,4543,4543,0,31,1497000.0
1497,1497999,21.461582725951516,37.94013947251729,0.0755219085146005,973.851859331131,115.75946187973022,690.7408685684204,6014,1471,4543,4543,0,31,1498000.0
1498,1498999,21.46505722380784,37.94436489519671,0.07565854356761692,974.4187994003296,115.83368873596191,691.1627054214478,6018,1473,4545,4545,0,31,1499000.0
1499,1499999,21.466546253585772,37.94456648052799,0.07572853937258617,974.8463709354401,115.90774607658386,692.7656564712524,6018,1473,4545,4545,0,31,1500000.0
1500,1500999,21.466749593644817,37.95215006765857,0.07573068395423532,975.4363861083984,115.98052597045898,693.3517618179321,6026,1474,4552,4552,0,31,1501000.0
1501,1501999,21.463894120091144,37.957533753289916,0.07565396305424077,976.2280368804932,116.0515513420105,693.0346841812134,6032,1475,4557,4557,0,31,1502000.0
1502,1502999,21.459535051268332,37.95232978838119,0.07564585765378073,976.7144577503204,116.12268161773682,694.1319665908813,6037,1476,4561,4561,0,31,1503000.0
1503,1503999,21.455489583649367,37.94547019380397,0.07563528555717614,977.2213907241821,116.1925151348114,695.4700479507446,6038,1476,4562,4562,0,31,1504000.0
1504,1504999,21.45150562766107,37.939281416818545,0.07563494039351715,977.8122758865356,116.26244044303894,696.1320276260376,6040,1477,4563,4563,0,31,1505000.0
1505,1505999,21.449187178727623,37.93969428204532,0.07558542433162463,978.2939882278442,116.3337140083313,697.0470972061157,6073,1479,4594,4594,0,31,1506000.0
1506,1506999,21.446172003999628,37.93457761086761,0.07557447540812823,978.9698214530945,116.40426898002625,697.4540796279907,6076,1480,4596,4596,0,31,1507000.0
1507,1507999,21.443307588954625,37.930336453236784,0.07555486682666257,979.7918136119843,116.47650194168091,697.0573358535767,6078,1481,4597,4597,0,31,1508000.0
1508,1508999,21.440603372006926,37.92501252493019,0.07553406569256793,980.543288230896,116.5497317314148,697.1522302627563,6078,1481,4597,4597,0,31,1509000.0
1509,1509999,21.437756792302846,37.919716148965044,0.07551531516224907,981.0753211975098,116.61996102333069,698.239556312561,6078,1481,4597,4597,0,31,1510000.0
1510,1510999,21.43530860639479,37.91397985702562,0.07550668486710688,981.4571635723114,116.69131970405579,699.5858545303345,6107,1483,4624,4624,0,31,1511000.0
1511,1511999,21.43353034063725,37.91184006639758,0.07549925010297454,982.6016929149628,116.76416301727295,697.2209329605103,6111,1485,4626,4626,0,31,1512000.0
1512,1512999,21.431486949785253,37.90908642572387,0.07549188810746443,983.1107926368713,116.8360013961792,698.267861366272,6113,1486,4627,4627,0,31,1513000.0
1513,1513999,21.430106750770502,37.90590369908151,0.07548306650190983,983.7404825687408,116.90881752967834,698.6040277481079,6115,1487,4628,4628,0,31,1514000.0
1514,1514999,21.429434686328193,37.90661053736797,0.07546673641852375,984.483865737915,116.97984218597412,698.6688852310181,6115,1487,4628,4628,0,31,1515000.0
1515,1515999,21.428805729754252,37.90392477942235,0.07547395226558862,985.4202756881714,117.05238509178162,697.6234674453735,6117,1488,4629,4629,0,31,1516000.0
1516,1516999,21.42819952915863,37.90136337426608,0.07549841622308762,985.848629951477,117.12276721000671,699.2180261611938,6117,1488,4629,4629,0,31,1517000.0
1517,1517999,21.428793192366232,37.90066404069211,0.07552519501725918,986.5983266830444,117.19559168815613,699.2643060684204,6117,1488,4629,4629,0,31,1518000.0
1518,1518999,21.430578419551807,37.90108164020881,0.0755370774495614,987.421070098877,117.27184796333313,698.7623987197876,6119,1489,4630,4630,0,31,1519000.0
1519,1519999,21.432446544602385,37.902238716435875,0.07555088125793619,988.0685749053955,117.342693567276,699.3128747940063,6119,1489,4630,4630,0,31,1520000.0
1520,1520999,21.433090882101496,37.901361907181844,0.07556512178334451,988.8136203289032,117.41486382484436,699.3308572769165,6119,1489,4630,4630,0,31,1521000.0
1521,1521999,21.4320387200353,37.89809120304354,0.07553269902677606,989.3781490325928,117.48546719551086,699.7151117324829,6132,1491,4641,4641,0,31,1522000.0
1522,1522999,21.429187383210053,37.902203480337334,0.07544301682271792,989.7903161048889,117.55558037757874,701.4220666885376,6137,1491,4646,4646,0,31,1523000.0
1523,1523999,21.425574404538963,37.89969143487208,0.0753940668022377,990.0910513401031,117.6251573562622,703.6249780654907,6139,1491,4648,4648,0,31,1524000.0
1524,1524999,21.420925314078545,37.89227740938773,0.07537551634833628,990.5167343616486,117.69624376296997,705.249924659729,6140,1491,4649,4649,0,31,1525000.0
1525,1525999,21.415759575753718,37.883901932371735,0.07540237256159543,991.6184833049774,117.76829648017883,703.2585000991821,6144,1493,4651,4651,0,31,1526000.0
1526,1526999,21.411312483187295,37.87715984591902,0.07542120677496111,992.0787167549133,117.8380434513092,704.6018304824829,6147,1494,4653,4653,0,31,1527000.0
1527,1527999,21.407018114678333,37.86986754444971,0.07543645118190834,992.4041121006012,117.9086000919342,706.7360315322876,6147,1494,4653,4653,0,31,1528000.0
1528,1528999,21.402560550050637,37.86209922983817,0.07545240678436893,993.078207731247,117.9791464805603,706.7129068374634,6151,1496,4655,4655,0,31,1529000.0
1529,1529999,21.398372791419813,37.85497398736527,0.07546893274051325,993.9543933868408,118.05194401741028,705.7644510269165,6156,1498,4658,4658,0,31,1530000.0
1530,1530999,21.394402871532474,37.84985979441511,0.07546608707729496,994.7139809131622,118.12518811225891,705.4659204483032,6161,1500,4661,4661,0,31,1531000.0
1531,1531999,21.391029068764755,37.844122544401905,0.0754671946791079,995.4242632389069,118.19817399978638,705.4724359512329,6164,1501,4663,4663,0,31,1532000.0
1532,1532999,21.386634901117436,37.836770662499866,0.07548586030492799,995.7496213912964,118.2692244052887,707.6137552261353,6164,1501,4663,4663,0,31,1533000.0
1533,1533999,21.3829464583536,37.82953241669506,0.07549472223068687,996.1954257488251,118.34008979797363,709.2325220108032,6164,1501,4663,4663,0,31,1534000.0
1534,1534999,21.379221104608686,37.824134968157765,0.07548977350267783,996.9862294197083,118.41301107406616,708.7270822525024,6168,1503,4665,4665,0,31,1535000.0
1535,1535999,21.376784490971705,37.819943536390994,0.07547415005986624,998.0452432632446,118.48530173301697,707.3697671890259,6168,1503,4665,4665,0,31,1536000.0
1536,1536999,21.37561468811703,37.817807129303254,0.07546020941881748,1002.5738680362701,118.55725073814392,707.3868951797485,6170,1504,4666,4666,0,31,1537000.0
1537,1537999,21.37362007330074,37.81367871598168,0.07545680544455247,1003.0015821456909,118.63249444961548,708.9761056900024,6170,1504,4666,4666,0,31,1538000.0
1538,1538999,21.372136048126414,37.80899977868017,0.07545927764420524,1003.9959394931793,118.70728516578674,707.9827127456665,6170,1504,4666,4666,0,31,1539000.0
1539,1539999,21.37066428797623,37.80481282171673,0.07546295853164275,1004.5346019268036,118.78133654594421,709.0439920425415,6170,1504,4666,4666,0,31,1540000.0
1540,1540999,21.369261249707087,37.801223717536665,0.075471095062291,1005.1310532093048,118.85424065589905,709.242959022522,6174,1506,4668,4668,0,31,1541000.0
1541,1541999,21.36684210847561,37.795442633683145,0.07548087053415875,1006.0790135860443,118.93007254600525,708.4589242935181,6174,1506,4668,4668,0,31,1542000.0
1542,1542999,21.363484915134645,37.7877837405697,0.07546527326227936,1006.8107557296753,119.00407814979553,708.6651849746704,6188,1506,4682,4682,0,31,1543000.0
1543,1543999,21.361490165110073,37.786141471175554,0.07536617861015482,1007.2831332683563,119.07703900337219,709.8372507095337,6195,1507,4688,4688,0,31,1544000.0
1544,1544999,21.358829934197388,37.7798156030977,0.07532215344498583,1007.6628220081329,119.14663529396057,711.4819498062134,6197,1508,4689,4689,0,31,1545000.0
1545,1545999,21.35493980281134,37.77283455632858,0.07532814948665467,1008.2487463951111,119.21965289115906,711.5833673477173,6212,1512,4700,4700,0,31,1546000.0
1546,1546999,21.352697638892973,37.76813443980588,0.07531033858498204,1008.8324775695801,119.29009556770325,712.3928308486938,6215,1513,4702,4702,0,31,1547000.0
1547,1547999,21.351230058404177,37.76612953500142,0.0753031539344271,1009.2621858119965,119.36159133911133,714.0759439468384,6215,1513,4702,4702,0,31,1548000.0
1548,1548999,21.350485350546098,37.76403143760736,0.07536751971793287,1010.2925436496735,119.43528604507446,712.8036737442017,6220,1515,4705,4705,0,31,1549000.0
1549,1549999,21.350510537860757,37.767161054750375,0.07542012044186541,1010.7586667537689,119.50830507278442,713.797646522522,6224,1517,4707,4707,0,31,1550000.0
1550,1550999,21.34903865412461,37.76685987708515,0.07553045150625193,1011.3716280460358,119.58201956748962,714.3477258682251,6226,1518,4708,4708,0,31,1551000.0
1551,1551999,21.350142456694847,37.7742959108227,0.07567759638677263,1012.1081826686859,119.65845441818237,714.4372568130493,6228,1519,4709,4709,0,31,1552000.0
1552,1552999,21.349980138478188,37.7769194075991,0.07578160448569715,1012.7269864082336,119.73100781440735,714.8965082168579,6230,1520,4710,4710,0,31,1553000.0
1553,1553999,21.352446482648638,37.788688392592185,0.07611131901511137,1013.2080452442169,119.80375099182129,715.393723487854,6236,1523,4713,4713,0,31,1554000.0
1554,1554999,21.354870813401913,37.79890327898996,0.07647907636132234,1013.973965883255,119.87965655326843,715.1001214981079,6238,1524,4714,4714,0,31,1555000.0
1555,1555999,21.356946393435273,37.80733753442132,0.07670113890694952,1015.0041146278381,119.95326375961304,713.6682443618774,6240,1525,4715,4715,0,31,1556000.0
1556,1556999,21.358555987024346,37.81346317774655,0.0768624833617183,1015.6344983577728,120.02750158309937,714.2678918838501,6240,1525,4715,4715,0,31,1557000.0
1557,1557999,21.36064382708989,37.821685300366056,0.07696424968226645,1016.0947043895721,120.1019971370697,715.6997919082642,6243,1526,4717,4717,0,31,1558000.0
1558,1558999,21.361625725038998,37.822819709420344,0.0770646542875113,1016.5878648757935,120.17473030090332,716.7994699478149,6246,1527,4719,4719,0,31,1559000.0
1559,1559999,21.363608383267472,37.82684787039513,0.07713918757826388,1017.0891087055206,120.24626040458679,717.8462152481079,6249,1528,4721,4721,0,31,1560000.0
1560,1560999,21.366230965811862,37.833953087954086,0.07714205356712611,1018.0327639579773,120.31904792785645,717.1454858779907,6249,1528,4721,4721,0,31,1561000.0
1561,1561999,21.368211580208186,37.83592591993017,0.07723444672007929,1018.3240020275116,120.39288377761841,719.4600992202759,6249,1528,4721,4721,0,31,1562000.0
1562,1562999,21.367100712581312,37.83244142526663,0.07722353591579345,1019.5070331096649,120.4674162864685,717.4844675064087,6249,1528,4721,4721,0,31,1563000.0
1563,1563999,21.364663846690153,37.83066017842573,0.07723086717462546,1020.0995814800262,120.54449009895325,718.1566400527954,6258,1529,4729,4729,0,31,1564000.0
1564,1564999,21.36372357270199,37.83131712970267,0.07721135985845728,1020.6153779029846,120.61811709403992,719.3347330093384,6259,1529,4730,4730,0,31,1565000.0
1565,1565999,21.363611655609976,37.8305406633447,0.07722869264477539,1020.9421300888062,120.69526076316833,721.0674829483032,6277,1531,4746,4746,0,31,1566000.0
1566,1566999,21.365062313808163,37.83221384234896,0.0772487664738516,1021.400420665741,120.77250480651855,722.1421213150024,6312,1533,4779,4779,0,31,1567000.0
1567,1567999,21.366509599192494,37.83213431298565,0.07726624243149227,1022.1412353515625,120.84787511825562,722.2893838882446,6312,1533,4779,4779,0,31,1568000.0
1568,1568999,21.367963974405228,37.833236334255076,0.07726896979520903,1022.4571824073792,120.92170190811157,724.4526224136353,6312,1533,4779,4779,0,31,1569000.0
1569,1569999,21.369716931676077,37.835426056288306,0.07729028821016493,1023.1299889087677,120.99817943572998,724.5050210952759,6316,1535,4781,4781,0,31,1570000.0
1570,1570999,21.370923458169177,37.836598197717656,0.07732087064610649,1023.6291272640228,121.07372879981995,725.6102457046509,6318,1536,4782,4782,0,31,1571000.0
1571,1571999,21.373258042564903,37.8381555140384,0.0773460913177052,1024.4950263500214,121.15168571472168,724.5090646743774,6324,1539,4785,4785,0,31,1572000.0
1572,1572999,21.37683796727159,37.842936617274454,0.07740368796282371,1025.5516939163208,121.23131895065308,723.1974115371704,6324,1539,4785,4785,0,31,1573000.0
1573,1573999,21.382545163696108,37.86136820320722,0.0774352361075854,1026.1568660736084,121.31023979187012,723.7533655166626,6326,1540,4786,4786,0,31,1574000.0
1574,1574999,21.388005263713445,37.86980443342181,0.07751520149117486,1026.7969253063202,121.38907074928284,723.7108316421509,6333,1543,4790,4790,0,31,1575000.0
1575,1575999,21.394254470650505,37.88553839501691,0.07764651437166625,1027.1956493854523,121.4633116722107,725.2410821914673,6335,1544,4791,4791,0,31,1576000.0
1576,1576999,21.4024968365245,37.90702303221412,0.07773823580183692,1027.8794031143188,121.5389928817749,725.2738962173462,6340,1546,4794,4794,0,31,1577000.0
1577,1577999,21.408223564273538,37.91469758099268,0.07785097285794373,1028.7157638072968,121.616446018219,724.7642679214478,6342,1547,4795,4795,0,31,1578000.0
1578,1578999,21.41298811257025,37.91989650912325,0.07802460488297325,1029.3546214103699,121.69370889663696,725.3530130386353,6342,1547,4795,4795,0,31,1579000.0
1579,1579999,21.42046222835706,37.93005748906979,0.07820744723698458,1030.0333173274994,121.76828980445862,725.3341760635376,6346,1549,4797,4797,0,31,1580000.0
1580,1580999,21.427234683640606,37.93789106929255,0.0783574725736732,1030.6654024124146,121.84837198257446,726.0256128311157,6346,1549,4797,4797,0,31,1581000.0
1581,1581999,21.434783065414432,37.94647087427986,0.07856448927357862,1031.4981615543365,121.92577362060547,725.5166177749634,6348,1550,4798,4798,0,31,1582000.0
1582,1582999,21.44219592526399,37.955239872714465,0.07877917387742328,1032.1002354621887,122.00226402282715,726.0586023330688,6350,1551,4799,4799,0,31,1583000.0
1583,1583999,21.444558746338185,37.95586711021822,0.07884566716802666,1032.923835992813,122.07690215110779,726.0181818008423,6366,1551,4815,4815,0,31,1584000.0
1584,1584999,21.44097206556386,37.94902128443046,0.07879588473991328,1033.308843612671,122.14822912216187,727.8636713027954,6369,1551,4818,4818,0,31,1585000.0
1585,1585999,21.436446256137916,37.9409104577783,0.07879079950654844,1033.65158700943,122.21819186210632,729.7874460220337,6373,1552,4821,4821,0,31,1586000.0
1586,1586999,21.433148733155964,37.93560213163945,0.0787786516898823,1034.0462613105774,122.29002594947815,731.4629602432251,6378,1553,4825,4825,0,31,1587000.0
1587,1587999,21.42980950711001,37.93272112434122,0.0787587857559241,1035.2040703296661,122.36448526382446,728.6767816543579,6388,1558,4830,4830,0,31,1588000.0
1588,1588999,21.42734246827175,37.929045611068105,0.07873637309993708,1035.5789804458618,122.43757271766663,730.3612451553345,6390,1559,4831,4831,0,31,1589000.0
1589,1589999,21.424276933423393,37.923187490090285,0.07872724584949664,1036.0461874008179,122.51170587539673,731.759202003479,6392,1560,4832,4832,0,31,1590000.0
1590,1590999,21.421108951903797,37.91637603919705,0.07870254257742648,1036.62957239151,122.58329510688782,732.4996576309204,6394,1561,4833,4833,0,31,1591000.0
1591,1591999,21.418767085346055,37.91132758919613,0.07868360999759394,1037.623869419098,122.65840697288513,730.7748346328735,6404,1565,4839,4839,0,31,1592000.0
1592,1592999,21.416468612592055,37.90783080369766,0.07868103882859934,1038.1654453277588,122.73031401634216,731.8809442520142,6404,1565,4839,4839,0,31,1593000.0
1593,1593999,21.4148852688849,37.90466424206659,0.07867473607923914,1038.5633561611176,122.80417442321777,733.4710702896118,6406,1566,4840,4840,0,31,1594000.0
1594,1594999,21.413966292988775,37.90180551484408,0.07870677242156487,1039.2899193763733,122.87723517417908,733.7992181777954,6406,1566,4840,4840,0,31,1595000.0
1595,1595999,21.414081378115785,37.90074750593294,0.07872904892734378,1039.9266021251678,122.95250153541565,734.1279382705688,6410,1568,4842,4842,0,31,1596000.0
1596,1596999,21.415147962918578,37.9078315890618,0.0787026850310718,1040.8673985004425,123.0277898311615,732.7785501480103,6414,1570,4844,4844,0,31,1597000.0
1597,1597999,21.416908749770545,37.909681910799584,0.07871177585393696,1041.4195919036865,123.09970378875732,733.7077875137329,6416,1571,4845,4845,0,31,1598000.0
1598,1598999,21.421180525718636,37.91678761216859,0.07871057058426056,1042.1153070926666,123.1732120513916,733.5784921646118,6420,1573,4847,4847,0,31,1599000.0
1599,1599999,21.42562610393515,37.92434137864032,0.07873221679881792,1042.5760159492493,123.24494218826294,734.6561441421509,6427,1575,4852,4852,0,31,1600000.0
1600,1600999,21.431121867525935,37.93177186008588,0.07874568719040442,1043.3028235435486,123.31792569160461,734.7048044204712,6429,1576,4853,4853,0,31,1601000.0
1601,1601999,21.43720764452465,37.94234244383233,0.07877386007841236,1047.940800666809,123.39199328422546,735.2835626602173,6429,1576,4853,4853,0,31,1602000.0
1602,1602999,21.446887949333473,37.97644018240107,0.07871468035794893,1048.4837319850922,123.46495747566223,736.4175806045532,6429,1576,4853,4853,0,31,1603000.0
1603,1603999,21.45114787800488,37.98138911462756,0.07875381394549008,1049.2179064750671,123.53840041160583,736.3139200210571,6431,1577,4854,4854,0,31,1604000.0
1604,1604999,21.45230354707731,37.98205048868363,0.07872607203191828,1049.591474056244,123.61081957817078,738.0331964492798,6444,1578,4866,4866,0,31,1605000.0
1605,1605999,21.454396969526442,37.99580749246878,0.0785437274908376,1049.94948720932,123.6834967136383,739.7618494033813,6452,1579,4873,4873,0,31,1606000.0
1606,1606999,21.45552096979448,38.004039966279734,0.07842187730335926,1050.5712101459503,123.75735521316528,740.4880990982056,6452,1579,4873,4873,0,31,1607000.0
1607,1607999,21.455708426225787,38.008208960635024,0.07833452026629062,1050.9178624153137,123.83034777641296,742.1215448379517,6457,1581,4876,4876,0,31,1608000.0
1608,1608999,21.45610062101222,38.00653265791488,0.07825559553314865,1051.5986931324005,123.90541076660156,741.7741174697876,6467,1585,4882,4882,0,31,1609000.0
1609,1609999,21.456774763727335,38.00726967388905,0.07819734792680078,1052.2021536827087,123.98119568824768,742.3430261611938,6471,1586,4885,4885,0,31,1610000.0
1610,1610999,21.45766067111532,38.00972111820718,0.07820939278170636,1053.0114459991455,124.05979108810425,741.2786111831665,6481,1590,4891,4891,0,31,1611000.0
1611,1611999,21.45772729871165,38.00952100604336,0.07824009008455479,1053.73965382576,124.13685059547424,740.8786935806274,6487,1593,4894,4894,0,31,1612000.0
1612,1612999,21.457559854583806,38.007418307696284,0.07822586443408042,1054.3552570343018,124.21373748779297,741.3433542251587,6489,1594,4895,4895,0,31,1613000.0
1613,1613999,21.45801222522928,38.00792120464265,0.07825180902051854,1054.6377222537994,124.2873182296753,743.5094003677368,6492,1595,4897,4897,0,31,1614000.0
1614,1614999,21.458685415717643,38.00797663868328,0.07829151062306727,1055.390058040619,124.3639121055603,743.6404123306274,6492,1595,4897,4897,0,31,1615000.0
1615,1615999,21.460068773592948,38.016659155196066,0.07830639934924444,1055.6924130916595,124.43915486335754,745.9682092666626,6492,1595,4897,4897,0,31,1616000.0
1616,1616999,21.46009635381877,38.01435221486216,0.07831884521146071,1056.4364881515503,124.51460552215576,746.0333871841431,6492,1595,4897,4897,0,31,1617000.0
1617,1617999,21.461146851239747,38.013693182185854,0.07836615021309346,1057.1833755970001,124.5892641544342,746.0926294326782,6492,1595,4897,4897,0,31,1618000.0
1618,1618999,21.461669509715982,38.011046922554605,0.0783573777833445,1057.6820850372314,124.66488742828369,747.0092325210571,6496,1596,4900,4900,0,31,1619000.0
1619,1619999,21.46196408397579,38.00871408983712,0.07837053009008232,1058.2114186286926,124.74023222923279,748.0856409072876,6496,1596,4900,4900,0,31,1620000.0
1620,1620999,21.46404546823383,38.01642358482346,0.07827125319410655,1058.846762895584,124.81559920310974,748.6343011856079,6496,1596,4900,4900,0,31,1621000.0
1621,1621999,21.463709750983096,38.0126078533778,0.07828598069989634,1059.4141058921814,124.89159226417542,749.0857858657837,6500,1598,4902,4902,0,31,1622000.0
1622,1622999,21.46319930482182,38.0088779567568,0.07815224902540707,1060.1544017791748,124.96574306488037,749.2579050064087,6504,1598,4906,4906,0,31,1623000.0
1623,1623999,21.464730739751584,38.01087058056283,0.07795649958929984,1060.730182647705,125.03797960281372,749.9081659317017,6511,1599,4912,4912,0,31,1624000.0
1624,1624999,21.464240233798947,38.00641555670522,0.07783796081848882,1061.5455973148346,125.11320495605469,748.8791360855103,6521,1603,4918,4918,0,31,1625000.0
1625,1625999,21.463513516104435,38.00541411404265,0.0776896332318463,1062.0368194580078,125.18608546257019,750.0407190322876,6523,1604,4919,4919,0,31,1626000.0
1626,1626999,21.46323071876085,38.00410551694194,0.0775662810898281,1062.8214309215546,125.26122212409973,749.5690317153931,6527,1606,4921,4921,0,31,1627000.0
1627,1627999,21.460339013734515,37.998284255405636,0.07754838334504166,1063.543658733368,125.33470845222473,749.5933084487915,6529,1607,4922,4922,0,31,1628000.0
1628,1628999,21.457227505518244,37.99249569460703,0.07750967741150061,1064.0742723941803,125.40829396247864,750.6760187149048,6529,1607,4922,4922,0,31,1629000.0
1629,1629999,21.453935317609986,37.98599869193083,0.07749699373585872,1064.6658380031586,125.48425316810608,751.3172922134399,6531,1608,4923,4923,0,31,1630000.0
1630,1630999,21.45085907717909,37.983567364557786,0.07745028699053624,1065.2768847942352,125.55963730812073,751.7671670913696,6532,1609,4923,4923,0,31,1631000.0
1631,1631999,21.44787864389536,37.97754386628658,0.07741310603133733,1065.7618854045868,125.63622903823853,752.8444299697876,6533,1610,4923,4923,0,31,1632000.0
1632,1632999,21.44488626221273,37.97363532655826,0.0773915750966413,1066.4031474590302,125.71209645271301,753.4305505752563,6533,1610,4923,4923,0,31,1633000.0
1633,1633999,21.44238173486724,37.96931138920816,0.07736704278490991,1067.3379020690918,125.78834199905396,752.4402551651001,6535,1611,4924,4924,0,31,1634000.0
1634,1634999,21.439930658686958,37.96398705102238,0.07734301315458547,1068.165269613266,125.8671658039093,751.9834833145142,6537,1612,4925,4925,0,31,1635000.0
1635,1635999,21.43719561707585,37.95894441570305,0.07732334282635223,1068.71248960495,125.94403553009033,753.0512399673462,6537,1612,4925,4925,0,31,1636000.0
1636,1636999,21.434923961515274,37.95774995294662,0.07727246305394142,1069.6693048477173,126.02188348770142,752.076455116272,6540,1613,4927,4927,0,31,1637000.0
1637,1637999,21.434948302057485,37.967794733196726,0.07717084018295894,1070.3511862754822,126.09661769866943,751.9306039810181,6544,1615,4929,4929,0,31,1638000.0
1638,1638999,21.433244108747534,37.963511241643005,0.07713902205315482,1071.0186650753021,126.17485618591309,751.9402551651001,6547,1617,4930,4930,0,31,1639000.0
1639,1639999,21.432356941579737,37.960353552633954,0.07710552755446909,1071.6375880241394,126.2569534778595,752.4765253067017,6578,1618,4960,4960,0,31,1640000.0
1640,1640999,21.430690295413992,37.9550258637636,0.07707802649462936,1072.2463898658752,126.33498191833496,753.0188608169556,6580,1619,4961,4961,0,31,1641000.0
1641,1641999,21.429036631826172,37.95517144531735,0.0770238437738936,1073.228106021881,126.41515898704529,752.0268030166626,6580,1619,4961,4961,0,31,1642000.0
1642,1642999,21.42737275911869,37.95215452099007,0.07696441557022016,1073.7520225048065,126.48807120323181,753.2315454483032,6590,1619,4971,4971,0,31,1643000.0
1643,1643999,21.425388341901556,37.947983506928466,0.07689882189410124,1074.1785225868225,126.5578875541687,754.3984308242798,6598,1621,4977,4977,0,31,1644000.0
1644,1644999,21.423057578074197,37.945712025388914,0.07684701463011956,1074.7471327781677,126.63206243515015,754.9965600967407,6606,1623,4983,4983,0,31,1645000.0
1645,1645999,21.419344206488393,37.941712090453265,0.07683219173800038,1075.3749253749847,126.70287895202637,755.002251625061,6613,1626,4987,4987,0,31,1646000.0
1646,1646999,21.416679927332183,37.953580514430804,0.07677251099352578,1075.7300398349762,126.77595853805542,757.2639169692993,6613,1626,4987,4987,0,31,1647000.0
1647,1647999,21.413397626977783,37.94801404761163,0.07676302417017133,1076.3370962142944,126.84749746322632,757.8621988296509,6615,1627,4988,4988,0,31,1648000.0
1648,1648999,21.40938378066114,37.940296519010914,0.07677013590055759,1076.7966392040253,126.91868758201599,758.8933420181274,6619,1629,4990,4990,0,31,1649000.0
1649,1649999,21.40559685080096,37.93321609411691,0.07676515606593703,1077.35937166214,126.99152541160583,759.4355096817017,6623,1631,4992,4992,0,31,1650000.0
1650,1650999,21.40193836565861,37.92612508153975,0.07676534579303307,1078.4333264827728,127.06471705436707,757.5869913101196,6659,1634,5025,5025,0,31,1651000.0
1651,1651999,21.398594955842302,37.91957182662334,0.07675316842764879,1078.97935628891,127.13796424865723,758.7090311050415,6659,1634,5025,5025,0,31,1652000.0
1652,1652999,21.39555531784789,37.913068752701456,0.07673963895108482,1079.8081450462341,127.2118763923645,758.264817237854,6663,1635,5028,5028,0,31,1653000.0
1653,1653999,21.39312667185112,37.90744729860752,0.07671753917564605,1080.1380631923676,127.28548955917358,760.4075937271118,6663,1635,5028,5028,0,31,1654000.0
1654,1654999,21.39031315300944,37.90092885126747,0.07670297739560283,1080.8453187942505,127.3600869178772,760.2337350845337,6667,1637,5030,5030,0,31,1655000.0
1655,1655999,21.388386479372322,37.896204663856814,0.07667127568511356,1081.4218962192535,127.43477129936218,760.7095727920532,6671,1639,5032,5032,0,31,1656000.0
1656,1656999,21.387491421493888,37.89313601258814,0.07664062851586129,1082.1732819080353,127.50820755958557,760.8196420669556,6671,1639,5032,5032,0,31,1657000.0
1657,1657999,21.387992962767548,37.89133497841573,0.07658500392866463,1082.8125648498535,127.5836021900177,761.4066171646118,6671,1639,5032,5032,0,31,1658000.0
1658,1658999,21.388918590965616,37.890233795270674,0.07653489679340097,1083.44513463974,127.65683245658875,762.0619974136353,6671,1639,5032,5032,0,31,1659000.0
1659,1659999,21.390836446312598,37.89202603949937,0.07646897982014644,1084.1909244060516,127.73040723800659,762.1846857070923,6671,1639,5032,5032,0,31,1660000.0
1660,1660999,21.391395498163153,37.889820293774456,0.07643296779855624,1084.5927374362946,127.80427575111389,764.0518960952759,6671,1639,5032,5032,0,31,1661000.0
1661,1661999,21.391780128244026,37.88770050902024,0.07639216840147245,1085.219260931015,127.87629389762878,764.4200220108032,6673,1640,5033,5033,0,31,1662000.0
1662,1662999,21.391619313532548,37.884865024995776,0.07637404787496382,1085.7333149909973,127.9476728439331,765.3296899795532,6675,1641,5034,5034,0,31,1663000.0
1663,1663999,21.38899462058021,37.87947687440194,0.07635215466807332,1086.3467528820038,128.01797652244568,766.1828470230103,6687,1641,5046,5046,0,31,1664000.0
1664,1664999,21.38462336854411,37.87414253364828,0.07638149175040632,1086.7327737808228,128.09074091911316,768.0289545059204,6695,1641,5054,5054,0,31,1665000.0
1665,1665999,21.379624576493125,37.86676867949906,0.07641867256967849,1087.2469699382782,128.16200637817383,769.2472848892212,6697,1641,5056,5056,0,31,1666000.0
1666,1666999,21.374840940373787,37.86300327817781,0.07644257312063651,1087.7299139499664,128.23558115959167,770.3258600234985,6700,1642,5058,5058,0,31,1667000.0
1667,1667999,21.36949467222917,37.855474423780464,0.07648342219777005,1088.4379301071167,128.30788326263428,770.124306678772,6706,1645,5061,5061,0,31,1668000.0
1668,1668999,21.364584479913137,37.848467125041516,0.07651657907267573,1088.6461901664734,128.378093957901,772.8382806777954,6706,1645,5061,5061,0,31,1669000.0
1669,1669999,21.359464687392546,37.841251985325655,0.07655651576345912,1089.5016543865204,128.45419359207153,771.4533319473267,6716,1650,5066,5066,0,31,1670000.0
1670,1670999,21.354548482906125,37.83400298540543,0.07659171117023955,1090.2287328243256,128.5292191505432,771.4224863052368,6718,1651,5067,5067,0,31,1671000.0
1671,1671999,21.349582022186993,37.826328442227904,0.07662561742853691,1095.0878155231476,128.60326290130615,770.9181909561157,6724,1654,5070,5070,0,31,1672000.0
1672,1672999,21.344871440472122,37.81867372690216,0.07665686178849263,1095.3542416095734,128.6756272315979,773.034478187561,6727,1655,5072,5072,0,31,1673000.0
1673,1673999,21.340286286769572,37.81225717613695,0.07667009668061098,1095.561980009079,128.74702429771423,775.6998605728149,6727,1655,5072,5072,0,31,1674000.0
1674,1674999,21.335890879935036,37.80511262043523,0.07668260582331654,1096.0698771476746,128.8203408718109,776.3918390274048,6733,1657,5076,5076,0,31,1675000.0
1675,1675999,21.33205982403135,37.798672082599566,0.07669050196750848,1097.212440252304,128.89421916007996,774.4179239273071,6736,1658,5078,5078,0,31,1676000.0
1676,1676999,21.328215407251108,37.79201362919661,0.0766843240432662,1097.6328032016754,128.96538472175598,776.0408182144165,6736,1658,5078,5078,0,31,1677000.0
1677,1677999,21.325385109851656,37.787108031808174,0.07666771343388323,1098.2253153324127,129.03708457946777,776.6350336074829,6738,1659,5079,5079,0,31,1678000.0
1678,1678999,21.324420408161306,37.78520029359453,0.07663415321133371,1098.9510335922241,129.10888743400574,776.8982782363892,6738,1659,5079,5079,0,31,1679000.0
1679,1679999,21.324346552847814,37.78829334620401,0.07659473935879746,1099.7033307552338,129.18287682533264,776.9505090713501,6738,1659,5079,5079,0,31,1680000.0
1680,1680999,21.324329106436686,37.79093884196958,0.0765567054052354,1100.5142040252686,129.25789761543274,776.4979791641235,6741,1660,5081,5081,0,31,1681000.0
1681,1681999,21.324406350394142,37.79262205305112,0.07654071797011153,1101.4328560829163,129.33010578155518,775.4892282485962,6743,1661,5082,5082,0,31,1682000.0
1682,1682999,21.323174399396386,37.78839663898489,0.07654725767077053,1101.7404782772064,129.40206933021545,777.5928964614868,6743,1661,5082,5082,0,31,1683000.0
1683,1683999,21.321484108319044,37.783448584623166,0.07653282300476005,1102.1235489845276,129.47607517242432,779.1528940200806,6747,1662,5085,5085,0,31,1684000.0
1684,1684999,21.317805435972343,37.77683124420791,0.076533210016823,1102.6970946788788,129.5471386909485,780.0315637588501,6766,1663,5103,5103,0,31,1685000.0
1685,1685999,21.313500219959675,37.769774915907455,0.07654192949406224,1103.1574501991272,129.62021350860596,781.2792825698853,6773,1664,5109,5109,0,31,1686000.0
1686,1686999,21.31007231736104,37.76352085014595,0.07655712944291826,1103.4564101696014,129.69085502624512,783.516167640686,6773,1664,5109,5109,0,31,1687000.0
1687,1687999,21.306635358405376,37.757223948347615,0.07657940600189084,1104.2051661014557,129.76312971115112,783.5924234390259,6776,1665,5111,5111,0,31,1688000.0
1688,1688999,21.303504058493857,37.75163846420421,0.07660189595957734,1104.6460144519806,129.83638191223145,784.6717309951782,6780,1667,5113,5113,0,31,1689000.0
1689,1689999,21.30147727748163,37.749645219612056,0.07661323287669408,1105.1410372257233,129.90859603881836,785.8307123184204,6782,1668,5114,5114,0,31,1690000.0
1690,1690999,21.29945773265453,37.74635387914421,0.07668838651243748,1106.1601977348328,129.981999874115,783.3642663955688,6792,1673,5119,5119,0,31,1691000.0
1691,1691999,21.297474379190053,37.74314598391674,0.07682593331634069,1106.6466631889343,130.0562620162964,784.4846353530884,6794,1674,5120,5120,0,31,1692000.0
1692,1692999,21.296047811349265,37.744250455541206,0.0769429587495506,1107.4700045585632,130.1310875415802,784.3572549819946,6794,1674,5120,5120,0,31,1693000.0
1693,1693999,21.29650580529992,37.75568061085465,0.07710411822861618,1107.9845180511475,130.20464062690735,785.5493249893188,6794,1674,5120,5120,0,31,1694000.0
1694,1694999,21.296526509828354,37.75745410256733,0.0772865696184617,1108.596158504486,130.2775468826294,785.9932489395142,6798,1675,5123,5123,0,31,1695000.0
1695,1695999,21.297981371233135,37.76366350578515,0.0777026230462734,1109.1352841854095,130.34983348846436,787.0991220474243,6798,1675,5123,5123,0,31,1696000.0
1696,1696999,21.2983414487321,37.7665595020816,0.07803116350236183,1109.683932542801,130.42210340499878,788.1852045059204,6798,1675,5123,5123,0,31,1697000.0
1697,1697999,21.298187341788765,37.76859992715274,0.0782330913970406,1110.5270128250122,130.4968729019165,787.9195261001587,6798,1675,5123,5123,0,31,1698000.0
1698,1698999,21.299275635080022,37.77293542255866,0.07843646232001933,1111.3577363491058,130.5718469619751,787.2062082290649,6800,1676,5124,5124,0,31,1699000.0
1699,1699999,21.301235154634963,37.7821080247888,0.07857426975968784,1111.9877843856812,130.6434063911438,787.8688745498657,6800,1676,5124,5124,0,31,1700000.0
1700,1700999,21.302521257352872,37.78546913507877,0.07872773859552606,1112.6198666095734,130.71776294708252,788.4403238296509,6800,1676,5124,5124,0,31,1701000.0
1701,1701999,21.304448013967804,37.78951810304714,0.07888503861322149,1113.0699853897095,130.78962898254395,789.4781579971313,6804,1678,5126,5126,0,31,1702000.0
1702,1702999,21.307841016575924,37.79528439699237,0.07894275849459764,1113.9936816692352,130.86446285247803,788.4980554580688,6806,1679,5127,5127,0,31,1703000.0
1703,1703999,21.3094826406985,37.796093660293934,0.07902285793303909,1114.5623517036438,130.94025135040283,789.0823450088501,6810,1681,5129,5129,0,31,1704000.0
1704,1704999,21.311033715090236,37.80839197815363,0.07900321464968851,1115.122605085373,131.01816606521606,790.1585321426392,6810,1681,5129,5129,0,31,1705000.0
1705,1705999,21.309725510540954,37.81075589963594,0.0789141712324436,1115.468472480774,131.09013414382935,792.0169839859009,6826,1682,5144,5144,0,31,1706000.0
1706,1706999,21.3055848499812,37.80397207237997,0.07891433860926289,1115.9594209194183,131.16302871704102,793.3090982437134,6829,1682,5147,5147,0,31,1707000.0
1707,1707999,21.301418831521854,37.796860835245994,0.07893229146333147,1116.2720143795013,131.23511481285095,795.0872049331665,6846,1684,5162,5162,0,31,1708000.0
1708,1708999,21.29818592789756,37.79568710109005,0.07891239563632724,1116.5272550582886,131.30735564231873,797.4528589248657,6851,1685,5166,5166,0,31,1709000.0
1709,1709999,21.295085561993442,37.79092406827406,0.07891517611955612,1117.0595910549164,131.3822672367096,798.1806650161743,6855,1687,5168,5168,0,31,1710000.0
1710,1710999,21.291721258611407,37.78566467823552,0.07892031868968774,1117.7037234306335,131.45677375793457,798.3424005508423,6859,1689,5170,5170,0,31,1711000.0
1711,1711999,21.289617499411445,37.781549092463145,0.07890804536652063,1118.2929747104645,131.53161334991455,799.2588586807251,6859,1689,5170,5170,0,31,1712000.0
1712,1712999,21.28784998445409,37.77787280228809,0.07889086669242329,1118.927217721939,131.60607242584229,799.8848505020142,6860,1689,5171,5171,0,31,1713000.0
1713,1713999,21.286012838372997,37.773489349632904,0.07890058380733667,1119.577078819275,131.6805031299591,799.562180519104,6866,1692,5174,5174,0,31,1714000.0
1714,1714999,21.28454568474652,37.78454335202313,0.0788536789419555,1120.3141677379608,131.7571792602539,799.6884393692017,6866,1692,5174,5174,0,31,1715000.0
1715,1715999,21.284264186139307,37.78377089511316,0.07884067271890616,1121.0066196918488,131.83219289779663,799.7694101333618,6868,1693,5175,5175,0,31,1716000.0
1716,1716999,21.283713695316525,37.78265547648803,0.07883551140293776,1121.3733644485474,131.9084084033966,801.4557123184204,6870,1694,5176,5176,0,31,1717000.0
1717,1717999,21.284541917661844,37.790611529562305,0.0788069170256328,1122.27858543396,131.98268127441406,800.2057657241821,6874,1696,5178,5178,0,31,1718000.0
1718,1718999,21.2859287198272,37.79427464879065,0.07880723628522268,1122.867548942566,132.05905556678772,800.7311639785767,6876,1697,5179,5179,0,31,1719000.0
1719,1719999,21.287267243792925,37.797337801245405,0.07880815541832509,1123.5603005886078,132.13481044769287,800.8262186050415,6878,1698,5180,5180,0,31,1720000.0
1720,1720999,21.290640888632748,37.80415901109413,0.07884163069032202,1124.1751382350922,132.20975184440613,801.527153968811,6878,1698,5180,5180,0,31,1721000.0
1721,1721999,21.29506191995124,37.818763269087555,0.07881785597080848,1124.664559841156,132.28427481651306,802.5428094863892,6880,1699,5181,5181,0,31,1722000.0
1722,1722999,21.299129970113274,37.83059057023523,0.07891093835746699,1125.3274021148682,132.36034774780273,802.5602045059204,6884,1701,5183,5183,0,31,1723000.0
1723,1723999,21.302345531329074,37.83657406668116,0.07893326113922994,1125.9324941635132,132.4346206188202,803.0418252944946,6886,1702,5184,5184,0,31,1724000.0
1724,1724999,21.30636811380169,37.84308739111613,0.07899762838157309,1126.8672156333923,132.50911736488342,802.0685434341431,6888,1703,5185,5185,0,31,1725000.0
1725,1725999,21.307169005066353,37.84297139533848,0.07898600828602875,1127.5982882976532,132.5828115940094,802.3382120132446,6906,1703,5203,5203,0,31,1726000.0
1726,1726999,21.30431951692852,37.837671883775066,0.078948063442013,1127.8311007022858,132.6540768146515,804.7946786880493,6926,1704,5222,5222,0,31,1727000.0
1727,1727999,21.300909138425066,37.83297589627933,0.07893714693978149,1128.3257653713226,132.72496819496155,806.2043466567993,6928,1704,5224,5224,0,31,1728000.0
1728,1728999,21.29777811282113,37.83245629989445,0.07891671159608726,1128.5929687023163,132.7960169315338,808.479043006897,6931,1705,5226,5226,0,31,1729000.0
1729,1729999,21.29519702863685,37.8289963421112,0.0789048510668725,1129.0669286251068,132.86879086494446,809.4897165298462,6967,1708,5259,5259,0,31,1730000.0
1730,1730999,21.29316253558711,37.82517477592498,0.0788977106427613,1129.402901649475,132.93873524665833,811.155556678772,6971,1710,5261,5261,0,31,1731000.0
1731,1731999,21.29083689474388,37.82013295413833,0.07888806738043963,1130.0402240753174,133.0121774673462,811.5768976211548,6975,1712,5263,5263,0,31,1732000.0
1732,1732999,21.28814724033828,37.815236237709364,0.07888079051479957,1130.8842780590057,133.08574223518372,810.8613901138306,6979,1714,5265,5265,0,31,1733000.0
1733,1733999,21.28589278253843,37.810757543492144,0.0788713991727703,1131.3815259933472,133.15886402130127,812.1032495498657,6981,1715,5266,5266,0,31,1734000.0
1734,1734999,21.285006526598995,37.80990660226566,0.07887844411687106,1131.8689103126526,133.23049640655518,813.6133050918579,6981,1715,5266,5266,0,31,1735000.0
1735,1735999,21.284372253629357,37.809489613899814,0.07888816963160405,1132.2748591899872,133.30225777626038,815.3872766494751,6981,1715,5266,5266,0,31,1736000.0
1736,1736999,21.284496436618763,37.82243132152695,0.07885202203209363,1132.667321920395,133.3741011619568,816.543251991272,6985,1717,5268,5268,0,31,1737000.0
1737,1737999,21.284296817751503,37.82178878694338,0.0788736016190098,1133.6789004802704,133.44893383979797,815.0370645523071,6989,1719,5270,5270,0,31,1738000.0
1738,1738999,21.284728878080234,37.822096793441226,0.07887898732198195,1134.2179820537567,133.5204734802246,816.3102426528931,6989,1719,5270,5270,0,31,1739000.0
1739,1739999,21.284645774821843,37.82163573548605,0.07889445313610621,1134.9496448040009,133.59502172470093,816.2922830581665,6991,1720,5271,5271,0,31,1740000.0
1740,1740999,21.286210268234896,37.824073528351285,0.07889772178971621,1135.4654095172882,133.6668562889099,817.0669260025024,6993,1721,5272,5272,0,31,1741000.0
1741,1741999,21.28836352379469,37.8275901249811,0.07892408998716749,1136.2036340236664,133.7415554523468,816.5755167007446,6999,1724,5275,5275,0,31,1742000.0
1742,1742999,21.292062433700682,37.835170659039086,0.07898163257104895,1141.3976500034332,133.81466722488403,816.7065134048462,6999,1724,5275,5275,0,31,1743000.0
1743,1743999,21.296907351421996,37.855132857538734,0.07894310668280347,1141.794338941574,133.88704085350037,818.2221078872681,7001,1725,5276,5276,0,31,1744000.0
1744,1744999,21.30044835855534,37.86199649560443,0.07898022668077598,1142.187906742096,133.95762729644775,819.7438364028931,7003,1726,5277,5277,0,31,1745000.0
1745,1745999,21.302301934599473,37.864052219422256,0.07903036843274558,1143.0244982242584,134.02958273887634,819.3536310195923,7005,1727,5278,5278,0,31,1746000.0
1746,1746999,21.3015754055879,37.86368483375772,0.07900642292126603,1143.5159666538239,134.10242342948914,820.4928598403931,7036,1729,5307,5307,0,31,1747000.0
1747,1747999,21.301877043654283,37.8658512403013,0.07895808214970723,1143.9849936962128,134.1768672466278,821.8196039199829,7044,1730,5314,5314,0,31,1748000.0
1748,1748999,21.299862718105736,37.86287410069316,0.07894894799917873,1144.2848076820374,134.2503216266632,824.1554727554321,7045,1730,5315,5315,0,31,1749000.0
1749,1749999,21.298746247832756,37.863231141686995,0.07890778688462408,1144.772617340088,134.32500839233398,825.1900262832642,7054,1733,5321,5321,0,31,1750000.0
1750,1750999,21.297771432614446,37.8626361658985,0.07888643007717833,1145.2457206249237,134.4000642299652,826.5183572769165,7056,1734,5322,5322,0,31,1751000.0
1751,1751999,21.29673878942654,37.86482864142132,0.07885088074565916,1145.702222585678,134.47397017478943,827.1874170303345,7062,1737,5325,5325,0,31,1752000.0
1752,1752999,21.29599094480565,37.86437330765627,0.07886340915840495,1146.3850848674774,134.55030751228333,827.151894569397,7069,1740,5329,5329,0,31,1753000.0
1753,1753999,21.294629299662354,37.86149939161946,0.07889133519335545,1146.9581637382507,134.62655639648438,828.1546792984009,7071,1741,5330,5330,0,31,1754000.0
1754,1754999,21.294310039212288,37.860179850737495,0.07889687562081449,1147.353842973709,134.70128059387207,829.7250604629517,7073,1742,5331,5331,0,31,1755000.0
1755,1755999,21.293787268275047,37.85885604468345,0.07892413722412861,1148.0247473716736,134.7765085697174,829.3822336196899,7079,1745,5334,5334,0,31,1756000.0
1756,1756999,21.29304995773072,37.85684363320472,0.07897816567836669,1148.3472790718079,134.85223817825317,831.6384134292603,7079,1745,5334,5334,0,31,1757000.0
1757,1757999,21.294481538409723,37.86486018456141,0.07896844025053851,1149.2331881523132,134.93090629577637,830.327561378479,7115,1748,5367,5367,0,31,1758000.0
1758,1758999,21.294738388861532,37.86333620958573,0.07896092350521777,1150.149864435196,135.00618410110474,829.1557550430298,7119,1750,5369,5369,0,31,1759000.0
1759,1759999,21.295947404074408,37.86313983002156,0.0789473426772549,1150.7824711799622,135.0798420906067,829.7631464004517,7119,1750,5369,5369,0,31,1760000.0
1760,1760999,21.29661374795248,37.86227164037762,0.07895470481177713,1151.176301240921,135.153244972229,831.3555383682251,7121,1751,5370,5370,0,31,1761000.0
1761,1761999,21.299192268454664,37.864525757187536,0.07896220713187307,1152.0295238494873,135.2273097038269,830.6868753433228,7127,1753,5374,5374,0,31,1762000.0
1762,1762999,21.3003812021205,37.86423478017042,0.07896951022186205,1152.6740319728851,135.30292510986328,831.2637033462524,7127,1753,5374,5374,0,31,1763000.0
1763,1763999,21.302712548940185,37.8694497359275,0.0789409953076321,1153.5985972881317,135.37748980522156,830.280556678772,7129,1754,5375,5375,0,31,1764000.0
1764,1764999,21.300683353011365,37.86470737015655,0.07891954795609579,1154.1568598747253,135.45386385917664,831.2588663101196,7143,1755,5388,5388,0,31,1765000.0
1765,1765999,21.297575172143695,37.86088457882111,0.07890012777377065,1154.6810297966003,135.51906728744507,832.5290994644165,7144,1755,5389,5389,0,31,1766000.0
1766,1766999,21.295083128249633,37.858338256474525,0.07887859350121174,1155.1813249588013,135.58259105682373,833.708046913147,7147,1755,5392,5392,0,31,1767000.0
1767,1767999,21.29356954265819,37.856223904480245,0.07881978252832189,1155.6517028808594,135.6458978652954,834.8474817276001,7149,1756,5393,5393,0,31,1768000.0
1768,1768999,21.29127102415022,37.85325837231118,0.07878406486907497,1156.2400872707367,135.7097294330597,835.4534387588501,7151,1757,5394,5394,0,31,1769000.0
1769,1769999,21.288763590238496,37.84877472099381,0.07875111474751484,1156.8150050640106,135.7731671333313,836.1474771499634,7154,1758,5396,5396,0,31,1770000.0
1770,1770999,21.28621452939272,37.84385918819132,0.07872051313646777,1157.6950900554657,135.84061980247498,835.2259073257446,7188,1760,5428,5428,0,31,1771000.0
1771,1771999,21.2841832689386,37.84227997027635,0.07868692578553238,1158.1463482379913,135.9074354171753,836.1926584243774,7190,1762,5428,5428,0,31,1772000.0
1772,1772999,21.28271554821586,37.83899260614101,0.07865462498409592,1159.1127429008484,135.97512102127075,834.5612726211548,7197,1765,5432,5432,0,31,1773000.0
1773,1773999,21.28117293946592,37.83682639679058,0.0786105696497632,1159.6333549022675,136.0406219959259,835.684739112854,7197,1765,5432,5432,0,31,1774000.0
1774,1774999,21.280133361684676,37.83398305011005,0.07857218434488877,1160.3645241260529,136.10615396499634,835.5793771743774,7199,1766,5433,5433,0,31,1775000.0
1775,1775999,21.280170795373227,37.83446712443981,0.0785337567848099,1161.1260650157928,136.17319226264954,835.1858835220337,7204,1768,5436,5436,0,31,1776000.0
1776,1776999,21.28088173932083,37.837663665220575,0.07852460777952974,1161.8326163291931,136.24249863624573,835.2490549087524,7206,1769,5437,5437,0,31,1777000.0
1777,1777999,21.281358960882763,37.837225422861906,0.07852671914301856,1162.483713388443,136.30995750427246,835.8662958145142,7206,1769,5437,5437,0,31,1778000.0
1778,1778999,21.283894786047163,37.841302349577205,0.078568455875485,1162.985467672348,136.3765411376953,836.9001474380493,7207,1770,5437,5437,0,31,1779000.0
1779,1779999,21.286270736463447,37.843199867453556,0.07868214612419078,1163.7285592556,136.4447922706604,836.9749155044556,7207,1770,5437,5437,0,31,1780000.0
1780,1780999,21.290303173307564,37.849470497993444,0.07883246578541503,1164.2570261955261,136.51334619522095,838.0602121353149,7207,1770,5437,5437,0,31,1781000.0
1781,1781999,21.29594942420762,37.860520198034244,0.07884449062332088,1164.8933954238892,136.5818691253662,838.6274042129517,7207,1770,5437,5437,0,31,1782000.0
1782,1782999,21.30160588380826,37.87081793609477,0.07888277693963053,1165.5340974330902,136.65040826797485,839.1804208755493,7207,1770,5437,5437,0,31,1783000.0
1783,1783999,21.305577307582247,37.87483614407731,0.07885024806025442,1166.4154815673828,136.71901512145996,838.0571374893188,7211,1772,5439,5439,0,31,1784000.0
1784,1784999,21.308815601432467,37.87535374816224,0.07863939392939634,1167.0975892543793,136.78848505020142,838.227463722229,7220,1773,5447,5447,0,31,1785000.0
1785,1785999,21.307514660503433,37.87367962093076,0.07855637439327201,1167.4632358551025,136.8543758392334,839.8036584854126,7222,1774,5448,5448,0,31,1786000.0
1786,1786999,21.305324670692276,37.869935639034566,0.0784890507742535,1168.180447101593,136.9220860004425,840.0695199966431,7222,1774,5448,5448,0,31,1787000.0
1787,1787999,21.303595398895833,37.86800055681016,0.07843305323293948,1168.7001168727875,136.98895525932312,841.1943674087524,7222,1774,5448,5448,0,31,1788000.0
1788,1788999,21.30247996758795,37.866568997132426,0.07837078305970224,1169.3369920253754,137.05678057670593,841.0554208755493,7228,1777,5451,5451,0,31,1789000.0
1789,1789999,21.30176428830995,37.864323148633595,0.07832211164640868,1169.8971524238586,137.1242287158966,841.6225137710571,7232,1779,5453,5453,0,31,1790000.0
1790,1790999,21.300109378954897,37.859505377071685,0.07826112866989288,1170.6425042152405,137.19316959381104,841.658257484436,7232,1779,5453,5453,0,31,1791000.0
1791,1791999,21.29920077627663,37.85678925683013,0.07820054098793516,1171.1333208084106,137.26152229309082,842.5917596817017,7233,1780,5453,5453,0,31,1792000.0
1792,1792999,21.297621955257384,37.85187570470159,0.07815270762281512,1171.8271930217743,137.3296091556549,842.6480798721313,7234,1781,5453,5453,0,31,1793000.0
1793,1793999,21.29723093583325,37.858394451717665,0.07810366729997964,1172.4479298591614,137.39812326431274,843.2414484024048,7234,1781,5453,5453,0,31,1794000.0
1794,1794999,21.29763809170657,37.85668938597102,0.07805762330822896,1173.290772676468,137.46632862091064,842.7899713516235,7234,1781,5453,5453,0,31,1795000.0
1795,1795999,21.297138766749107,37.852817748358625,0.07799728409166362,1173.9264733791351,137.5366611480713,843.3350687026978,7234,1781,5453,5453,0,31,1796000.0
1796,1796999,21.29730586276952,37.85080277595712,0.07793588353981817,1174.6625080108643,137.6065456867218,843.435959815979,7234,1781,5453,5453,0,31,1797000.0
1797,1797999,21.296982903352603,37.84700785994268,0.07790237582597959,1175.211036682129,137.67768049240112,844.4821786880493,7234,1781,5453,5453,0,31,1798000.0
1798,1798999,21.296739215816874,37.8438789212471,0.07786460338408296,1176.031699180603,137.74671626091003,843.8410882949829,7235,1782,5453,5453,0,31,1799000.0
1799,1799999,21.297350415272206,37.84171879074136,0.07783203681328521,1176.8407628536224,137.81748509407043,843.3612680435181,7236,1783,5453,5453,0,31,1800000.0
1800,1800999,21.298324104838247,37.84877222850975,0.07776152425347649,1177.2543351650238,137.88907146453857,844.9703226089478,7236,1783,5453,5453,0,31,1801000.0
1801,1801999,21.298994701252386,37.84655989645955,0.07772385525475545,1177.7810468673706,137.95842957496643,846.0398645401001,7236,1783,5453,5453,0,31,1802000.0
1802,1802999,21.29967595231198,37.84391023572613,0.07769672504746516,1178.750853061676,138.03098440170288,845.0319223403931,7236,1783,5453,5453,0,31,1803000.0
1803,1803999,21.299086106232483,37.84010484215568,0.07768036590424998,1179.5957605838776,138.10400009155273,844.5217447280884,7236,1783,5453,5453,0,31,1804000.0
1804,1804999,21.297652790382077,37.83518318787076,0.07767963653789323,1180.4519834518433,138.17586994171143,844.0236902236938,7236,1783,5453,5453,0,31,1805000.0
1805,1805999,21.296041472709135,37.831775767277215,0.07763710926492073,1180.9033074378967,138.2448763847351,845.421555519104,7246,1784,5462,5462,0,31,1806000.0
1806,1806999,21.2921213411671,37.82615901644849,0.07765698483802319,1181.5079033374786,138.31466054916382,846.1142358779907,7246,1784,5462,5462,0,31,1807000.0
1807,1807999,21.29023691144616,37.824388144333604,0.0776726057596322,1182.0448162555695,138.38227152824402,846.8024377822876,7262,1786,5476,5476,0,31,1808000.0
1808,1808999,21.290279456924665,37.826490452037525,0.07769439175484893,1182.3403038978577,138.45047163963318,849.1059045791626,7262,1786,5476,5476,0,31,1809000.0
1809,1809999,21.28881111393322,37.82726299201432,0.07770301918887312,1182.7442827224731,138.51850295066833,850.2379159927368,7269,1789,5480,5480,0,31,1810000.0
1810,1810999,21.288606695958247,37.82882545971588,0.07774054846856204,1183.2936346530914,138.58758020401,850.876633644104,7273,1791,5482,5482,0,31,1811000.0
1811,1811999,21.289355680664418,37.831485442337886,0.07777754585394059,1183.954665184021,138.65677690505981,850.9556436538696,7277,1793,5484,5484,0,31,1812000.0
1812,1812999,21.28987029943565,37.83102435090838,0.07782626596896969,1184.3695664405823,138.72671508789062,852.6199045181274,7278,1793,5485,5485,0,31,1813000.0
1813,1813999,21.289135791397733,37.82957129985792,0.07783755989491359,1185.0025610923767,138.7965316772461,852.6329507827759,7284,1796,5488,5488,0,31,1814000.0
1814,1814999,21.288489954073125,37.82947339554693,0.07787804128684905,1185.9329504966736,138.86664748191833,851.9254541397095,7284,1796,5488,5488,0,31,1815000.0
1815,1815999,21.289514914612504,37.83247568835303,0.07794067894135104,1186.4469883441925,138.93549919128418,853.035683631897,7284,1796,5488,5488,0,31,1816000.0
1816,1816999,21.289396358406442,37.830428893981164,0.07799237264093084,1186.9726119041443,139.00469994544983,854.1534738540649,7284,1796,5488,5488,0,31,1817000.0
1817,1817999,21.28943753679319,37.82866899649936,0.07798946652061145,1187.5000894069672,139.07472968101501,855.2515115737915,7284,1796,5488,5488,0,31,1818000.0
1818,1818999,21.291130434180396,37.83545390554451,0.07800738581826672,1188.4561839103699,139.14499473571777,854.2675867080688,7284,1796,5488,5488,0,31,1819000.0
1819,1819999,21.29201360794065,37.834525531535014,0.07801322352954498,1189.085973739624,139.21457076072693,854.8316583633423,7284,1796,5488,5488,0,31,1820000.0
1820,1820999,21.292993768550467,37.83349170804843,0.07803725126763461,1189.5650353431702,139.28468561172485,855.8820123672485,7286,1797,5489,5489,0,31,1821000.0
1821,1821999,21.295064999918328,37.83518392044892,0.07808101056537275,1194.6790430545807,139.35500407218933,856.9505548477173,7286,1797,5489,5489,0,31,1822000.0
1822,1822999,21.296936535144642,37.83518929199637,0.07807834716176743,1195.2272362709045,139.42824602127075,857.3357858657837,7292,1800,5492,5492,0,31,1823000.0
1823,1823999,21.301337041174406,37.84000711338304,0.07811995363073199,1195.9692912101746,139.4980981349945,857.4936990737915,7292,1800,5492,5492,0,31,1824000.0
1824,1824999,21.30346000991775,37.84029974913251,0.07814682789566119,1196.7115211486816,139.57152676582336,857.5646066665649,7293,1800,5493,5493,0,31,1825000.0
1825,1825999,21.303363807398057,37.83776179361306,0.07809262737515432,1197.6439340114594,139.64482808113098,856.7498865127563,7301,1800,5501,5501,0,31,1826000.0
1826,1826999,21.30008315196041,37.834259348812694,0.07807103207255395,1198.2161936759949,139.71248054504395,857.4466333389282,7303,1801,5502,5502,0,31,1827000.0
1827,1827999,21.2967433970739,37.82998185069952,0.07805510389242443,1198.758440732956,139.7828242778778,858.0440530776978,7319,1803,5516,5516,0,31,1828000.0
1828,1828999,21.29518740006991,37.83017748601888,0.07801611763768279,1199.004956483841,139.8515887260437,860.3088693618774,7321,1804,5517,5517,0,31,1829000.0
1829,1829999,21.29212608061654,37.82407244460099,0.07799315335690848,1199.4910371303558,139.92334127426147,861.5564889907837,7323,1805,5518,5518,0,31,1830000.0
1830,1830999,21.290532553102512,37.83213541231885,0.07791723306293286,1200.1414742469788,139.9930911064148,862.1069955825806,7326,1806,5520,5520,0,31,1831000.0
1831,1831999,21.2892899858841,37.82844257354971,0.07788557701517351,1200.5460669994354,140.0611686706543,863.8492212295532,7326,1806,5520,5520,0,31,1832000.0
1832,1832999,21.28827785375999,37.827665458427525,0.07785533635942188,1200.9641692638397,140.12914419174194,865.4998254776001,7327,1806,5521,5521,0,31,1833000.0
1833,1833999,21.287463365547854,37.824910329210226,0.07784239100014834,1201.6997096538544,140.19910049438477,865.5759592056274,7327,1806,5521,5521,0,31,1834000.0
1834,1834999,21.287409397390523,37.82387739763003,0.07783895206103175,1202.504725933075,140.26787424087524,864.8819131851196,7331,1808,5523,5523,0,31,1835000.0
1835,1835999,21.289171205945774,37.8258156684055,0.07782856776120084,1203.0486063957214,140.33676886558533,865.9323053359985,7331,1808,5523,5523,0,31,1836000.0
1836,1836999,21.29065309946686,37.828556367219356,0.07783943135615479,1203.7961797714233,140.40600633621216,866.0649652481079,7331,1808,5523,5523,0,31,1837000.0
1837,1837999,21.292725363729183,37.8312542391153,0.07787843946116957,1204.632491350174,140.47776889801025,864.7878656387329,7340,1812,5528,5528,0,31,1838000.0
1838,1838999,21.294804244094465,37.83318138964078,0.07793468352895416,1205.2367305755615,140.54832530021667,865.3454294204712,7342,1813,5529,5529,0,31,1839000.0
1839,1839999,21.297937350650322,37.83707971446713,0.07802799535616478,1205.956118106842,140.61826515197754,864.5297479629517,7350,1817,5533,5533,0,31,1840000.0
1840,1840999,21.301848505226026,37.844140041717395,0.07810511476622517,1206.4774010181427,140.68701314926147,865.6847085952759,7350,1817,5533,5533,0,31,1841000.0
1841,1841999,21.30710940657023,37.85152682722789,0.0782145153447451,1206.9981484413147,140.75821900367737,866.8163843154907,7350,1817,5533,5533,0,31,1842000.0
1842,1842999,21.312007460428013,37.85676328618669,0.07834349481792202,1207.774248123169,140.82739400863647,866.316216468811,7354,1819,5535,5535,0,31,1843000.0
1843,1843999,21.31848731903107,37.86593011053067,0.07845614547793966,1208.199711561203,140.89616084098816,867.8680505752563,7355,1819,5536,5536,0,31,1844000.0
1844,1844999,21.325303076496578,37.88529033517356,0.07849943091917766,1208.837379693985,140.96647477149963,868.4302988052368,7355,1819,5536,5536,0,31,1845000.0
1845,1845999,21.32905958987996,37.89011045330436,0.07854552588080177,1209.3625264167786,141.03661489486694,869.4958810806274,7355,1819,5536,5536,0,31,1846000.0
1846,1846999,21.329570983766434,37.88829131618723,0.07849624535282052,1210.1364731788635,141.10471725463867,869.2182397842407,7365,1820,5545,5545,0,31,1847000.0
1847,1847999,21.3264766320961,37.88362404212942,0.07847806614211605,1210.5034334659576,141.1731879711151,870.6918497085571,7367,1821,5546,5546,0,31,1848000.0
1848,1848999,21.322940346625938,37.87736500840568,0.07847600680176536,1211.0091290473938,141.24019598960876,871.865288734436,7368,1821,5547,5547,0,31,1849000.0
1849,1849999,21.31980454120897,37.873728284129044,0.07846628478307827,1211.7248449325562,141.30937457084656,872.128830909729,7368,1821,5547,5547,0,31,1850000.0
1850,1850999,21.31684546405742,37.86857667224151,0.07846187496614954,1212.3048207759857,141.3776454925537,872.8517770767212,7370,1822,5548,5548,0,31,1851000.0
1851,1851999,21.31445579041083,37.86314552033632,0.07844598540313108,1212.970870733261,141.44669818878174,873.2377862930298,7372,1823,5549,5549,0,31,1852000.0
1852,1852999,21.311335052945985,37.85757244267018,0.0784475218477314,1213.8249328136444,141.51752066612244,872.7747430801392,7372,1823,5549,5549,0,31,1853000.0
1853,1853999,21.308673525374616,37.85237826540473,0.07845019762901928,1214.314770936966,141.58790159225464,873.6802453994751,7373,1824,5549,5549,0,31,1854000.0
1854,1854999,21.306456401901084,37.84729957981872,0.07845079860447002,1214.8913295269012,141.65694642066956,874.0357370376587,7376,1826,5550,5550,0,31,1855000.0
1855,1855999,21.30532207342082,37.844126085083495,0.07845726747176884,1215.6179423332214,141.72710156440735,873.7708368301392,7378,1827,5551,5551,0,31,1856000.0
1856,1856999,21.30370902430213,37.840048299308286,0.07846786948710449,1216.435840845108,141.79861521720886,873.1563501358032,7380,1828,5552,5552,0,31,1857000.0
1857,1857999,21.30322137109121,37.83841439406581,0.07849720922634684,1216.8627223968506,141.86979818344116,874.7570657730103,7380,1828,5552,5552,0,31,1858000.0
1858,1858999,21.30297019951981,37.836361640571944,0.07855373279912381,1217.9078168869019,141.94091129302979,873.5591592788696,7380,1828,5552,5552,0,31,1859000.0
1859,1859999,21.304394228698815,37.83849108729541,0.0785823742333045,1218.5078241825104,142.01039385795593,874.085618019104,7382,1829,5553,5553,0,31,1860000.0
1860,1860999,21.305993587904332,37.83891816483814,0.07858508808134068,1219.0465047359467,142.08196926116943,875.1474924087524,7382,1829,5553,5553,0,31,1861000.0
1861,1861999,21.309220745406563,37.8423360618722,0.07862451956203598,1219.8289723396301,142.15388298034668,874.5398263931274,7385,1831,5554,5554,0,31,1862000.0
1862,1862999,21.31155575982773,37.843561050815005,0.07870539399259457,1220.4613316059113,142.22636079788208,875.1275110244751,7385,1831,5554,5554,0,31,1863000.0
1863,1863999,21.314529982880632,37.844943548787924,0.07876784056321151,1221.0649287700653,142.29688453674316,875.6654214859009,7387,1832,5555,5555,0,31,1864000.0
1864,1864999,21.31836627379829,37.84812137161065,0.07879368530281905,1221.7043459415436,142.36734223365784,876.2173547744751,7387,1832,5555,5555,0,31,1865000.0
1865,1865999,21.32125620491953,37.84929040604884,0.0788482335264008,1222.415785074234,142.43928456306458,876.1440591812134,7389,1833,5556,5556,0,31,1866000.0
1866,1866999,21.32221956080612,37.847631032926365,0.07887992489052331,1223.2180261611938,142.51115727424622,875.6648874282837,7391,1834,5557,5557,0,31,1867000.0
1867,1867999,21.321436913685194,37.84944275282576,0.07880001263251013,1223.678556919098,142.57950949668884,876.9297571182251,7406,1835,5571,5571,0,31,1868000.0
1868,1868999,21.317310193639557,37.84250985120068,0.07878467569198933,1224.288275718689,142.64902424812317,877.6631021499634,7407,1835,5572,5572,0,31,1869000.0
1869,1869999,21.31408940474274,37.84110740392353,0.07875840861819261,1224.776445865631,142.71770405769348,878.9544305801392,7407,1835,5572,5572,0,31,1870000.0
1870,1870999,21.310573006790662,37.83529435304337,0.07876673284788771,1225.2876954078674,142.78595328330994,880.1014337539673,7407,1835,5572,5572,0,31,1871000.0
1871,1871999,21.307053914073908,37.82912876749981,0.07875956639201898,1225.7118227481842,142.85365557670593,881.7188882827759,7407,1835,5572,5572,0,31,1872000.0
1872,1872999,21.303369426808615,37.82301632424181,0.07876295694916846,1226.491423368454,142.92166113853455,881.4112787246704,7409,1836,5573,5573,0,31,1873000.0
1873,1873999,21.300608487834186,37.81702239951909,0.07875253325917908,1227.3261840343475,142.99152874946594,880.3267602920532,7415,1839,5576,5576,0,31,1874000.0
1874,1874999,21.298108969700227,37.81284649813874,0.07873962609486496,1227.8465557098389,143.06378412246704,881.4881677627563,7415,1839,5576,5576,0,31,1875000.0
1875,1875999,21.295632959743763,37.80750465725601,0.07875479183204315,1228.2580308914185,143.13328289985657,883.1244516372681,7415,1839,5576,5576,0,31,1876000.0
1876,1876999,21.293390221939656,37.803809106492004,0.07876172687587857,1228.8850104808807,143.2024700641632,883.7021341323853,7415,1839,5576,5576,0,31,1877000.0
1877,1877999,21.291688591346485,37.80184865166414,0.0787574420073065,1229.4740335941315,143.2720968723297,884.2739725112915,7425,1840,5585,5585,0,31,1878000.0
1878,1878999,21.290346074185244,37.799427847794625,0.07878372147517831,1230.0022115707397,143.34144115447998,885.4168710708618,7425,1840,5585,5585,0,31,1879000.0
1879,1879999,21.2893612283308,37.796847895690924,0.07881695013688139,1230.693389415741,143.4125497341156,885.5589303970337,7427,1841,5586,5586,0,31,1880000.0
1880,1880999,21.289083773099293,37.80024927542602,0.07883695367755061,1231.0652389526367,143.48140025138855,887.1560297012329,7429,1842,5587,5587,0,31,1881000.0
1881,1881999,21.288536091609252,37.798026787672704,0.07887365421144676,1231.5805735588074,143.55165815353394,888.2758874893188,7430,1842,5588,5588,0,31,1882000.0
1882,1882999,21.288945842546827,37.796890301762176,0.07892729253462516,1232.3068606853485,143.6239833831787,888.3953638076782,7430,1842,5588,5588,0,31,1883000.0
1883,1883999,21.289011537251547,37.79467751858078,0.07900008002086378,1233.1502833366394,143.69631338119507,887.9420785903931,7430,1842,5588,5588,0,31,1884000.0
1884,1884999,21.290543171239197,37.7956140914132,0.07907041113905056,1234.0300438404083,143.76940870285034,886.7917337417603,7434,1844,5590,5590,0,31,1885000.0
1885,1885999,21.291509799632085,37.79455703212054,0.07914059468081347,1234.2271993160248,143.83919954299927,889.4288644790649,7434,1844,5590,5590,0,31,1886000.0
1886,1886999,21.291698750241824,37.79225900432263,0.07919258922534456,1234.9696786403656,143.90887570381165,889.4794397354126,7434,1844,5590,5590,0,31,1887000.0
1887,1887999,21.29195547232554,37.78974828624647,0.079242152492903,1236.2161037921906,143.97967052459717,886.9235315322876,7436,1845,5591,5591,0,31,1888000.0
1888,1888999,21.289496244097833,37.78416389681468,0.07923685049122176,1236.6656420230865,144.05089402198792,888.3259592056274,7453,1846,5607,5607,0,31,1889000.0
1889,1889999,21.285382178731723,37.77754005991951,0.0792535490067171,1237.228224515915,144.11889719963074,888.7931756973267,7465,1848,5617,5617,0,31,1890000.0
1890,1890999,21.28294642680433,37.77432018382554,0.07924636643935967,1237.7673571109772,144.19335389137268,889.9916315078735,7465,1848,5617,5617,0,31,1891000.0
1891,1891999,21.27977632587931,37.76856033518941,0.0792492016053653,1238.3428075313568,144.2625856399536,890.6145105361938,7480,1850,5630,5630,0,31,1892000.0
1892,1892999,21.276463071376803,37.76249836161102,0.07924929661441305,1238.823390007019,144.33291697502136,891.8058481216431,7482,1851,5631,5631,0,31,1893000.0
1893,1893999,21.27394924067819,37.758184572535974,0.07925262729358573,1239.4475989341736,144.40234923362732,891.8376398086548,7488,1854,5634,5634,0,31,1894000.0
1894,1894999,21.271590649140837,37.75611785559608,0.07923319213680924,1239.9733476638794,144.4709756374359,893.0004510879517,7489,1854,5635,5635,0,31,1895000.0
1895,1895999,21.269326568394447,37.753675833242376,0.0792155861395416,1240.5666944980621,144.5408341884613,893.5897989273071,7491,1855,5636,5636,0,31,1896000.0
1896,1896999,21.266831267243287,37.74885242375195,0.07920770943924249,1241.195119380951,144.61032438278198,894.2332773208618,7491,1855,5636,5636,0,31,1897000.0
1897,1897999,21.26390312429122,37.743648850528764,0.07920177636827064,1241.8271646499634,144.68012261390686,894.8166284561157,7491,1855,5636,5636,0,31,1898000.0
1898,1898999,21.262146581471644,37.74048817546067,0.07917859839306363,1242.2244861125946,144.7499577999115,896.2552042007446,7492,1856,5636,5636,0,31,1899000.0
1899,1899999,21.260152321161765,37.738599630736836,0.07915332366565309,1243.0203976631165,144.8212866783142,895.8998498916626,7493,1857,5636,5636,0,31,1900000.0
1900,1900999,21.25731536466493,37.732609788483586,0.07915357395795863,1243.4311273097992,144.89087438583374,897.5750589370728,7493,1857,5636,5636,0,31,1901000.0
1901,1901999,21.25511623992998,37.72765587474987,0.07914954082750358,1244.088143825531,144.96421790122986,898.1513757705688,7493,1857,5636,5636,0,31,1902000.0
1902,1902999,21.253489614707643,37.723454787887285,0.07914217663035694,1244.7488989830017,149.83033323287964,898.7274942398071,7493,1857,5636,5636,0,31,1903000.0
1903,1903999,21.252704424658152,37.72014472945519,0.07913272649540093,1245.690717458725,149.90018939971924,897.5673532485962,7524,1858,5666,5666,0,31,1904000.0
1904,1904999,21.25088830929419,37.71523924562518,0.07913508408884085,1246.408635854721,149.97181034088135,897.5822763442993,7530,1859,5671,5671,0,31,1905000.0
1905,1905999,21.249197078301368,37.710505237238216,0.07913235953768039,1247.04785490036,150.04496312141418,898.1288232803345,7530,1859,5671,5671,0,31,1906000.0
1906,1906999,21.24730841615679,37.7058346215669,0.07911041778243588,1247.560220003128,150.11334252357483,899.4219980239868,7543,1859,5684,5684,0,31,1907000.0
1907,1907999,21.244358666690992,37.70093202987442,0.07911405172008212,1247.9412548542023,150.1804084777832,901.1455316543579,7544,1859,5685,5685,0,31,1908000.0
1908,1908999,21.240791583859654,37.69590153068865,0.07913884966288831,1248.5636203289032,150.24731349945068,901.9151086807251,7544,1859,5685,5685,0,31,1909000.0
1909,1909999,21.237132135218495,37.6905006837812,0.07916066165807889,1249.1106805801392,150.31440234184265,902.8584604263306,7546,1860,5686,5686,0,31,1910000.0
1910,1910999,21.23331051776918,37.68451566837456,0.07918963608851448,1249.7432775497437,150.38238787651062,903.470383644104,7546,1860,5686,5686,0,31,1911000.0
1911,1911999,21.229770153035155,37.678038005564595,0.07922037408604166,1250.5306503772736,150.45100808143616,903.1354150772095,7550,1862,5688,5688,0,31,1912000.0
1912,1912999,21.225272438546234,37.67072906998253,0.0792527738502542,1251.0187418460846,150.51816511154175,904.0811853408813,7551,1863,5688,5688,0,31,1913000.0
1913,1913999,21.221598825013746,37.66474920053132,0.07927071916549888,1251.6099200248718,150.5859637260437,904.6193017959595,7552,1864,5688,5688,0,31,1914000.0
1914,1914999,21.218354319929865,37.66407085577505,0.07926035469277282,1252.293779373169,150.65526485443115,904.3555917739868,7556,1866,5690,5690,0,31,1915000.0
1915,1915999,21.215562534585025,37.6607037381339,0.07925012125588704,1252.885314464569,150.72420716285706,904.9291315078735,7558,1867,5691,5691,0,31,1916000.0
1916,1916999,21.212286763098458,37.65544009306107,0.07925722143094027,1253.5215232372284,150.79263591766357,905.5094308853149,7558,1867,5691,5691,0,31,1917000.0
1917,1917999,21.2095976032203,37.65128139214872,0.07925807074359459,1254.284203529358,150.86347675323486,904.7770853042603,7564,1870,5694,5694,0,31,1918000.0
1918,1918999,21.207571531007076,37.659931668821,0.07919212492300376,1255.141105413437,150.9323375225067,904.3312158584595,7564,1870,5694,5694,0,31,1919000.0
1919,1919999,21.205983383045197,37.65746371627989,0.07916891906709622,1255.8123774528503,151.00408482551575,904.427041053772,7565,1871,5694,5694,0,31,1920000.0
1920,1920999,21.205145621410445,37.65675494303461,0.07913858257515882,1256.4112648963928,151.07360982894897,905.0042810440063,7579,1872,5707,5707,0,31,1921000.0
1921,1921999,21.20411308805776,37.6563391832813,0.07911424143168788,1256.824219942093,151.14889669418335,906.8266687393188,7581,1872,5709,5709,0,31,1922000.0
1922,1922999,21.20216581895865,37.65133536272223,0.07911910323630023,1257.1192889213562,151.21804857254028,909.0506906509399,7581,1872,5709,5709,0,31,1923000.0
1923,1923999,21.200930473258953,37.64812196646688,0.07911928400016532,1257.7389583587646,151.28877806663513,909.6888971328735,7581,1872,5709,5709,0,31,1924000.0
1924,1924999,21.198654860251686,37.64344939444056,0.07911487363283976,1258.4598398208618,151.35836243629456,909.7837152481079,7581,1872,5709,5709,0,31,1925000.0
1925,1925999,21.196139116150906,37.638448668221244,0.07912455889026937,1258.9776875972748,151.42823338508606,910.888108253479,7581,1872,5709,5709,0,31,1926000.0
1926,1926999,21.193442409984538,37.63597466956819,0.07909586199497132,1259.6343111991882,151.49988651275635,910.9306116104126,7593,1874,5719,5719,0,31,1927000.0
1927,1927999,21.188310359084284,37.63136605502623,0.07911050042414636,1260.020563364029,151.5705201625824,912.6672830581665,7594,1874,5720,5720,0,31,1928000.0
1928,1928999,21.183285369158238,37.62470089000231,0.07913494019343126,1260.5647702217102,151.6395161151886,913.2232751846313,7605,1876,5729,5729,0,31,1929000.0
1929,1929999,21.1792431447276,37.62079215237754,0.0791431750864936,1261.0857751369476,151.71161341667175,914.3754892349243,7605,1876,5729,5729,0,31,1930000.0
1930,1930999,21.174737973634922,37.614102529794344,0.07916482583793616,1261.765297651291,151.7832498550415,914.6846933364868,7607,1877,5730,5730,0,31,1931000.0
1931,1931999,21.17021616775695,37.60713794425454,0.07918386250244525,1262.5117642879486,151.8541259765625,914.3788156509399,7611,1879,5732,5732,0,31,1932000.0
1932,1932999,21.16599154781207,37.60034363179145,0.07919546522413956,1263.1666989326477,151.9258532524109,914.9391870498657,7611,1879,5732,5732,0,31,1933000.0
1933,1933999,21.161795377968037,37.59426244897915,0.07920772226299211,1263.8307299613953,151.9966208934784,914.8531198501587,7614,1881,5733,5733,0,31,1934000.0
1934,1934999,21.158148001415142,37.58894139218799,0.07920756800083517,1264.31556558609,152.07104444503784,915.9208459854126,7615,1882,5733,5733,0,31,1935000.0
1935,1935999,21.15410794025343,37.582662036769385,0.07922052833783755,1265.3265018463135,152.14444780349731,914.1271371841431,7620,1884,5736,5736,0,31,1936000.0
1936,1936999,21.150845142284115,37.5771138183456,0.07922105322825412,1265.844747543335,152.2159059047699,915.2350015640259,7620,1884,5736,5736,0,31,1937000.0
1937,1937999,21.14849221956152,37.57465299694157,0.0792053103489927,1266.596451997757,152.28879070281982,915.0535974502563,7622,1885,5737,5737,0,31,1938000.0
1938,1938999,21.14494769414706,37.56939866272358,0.07920724596834217,1267.1316690444946,152.36092925071716,916.1281747817993,7622,1885,5737,5737,0,31,1939000.0
1939,1939999,21.142145859779404,37.56408831554458,0.07920064212452671,1267.7748517990112,152.43395900726318,916.6876840591431,7622,1885,5737,5737,0,31,1940000.0
1940,1940999,21.13952692823393,37.56011006731673,0.07918823235056582,1268.603464603424,152.50818347930908,916.0892343521118,7623,1886,5737,5737,0,31,1941000.0
1941,1941999,21.13776395044487,37.55683227568701,0.07916733901194872,1269.305192232132,152.58348417282104,916.1212320327759,7624,1887,5737,5737,0,31,1942000.0
1942,1942999,21.135540461755543,37.551699660631876,0.07916364927729391,1270.0547134876251,152.65798354148865,916.1938333511353,7624,1887,5737,5737,0,31,1943000.0
1943,1943999,21.133936282270405,37.551295197993255,0.07913537873538812,1270.4795842170715,152.73254919052124,917.7801218032837,7624,1887,5737,5737,0,31,1944000.0
1944,1944999,21.132001747929635,37.546188317440674,0.0791351851959986,1271.230560541153,152.80837035179138,917.8059015274048,7624,1887,5737,5737,0,31,1945000.0
1945,1945999,21.129662419237853,37.54101859352257,0.07913017526582644,1271.981094121933,152.88584089279175,917.818413734436,7624,1887,5737,5737,0,31,1946000.0
1946,1946999,21.12674029509029,37.53541147612751,0.07912150549179886,1273.016846895218,152.96261024475098,916.2745981216431,7626,1888,5738,5738,0,31,1947000.0
1947,1947999,21.124383055992126,37.530536735697,0.07909382736118309,1273.5153319835663,153.03409576416016,917.5307016372681,7637,1888,5749,5749,0,31,1948000.0
1948,1948999,21.120566758640436,37.52503267295778,0.0790744862124626,1273.8085675239563,153.10429739952087,919.6995096206665,7637,1888,5749,5749,0,31,1949000.0
1949,1949999,21.117591199165084,37.51981206100255,0.07903998992887229,1274.231590270996,153.17404294013977,920.7104730606079,7643,1891,5752,5752,0,31,1950000.0
1950,1950999,21.115437014588327,37.51671486249375,0.07899359736033018,1274.7334167957306,153.2451047897339,921.8498163223267,7645,1892,5753,5753,0,31,1951000.0
1951,1951999,21.112211734600294,37.510605028414595,0.07897594965922727,1275.3062090873718,153.31554317474365,922.5985269546509,7647,1893,5754,5754,0,31,1952000.0
1952,1952999,21.109171860077783,37.50484869514257,0.07895388050302476,1276.0605828762054,153.38776421546936,921.7999429702759,7686,1898,5788,5788,0,31,1953000.0
1953,1953999,21.105490165196795,37.49871712998202,0.07896036366552628,1276.480576992035,153.45767211914062,923.4465417861938,7686,1898,5788,5788,0,31,1954000.0
1954,1954999,21.101461860590575,37.49167260641193,0.07897193609269948,1277.1883881092072,153.52973341941833,923.504807472229,7688,1899,5789,5789,0,31,1955000.0
1955,1955999,21.09776604988764,37.48694304825223,0.07896277301636279,1277.622245311737,153.60189580917358,924.4180688858032,7694,1902,5792,5792,0,31,1956000.0
1956,1956999,21.09422408345251,37.481524292683474,0.07897638036757537,1278.5744755268097,153.67544841766357,923.1926279067993,7696,1903,5793,5793,0,31,1957000.0
1957,1957999,21.091599451067836,37.47865328698087,0.07896656749535313,1279.0630233287811,153.746102809906,924.0433206558228,7700,1905,5795,5795,0,31,1958000.0
1958,1958999,21.088468773174533,37.47579811979027,0.07895233126164491,1279.7537677288055,153.81929063796997,923.9451761245728,7704,1907,5797,5797,0,31,1959000.0
1959,1959999,21.08566271793191,37.4718283833005,0.07894710267838012,1280.4421379566193,153.8927960395813,923.9545831680298,7708,1909,5799,5799,0,31,1960000.0
1960,1960999,21.082905452165445,37.4664876602038,0.07894455572192982,1280.8746371269226,153.96503829956055,925.5537424087524,7708,1909,5799,5799,0,31,1961000.0
1961,1961999,21.07998412018215,37.460569447189776,0.07895935494922568,1281.686189174652,154.0386757850647,925.105149269104,7710,1910,5800,5800,0,31,1962000.0
1962,1962999,21.07800309171261,37.457084962620605,0.07894604332844612,1282.508898973465,154.11211276054382,924.559136390686,7714,1911,5803,5803,0,31,1963000.0
1963,1963999,21.076179062458174,37.45327183429195,0.0789416477878182,1283.4308240413666,154.18279910087585,923.5173501968384,7716,1912,5804,5804,0,31,1964000.0
1964,1964999,21.073716856889426,37.447884075295015,0.07894394599850352,1284.2805697917938,154.25353717803955,923.0658197402954,7716,1912,5804,5804,0,31,1965000.0
1965,1965999,21.07244152743439,37.44746681840854,0.07893293622280739,1284.6989505290985,154.3269362449646,924.6458978652954,7716,1912,5804,5804,0,31,1966000.0
1966,1966999,21.06967189978026,37.44177522451802,0.07894176838039979,1285.0872445106506,154.39922523498535,926.2045068740845,7718,1913,5805,5805,0,31,1967000.0
1967,1967999,21.067721976122577,37.437339431799664,0.07894492619455751,1285.510082244873,154.47079014778137,927.7992868423462,7718,1913,5805,5805,0,31,1968000.0
1968,1968999,21.069552770911827,37.44130677123725,0.07884880451454623,1285.8784575462341,154.54028367996216,929.8032007217407,7728,1913,5815,5815,0,31,1969000.0
1969,1969999,21.072203665707463,37.45109226009866,0.07872985052512671,1286.2740457057953,154.60889744758606,931.5071039199829,7729,1913,5816,5816,0,31,1970000.0
1970,1970999,21.073896530835114,37.453301102014215,0.07872417563481882,1286.7895591259003,154.67804217338562,932.0066614151001,7735,1916,5819,5819,0,31,1971000.0
1971,1971999,21.075420418963173,37.45634177753571,0.07885434551674708,1287.5948181152344,154.75034642219543,931.0551385879517,7743,1920,5823,5823,0,31,1972000.0
1972,1972999,21.076690599245023,37.45962256354269,0.07898094773087272,1288.327329158783,154.8220603466034,930.0851907730103,7756,1926,5830,5830,0,31,1973000.0
1973,1973999,21.080006113100634,37.47076420368056,0.07919309703053512,1288.8515808582306,154.8921036720276,930.9569864273071,7758,1927,5831,5831,0,31,1974000.0
1974,1974999,21.08335086938648,37.48007247044417,0.07937833014563866,1289.4585785865784,154.96278738975525,931.5407800674438,7760,1928,5832,5832,0,31,1975000.0
1975,1975999,21.08604256898776,37.48753550529697,0.07957835380786227,1290.1959879398346,155.03566694259644,931.0526208877563,7766,1931,5835,5835,0,31,1976000.0
1976,1976999,21.08835242542202,37.492930619121466,0.07977657484184852,1290.8139884471893,155.1067295074463,931.4960489273071,7768,1932,5836,5836,0,31,1977000.0
1977,1977999,21.09143223256361,37.50053968737278,0.07997880506710786,1291.3455457687378,155.17717814445496,932.6251153945923,7768,1932,5836,5836,0,31,1978000.0
1978,1978999,21.09466970951922,37.50796216394668,0.08020792551966682,1291.8227014541626,155.24817728996277,933.4909067153931,7774,1934,5840,5840,0,31,1979000.0
1979,1979999,21.098525832336982,37.520874957639094,0.08034310417512225,1292.4687569141388,155.3221504688263,934.1094064712524,7774,1934,5840,5840,0,31,1980000.0
1980,1980999,21.101915362839602,37.527090797683734,0.0804250869448685,1292.8932764530182,155.39285016059875,935.7158136367798,7774,1934,5840,5840,0,31,1981000.0
1981,1981999,21.1055021692581,37.531695895890984,0.0804398792976938,1293.712266921997,155.4637689590454,935.1908731460571,7776,1935,5841,5841,0,31,1982000.0
1982,1982999,21.10978378815522,37.539000049561594,0.08056853462968527,1294.9012744426727,155.53561425209045,932.6080636978149,7789,1938,5851,5851,0,31,1983000.0
1983,1983999,21.11423440931465,37.54731413745541,0.08059535660602535,1295.4132907390594,155.60706734657288,933.7832269668579,7789,1938,5851,5851,0,31,1984000.0
1984,1984999,21.118131239510625,37.554070248353725,0.080647305509569,1296.1323246955872,155.68019556999207,933.6511087417603,7791,1939,5852,5852,0,31,1985000.0
1985,1985999,21.123283835078524,37.564717701184485,0.08067946875976928,1296.5593883991241,155.7505702972412,935.2519388198853,7791,1939,5852,5852,0,31,1986000.0
1986,1986999,21.12772346265555,37.56946987614322,0.08068075450513168,1296.9525127410889,155.8215034008026,936.6853952407837,7793,1940,5853,5853,0,31,1987000.0
1987,1987999,21.130414993506182,37.57038331482357,0.08063942993800155,1297.469479084015,155.89227485656738,937.8225946426392,7793,1940,5853,5853,0,31,1988000.0
1988,1988999,21.1297632260317,37.57006222473096,0.08055104546801539,1298.0814299583435,161.01030778884888,938.7012796401978,7806,1940,5866,5866,0,31,1989000.0
1989,1989999,21.128594314836572,37.56667729384023,0.08049074184282223,1298.4948496818542,161.08282709121704,940.0353555679321,7809,1941,5868,5868,0,31,1990000.0
1990,1990999,21.128994814772536,37.56783044995402,0.08042334566092357,1299.0946335792542,161.15622901916504,940.8651514053345,7809,1941,5868,5868,0,31,1991000.0
1991,1991999,21.128080714788922,37.56486818744876,0.0803908818768142,1299.5078732967377,161.2276120185852,942.5204782485962,7809,1941,5868,5868,0,31,1992000.0
1992,1992999,21.129350912748,37.56639387620172,0.08032855471609779,1300.6187698841095,161.29992532730103,940.1553735733032,7817,1945,5872,5872,0,31,1993000.0
1993,1993999,21.13028941591711,37.567125965774906,0.08031865620047607,1301.3016521930695,161.375394821167,940.2186136245728,7821,1947,5874,5874,0,31,1994000.0
1994,1994999,21.131911073880016,37.56913181886911,0.08033501168267887,1301.9402120113373,161.44859218597412,940.8424234390259,7821,1947,5874,5874,0,31,1995000.0
1995,1995999,21.134042627627334,37.571144920769754,0.08035053064237907,1302.550163269043,161.5211799144745,941.3122110366821,7822,1948,5874,5874,0,31,1996000.0
1996,1996999,21.137949106910554,37.577933642127775,0.08034147260202662,1303.0771977901459,161.5954406261444,942.4568185806274,7822,1948,5874,5874,0,31,1997000.0
1997,1997999,21.14113986413567,37.582593765506296,0.08039995249703169,1303.7142271995544,161.6708812713623,942.8567132949829,7823,1949,5874,5874,0,31,1998000.0
1998,1998999,21.14602700503275,37.59126137782006,0.08049446356799805,1304.5321736335754,161.74745726585388,942.4175806045532,7825,1950,5875,5875,0,31,1999000.0
1999,1999999,21.15143507581797,37.60013568884478,0.0805289526904045,1305.1452612876892,161.82333207130432,942.9700784683228,7827,1951,5876,5876,0,31,2000000.0
2000,2000999,21.15800626312235,37.612136127402636,0.08057763574539123,1305.8643927574158,161.89717721939087,942.9962396621704,7829,1952,5877,5877,0,31,2001000.0
2001,2001999,21.16471679250302,37.62367502200969,0.08063876626331334,1306.8346073627472,161.9714412689209,942.1066980361938,7829,1952,5877,5877,0,31,2002000.0
2002,2002999,21.170759961811118,37.63202936806977,0.08072980381041006,1307.6341969966888,162.04804706573486,941.6406106948853,7834,1954,5880,5880,0,31,2003000.0
2003,2003999,21.177619059159785,37.64866744265244,0.08075107331748055,1308.0336060523987,162.12447595596313,943.0827417373657,7835,1955,5880,5880,0,31,2004000.0
2004,2004999,21.184283850493205,37.656256284188196,0.08079908632879795,1308.4554181098938,162.19867730140686,944.7221078872681,7835,1955,5880,5880,0,31,2005000.0
2005,2005999,21.191739324545672,37.66591801959905,0.0808398958515748,1309.1772272586823,162.2755000591278,944.7021722793579,7836,1956,5880,5880,0,31,2006000.0
2006,2006999,21.200173248112822,37.67810954737466,0.08087875242236531,1309.9143109321594,162.35497498512268,944.8635263442993,7836,1956,5880,5880,0,31,2007000.0
2007,2007999,21.205677758691706,37.68306721724032,0.08093508133667293,1310.7818324565887,162.43379044532776,944.3708124160767,7836,1956,5880,5880,0,31,2008000.0
2008,2008999,21.207090227536547,37.68619253953839,0.08090538644592504,1311.0290400981903,162.50595259666443,946.6210336685181,7854,1957,5897,5897,0,31,2009000.0
2009,2009999,21.20576957565866,37.68689312263561,0.0807668621044928,1311.5328834056854,162.57551050186157,947.848671913147,7857,1957,5900,5900,0,31,2010000.0
2010,2010999,21.203251010353444,37.68239054956696,0.08075086347484961,1312.136323928833,162.64474391937256,948.6429147720337,7857,1957,5900,5900,0,31,2011000.0
2011,2011999,21.20127468479123,37.67847898440876,0.08072798372893752,1312.6574003696442,162.71643733978271,949.8320550918579,7857,1957,5900,5900,0,31,2012000.0
2012,2012999,21.199636124491825,37.6869465771571,0.08061804493517422,1313.1431233882904,162.78905200958252,950.6134653091431,7861,1959,5902,5902,0,31,2013000.0
2013,2013999,21.19693594150504,37.68117210934425,0.08058883435635789,1313.9931900501251,162.86054301261902,949.7211771011353,7868,1962,5906,5906,0,31,2014000.0
2014,2014999,21.194631910734408,37.67655416127906,0.08056528956297726,1314.600327014923,162.93150067329407,949.6436929702759,7876,1966,5910,5910,0,31,2015000.0
2015,2015999,21.19253613576324,37.67175101348987,0.08054380334383027,1315.1180601119995,163.00349855422974,950.9625024795532,7876,1966,5910,5910,0,31,2016000.0
2016,2016999,21.190213512952596,37.66676516441794,0.0805276107783669,1315.824420928955,163.0743227005005,951.0362939834595,7878,1967,5911,5911,0,31,2017000.0
2017,2017999,21.188790237018182,37.665552706039236,0.0804994576809076,1316.3515672683716,163.14627051353455,952.1348123550415,7878,1967,5911,5911,0,31,2018000.0
2018,2018999,21.187222306440233,37.66147754784458,0.08052301725263755,1316.8893897533417,163.2171504497528,953.2191858291626,7878,1967,5911,5911,0,31,2019000.0
2019,2019999,21.18667009594675,37.65915028042581,0.08052930144000137,1317.626930475235,163.2878177165985,953.0671625137329,7880,1968,5912,5912,0,31,2020000.0
2020,2020999,21.18697630284774,37.657413029086435,0.0805141993380899,1318.1532626152039,163.35925674438477,954.1445474624634,7880,1968,5912,5912,0,31,2021000.0
2021,2021999,21.18763580766224,37.657948959059404,0.08050967943135634,1318.6921892166138,163.43299651145935,955.1910791397095,7880,1968,5912,5912,0,31,2022000.0
2022,2022999,21.18917993488931,37.659858045243055,0.08049685673063933,1319.2045123577118,163.50304746627808,956.0560312271118,7882,1969,5913,5913,0,31,2023000.0
2023,2023999,21.192384872679416,37.66740138724155,0.08050073083766918,1320.302181005478,163.5746648311615,953.8370370864868,7917,1972,5945,5945,0,31,2024000.0
2024,2024999,21.19783181413635,37.680851235429685,0.0805307986637327,1320.8486313819885,163.64592123031616,954.6153345108032,7921,1974,5947,5947,0,31,2025000.0
2025,2025999,21.20430757608631,37.69307618424928,0.08060505039164201,1321.869098186493,163.718106508255,953.2976007461548,7930,1975,5955,5955,0,31,2026000.0
2026,2026999,21.20988945387921,37.70647879768737,0.08064350058500769,1322.4468050003052,163.79082345962524,954.0931634902954,7937,1976,5961,5961,0,31,2027000.0
2027,2027999,21.213376006586195,37.71159120851124,0.08067083552003029,1322.8357725143433,163.8626823425293,955.6696405410767,7940,1977,5963,5963,0,31,2028000.0
2028,2028999,21.214455408383582,37.71221444047762,0.08069461375486875,1323.620105266571,163.93624472618103,955.1770639419556,7944,1979,5965,5965,0,31,2029000.0
2029,2029999,21.21330035893619,37.712308999288695,0.0806392729689065,1324.152598619461,164.0075011253357,956.0775537490845,7960,1981,5979,5979,0,31,2030000.0
2030,2030999,21.211304686084397,37.70907805846535,0.08062932838973158,1324.7559475898743,164.07864999771118,956.7249155044556,7966,1982,5984,5984,0,31,2031000.0
2031,2031999,21.208759263125682,37.70527636283976,0.08062072389741903,1325.333364725113,164.14851236343384,957.3156366348267,7984,1984,6000,6000,0,31,2032000.0
2032,2032999,21.207446568451434,37.70626705347382,0.0805916159932425,1325.7799863815308,164.22026801109314,958.8975610733032,7986,1985,6001,6001,0,31,2033000.0
2033,2033999,21.205503638852658,37.70210110192663,0.08056756753042471,1326.320993900299,164.29245591163635,959.5758295059204,7999,1988,6011,6011,0,31,2034000.0
2034,2034999,21.203460268487266,37.69799451849805,0.08055544007783977,1326.967455625534,164.36792612075806,959.6545877456665,8005,1991,6014,6014,0,31,2035000.0
2035,2035999,21.202102684848743,37.69449783984625,0.08054832747854934,1327.385581254959,164.43888688087463,961.3606958389282,8005,1991,6014,6014,0,31,2036000.0
2036,2036999,21.200830499805818,37.695229704861866,0.08051369954889187,1328.0206320285797,164.51176524162292,961.7460107803345,8009,1993,6016,6016,0,31,2037000.0
2037,2037999,21.19923616342131,37.693170799536475,0.0804907399069783,1328.671442270279,164.58330512046814,962.3695917129517,8009,1993,6016,6016,0,31,2038000.0
2038,2038999,21.198203577991826,37.695488673000014,0.08046450851897002,1329.1744222640991,164.65518617630005,962.9989709854126,8013,1995,6018,6018,0,31,2039000.0
2039,2039999,21.197504815767207,37.69797590467489,0.0804316714386637,1329.8138995170593,164.72620940208435,963.6146097183228,8013,1995,6018,6018,0,31,2040000.0
2040,2040999,21.195695353091462,37.69312028140055,0.08041775224371084,1330.3145232200623,164.79720997810364,964.6672296524048,8015,1996,6019,6019,0,31,2041000.0
2041,2041999,21.194440784016493,37.6897571637095,0.08040729059577068,1330.839194536209,164.86782908439636,965.7929544448853,8015,1996,6019,6019,0,31,2042000.0
2042,2042999,21.193675780058758,37.68652563810822,0.08039251193500341,1331.5910925865173,164.9417700767517,965.8246774673462,8015,1996,6019,6019,0,31,2043000.0
2043,2043999,21.193164988781103,37.686486831296975,0.08036696395410381,1332.3517549037933,165.0131537914276,965.9669580459595,8015,1996,6019,6019,0,31,2044000.0
2044,2044999,21.191963224955114,37.6856642912628,0.08037140429839951,1333.1098990440369,165.08392691612244,965.9691705703735,8015,1996,6019,6019,0,31,2045000.0
2045,2045999,21.190642209545462,37.68115035967112,0.08036738767281104,1333.736568927765,165.1595001220703,966.5139322280884,8017,1997,6020,6020,0,31,2046000.0
2046,2046999,21.188795576197663,37.675741060596955,0.08036497248674945,1334.4738187789917,165.23065328598022,966.7340097427368,8017,1997,6020,6020,0,31,2047000.0
2047,2047999,21.18589895676545,37.67050349627215,0.08034809606916204,1335.0469827651978,165.30299067497253,967.6249933242798,8039,1998,6041,6041,0,31,2048000.0
2048,2048999,21.18374487635469,37.67032987833532,0.08032254986577614,1335.4077277183533,165.37371826171875,969.268609046936,8041,1999,6042,6042,0,31,2049000.0
2049,2049999,21.181564054657436,37.66634956815593,0.08032922147924837,1335.6034898757935,165.44460940361023,972.0307168960571,8041,1999,6042,6042,0,31,2050000.0
2050,2050999,21.179582113120674,37.66368135390324,0.08031402011332145,1336.4082164764404,165.51682209968567,971.5080728530884,8046,2001,6045,6045,0,31,2051000.0
2051,2051999,21.177703905133267,37.65974281178048,0.08030209790635079,1336.8286538124084,165.5870487689972,973.2145318984985,8046,2001,6045,6045,0,31,2052000.0
2052,2052999,21.175817293926798,37.660371517245245,0.08026777375313698,1338.062349319458,165.66009497642517,970.1925897598267,8054,2005,6049,6049,0,31,2053000.0
2053,2053999,21.175827459282026,37.66318070115547,0.08026087716267793,1338.3708589076996,165.7318046092987,972.3506555557251,8054,2005,6049,6049,0,31,2054000.0
2054,2054999,21.175834696660438,37.66647441819948,0.08023633698731303,1338.8657126426697,165.80236554145813,973.478554725647,8056,2006,6050,6050,0,31,2055000.0
2055,2055999,21.176325811373356,37.66746711198761,0.08018698154617687,1339.6823000907898,165.8747534751892,973.0446863174438,8065,2007,6058,6058,0,31,2056000.0
2056,2056999,21.178507002075108,37.6747772880426,0.08015564823291665,1340.502269268036,165.94941568374634,972.6206827163696,8067,2008,6059,6059,0,31,2057000.0
2057,2057999,21.180507644596922,37.68422029434291,0.08010305979731802,1341.113908290863,166.02205681800842,973.1973581314087,8069,2009,6060,6060,0,31,2058000.0
2058,2058999,21.184306225994785,37.69358918409238,0.08009524986501115,1341.8396735191345,166.0954089164734,973.2402429580688,8071,2010,6061,6061,0,31,2059000.0
2059,2059999,21.188616343898683,37.70665468472216,0.08006437637141062,1342.595230102539,166.16700863838196,972.5316400527954,8077,2013,6064,6064,0,31,2060000.0
2060,2060999,21.19202600388082,37.71401147413597,0.080102062154356,1343.0202105045319,166.240252494812,973.4947443008423,8083,2016,6067,6067,0,31,2061000.0
2061,2061999,21.19460159278805,37.717730121974434,0.08012241363831996,1343.5877373218536,166.31134247779846,973.9959115982056,8087,2018,6069,6069,0,31,2062000.0
2062,2062999,21.199096590080533,37.728186307517916,0.08017767723374358,1344.3320724964142,166.3832037448883,974.122124671936,8087,2018,6069,6069,0,31,2063000.0
2063,2063999,21.203127678455985,37.741081685790455,0.08024945641066294,1344.717224597931,166.45418643951416,975.6933908462524,8089,2019,6070,6070,0,31,2064000.0
2064,2064999,21.207095417358786,37.748653539976544,0.08031699357642719,1345.4604828357697,166.52530169487,975.845269203186,8089,2019,6070,6070,0,31,2065000.0
2065,2065999,21.208832060399565,37.75330060684331,0.08034708103124788,1346.2680208683014,166.59815287590027,975.6507120132446,8091,2020,6071,6071,0,31,2066000.0
2066,2066999,21.20968566480969,37.76599421067382,0.08013637559837816,1346.6163685321808,166.66998028755188,977.6408090591431,8116,2021,6095,6095,0,31,2067000.0
2067,2067999,21.209455222288426,37.766813575643695,0.0800408954429549,1346.8886139392853,166.7417471408844,980.0226144790649,8116,2021,6095,6095,0,31,2068000.0
2068,2068999,21.208982550773626,37.76468279683904,0.08002187693660356,1347.149883031845,166.81348872184753,982.3033533096313,8119,2022,6097,6097,0,31,2069000.0
2069,2069999,21.208604962836276,37.76443017149671,0.07999597951951287,1347.6755394935608,166.8846926689148,982.9680871963501,8126,2025,6101,6101,0,31,2070000.0
2070,2070999,21.209159537244734,37.76910470776993,0.07994061544075981,1348.3044791221619,166.95626854896545,983.0936594009399,8132,2028,6104,6104,0,31,2071000.0
2071,2071999,21.2093300943311,37.76844087666774,0.07992327330227533,1348.6812827587128,167.0303463935852,984.765191078186,8134,2029,6105,6105,0,31,2072000.0
2072,2072999,21.20985889512044,37.767826345541295,0.07991873826201068,1349.4389090538025,167.10323214530945,984.414963722229,8138,2031,6107,6107,0,31,2073000.0
2073,2073999,21.211279978252886,37.7694281157953,0.07992869829109561,1350.2586314678192,167.17616438865662,983.422417640686,8159,2035,6124,6124,0,31,2074000.0
2074,2074999,21.21214391458328,37.769557224431374,0.0799299530268992,1350.7828013896942,167.2496919631958,984.5688486099243,8159,2035,6124,6124,0,31,2075000.0
2075,2075999,21.214701901823005,37.773771665863606,0.07996713967982305,1356.8065159320831,167.32380867004395,984.2406778335571,8167,2038,6129,6129,0,31,2076000.0
2076,2076999,21.217734362429194,37.78068121053317,0.08000741403087785,1357.1994638442993,167.39830899238586,985.8769540786743,8169,2039,6130,6130,0,31,2077000.0
2077,2077999,21.219800019043277,37.78308600812711,0.08008455529295866,1358.1245863437653,167.4717915058136,984.9057321548462,8171,2040,6131,6131,0,31,2078000.0
2078,2078999,21.222228107554674,37.785648267674105,0.08016409501621391,1358.8024775981903,167.54625368118286,984.7904367446899,8175,2042,6133,6133,0,31,2079000.0
2079,2079999,21.225170699234745,37.79327781766778,0.08017101740109656,1359.2150220870972,167.61998414993286,986.4299783706665,8176,2042,6134,6134,0,31,2080000.0
2080,2080999,21.226821332409436,37.794233616650736,0.08021747466952078,1360.0233132839203,167.69391107559204,985.9799356460571,8178,2043,6135,6135,0,31,2081000.0
2081,2081999,21.22925771795727,37.796619207755725,0.0802526733878467,1360.4397020339966,167.76568818092346,987.5887231826782,8178,2043,6135,6135,0,31,2082000.0
2082,2082999,21.231655336313253,37.80398737641376,0.08024041369961321,1361.2933642864227,167.83843350410461,987.1261072158813,8178,2043,6135,6135,0,31,2083000.0
2083,2083999,21.23351716583081,37.80491800103351,0.08028265472631946,1361.815702676773,167.9105043411255,988.2047052383423,8178,2043,6135,6135,0,31,2084000.0
2084,2084999,21.23575784159245,37.80572915515426,0.08029430969862938,1362.4452180862427,167.9834508895874,988.7421579360962,8178,2043,6135,6135,0,31,2085000.0
2085,2085999,21.236846546764266,37.80868619202643,0.08036732613720954,1363.3619565963745,168.0593147277832,987.3907175064087,8182,2045,6137,6137,0,31,2086000.0
2086,2086999,21.235228936387642,37.80619207545969,0.08033345168917916,1363.7539975643158,168.13163375854492,989.3043146133423,8202,2045,6157,6157,0,31,2087000.0
2087,2087999,21.231030290003456,37.80089605842653,0.08034451969731249,1364.0203773975372,168.20133924484253,991.504937171936,8206,2046,6160,6160,0,31,2088000.0
2088,2088999,21.227370616145905,37.79441143842433,0.08035904244830772,1364.5158677101135,168.27204823493958,992.8951959609985,8206,2046,6160,6160,0,31,2089000.0
2089,2089999,21.22440986115171,37.79068325742807,0.08034625682877128,1365.2133965492249,168.34346294403076,993.0794916152954,8209,2047,6162,6162,0,31,2090000.0
2090,2090999,21.22079198082913,37.78542985997816,0.08034333973967822,1365.8897354602814,168.41347455978394,993.1249933242798,8213,2049,6164,6164,0,31,2091000.0
2091,2091999,21.216697869553634,37.779047345786125,0.08035019705687318,1366.5291638374329,168.48537182807922,993.9232797622681,8216,2050,6166,6166,0,31,2092000.0
2092,2092999,21.21338420859187,37.77360182259393,0.08035018506434755,1367.108653306961,168.55840229988098,994.4442148208618,8220,2052,6168,6168,0,31,2093000.0
2093,2093999,21.20999291730008,37.76794525151854,0.08035278131995405,1367.8888680934906,168.6313247680664,994.1684808731079,8229,2054,6175,6175,0,31,2094000.0
2094,2094999,21.207481400285207,37.76335912673975,0.080341349826753,1368.5838463306427,168.7046239376068,994.2530374526978,8234,2056,6178,6178,0,31,2095000.0
2095,2095999,21.204613113139676,37.75833366932652,0.0803471936865151,1369.5492985248566,168.77708888053894,992.1834650039673,8245,2061,6184,6184,0,31,2096000.0
2096,2096999,21.203195449804785,37.75580507793396,0.08032975664264264,1370.2072026729584,168.8520212173462,992.8361902236938,8245,2061,6184,6184,0,31,2097000.0
2097,2097999,21.202032691613795,37.75340984467014,0.08031540510848934,1370.722085237503,168.92510771751404,994.1465311050415,8255,2062,6193,6193,0,31,2098000.0
2098,2098999,21.201581249551733,37.75263812010336,0.08028845083929648,1371.3662910461426,168.99919533729553,994.7605600357056,8255,2062,6193,6193,0,31,2099000.0
2099,2099999,21.201723069270354,37.75241284465315,0.08025891432595844,1372.0147306919098,169.07197499275208,995.3321237564087,8255,2062,6193,6193,0,31,2100000.0
2100,2100999,21.201581507717446,37.75175146928007,0.08025600781081832,1372.5670790672302,169.14540910720825,996.1850748062134,8257,2063,6194,6194,0,31,2101000.0
2101,2101999,21.20290301151074,37.75331085196456,0.08027476036170278,1373.239957332611,169.21875858306885,995.9629602432251,8264,2066,6198,6198,0,31,2102000.0
2102,2102999,21.205915543650356,37.757566118972285,0.08027591792111632,1373.9383916854858,169.29713606834412,995.9413461685181,8268,2068,6200,6200,0,31,2103000.0
2103,2103999,21.209162391748887,37.76211341866086,0.0802818001679918,1374.7470331192017,169.37029147148132,995.7963418960571,8272,2069,6203,6203,0,31,2104000.0
2104,2104999,21.211284406462298,37.76512277855856,0.08030272473025413,1375.7704205513,169.4431893825531,993.8511590957642,8278,2072,6206,6206,0,31,2105000.0
2105,2105999,21.21224955460954,37.765272587575446,0.08034128056372225,1376.095286846161,169.51486706733704,995.9898614883423,8278,2072,6206,6206,0,31,2106000.0
2106,2106999,21.211003313900182,37.761227212875234,0.08033476661063366,1377.1210370063782,169.59138536453247,994.7030115127563,8294,2073,6221,6221,0,31,2107000.0
2107,2107999,21.20883138062702,37.757706141404064,0.08028264160075615,1377.5114991664886,169.66301655769348,996.6309061050415,8294,2073,6221,6221,0,31,2108000.0
2108,2108999,21.207246698685765,37.75441393842169,0.08022789539789321,1377.9630672931671,169.73297905921936,997.7585763931274,8299,2075,6224,6224,0,31,2109000.0
2109,2109999,21.206898499617246,37.75722668212136,0.08012456015091651,1378.328415632248,169.80533695220947,999.2330102920532,8304,2077,6227,6227,0,31,2110000.0
2110,2110999,21.204342138898696,37.752018079821624,0.08008690835962018,1379.0801391601562,169.87819695472717,998.7644052505493,8310,2080,6230,6230,0,31,2111000.0
2111,2111999,21.20302266452219,37.7506493680301,0.08002750372471068,1379.7734484672546,169.95123529434204,998.8840112686157,8314,2082,6232,6232,0,31,2112000.0
2112,2112999,21.20045086043539,37.74530484573153,0.08000076359768427,1380.3420996665955,170.02490210533142,999.4298639297485,8318,2084,6234,6234,0,31,2113000.0
2113,2113999,21.198443852831357,37.7410117102382,0.07996307510229406,1380.744410276413,170.09592390060425,1001.0432977676392,8320,2085,6235,6235,0,31,2114000.0
2114,2114999,21.196190436685765,37.73645002766829,0.079928459485329,1381.6963629722595,170.1686134338379,999.4544229507446,8332,2089,6243,6243,0,31,2115000.0
2115,2115999,21.195024990320942,37.732962702134934,0.07987459286884724,1382.4468789100647,170.23995089530945,999.6073160171509,8332,2089,6243,6243,0,31,2116000.0
2116,2116999,21.193494289271026,37.72901961381482,0.07982603174870306,1383.391413450241,170.31669974327087,998.626763343811,8334,2090,6244,6244,0,31,2117000.0
2117,2117999,21.19252880983429,37.72610891043749,0.0797690579530057,1383.8875632286072,170.39124870300293,999.7420892715454,8365,2091,6274,6274,0,31,2118000.0
2118,2118999,21.191988673031183,37.724783730040755,0.07972553394055981,1384.571572303772,170.4657576084137,999.7600870132446,8370,2093,6277,6277,0,31,2119000.0
2119,2119999,21.191234544926235,37.722201728981446,0.07968722545343809,1385.3442838191986,170.53764939308167,999.4217615127563,8379,2095,6284,6284,0,31,2120000.0
2120,2120999,21.1907107372847,37.719574548347836,0.07965241530656586,1385.7818961143494,170.6121244430542,1001.0346002578735,8379,2095,6284,6284,0,31,2121000.0
2121,2121999,21.19073813740046,37.7189070972493,0.07960109875440136,1386.526597738266,170.68472242355347,1001.2135782241821,8379,2095,6284,6284,0,31,2122000.0
2122,2122999,21.190730418966986,37.716597121870464,0.07958164652203537,1386.9530458450317,170.7556459903717,1002.8088159561157,8379,2095,6284,6284,0,31,2123000.0
2123,2123999,21.191345064149424,37.71568668354423,0.07953774827730131,1387.914437532425,170.8275284767151,1001.8818292617798,8379,2095,6284,6284,0,31,2124000.0
2124,2124999,21.192053831331933,37.715180712645626,0.07953205117156292,1388.5294663906097,170.90127420425415,1002.454026222229,8381,2096,6285,6285,0,31,2125000.0
2125,2125999,21.192602200396315,37.71398304308162,0.07951542532362632,1389.1745970249176,170.97445702552795,1002.9922494888306,8381,2096,6285,6285,0,31,2126000.0
2126,2126999,21.191188386052357,37.71047712134085,0.07950719205667289,1390.214156627655,171.0471806526184,1001.5603952407837,8383,2097,6286,6286,0,31,2127000.0
2127,2127999,21.187541613719507,37.7038222735015,0.07952989815729983,1390.6955807209015,171.11936926841736,1002.9062280654907,8398,2098,6300,6300,0,31,2128000.0
2128,2128999,21.182887621320592,37.69707495977498,0.07955662754596093,1391.3101482391357,171.1938955783844,1003.735878944397,8398,2098,6300,6300,0,31,2129000.0
2129,2129999,21.179067389177426,37.691758145222806,0.07956459143868766,1391.9238865375519,171.26756405830383,1004.6007089614868,8398,2098,6300,6300,0,31,2130000.0
2130,2130999,21.175931838426994,37.68783203014417,0.07956414617579066,1392.3435671329498,171.34222555160522,1006.2682580947876,8399,2098,6301,6301,0,31,2131000.0
2131,2131999,21.172490268729433,37.68277740986654,0.07956773077288659,1393.1776976585388,171.41606378555298,1005.4804697036743,8405,2101,6304,6304,0,31,2132000.0
2132,2132999,21.16908751216216,37.677173224169714,0.07956242046372186,1393.8532721996307,171.49092626571655,1005.2920007705688,8411,2104,6307,6307,0,31,2133000.0
2133,2133999,21.16597658451853,37.67284250865032,0.07952823269470521,1394.2773869037628,171.5659420490265,1006.9422769546509,8411,2104,6307,6307,0,31,2134000.0
2134,2134999,21.16233974872317,37.667181887475,0.07950386293689948,1394.9296250343323,171.64289498329163,1006.9488458633423,8419,2107,6312,6312,0,31,2135000.0
2135,2135999,21.158913520709735,37.661879702521965,0.07949315921363742,1395.6221413612366,171.71793961524963,1006.8084497451782,8428,2109,6319,6319,0,31,2136000.0
2136,2136999,21.15553525643107,37.656247028107686,0.07948108409266996,1396.0459561347961,171.7950882911682,1008.498085975647,8428,2109,6319,6319,0,31,2137000.0
2137,2137999,21.15224998218282,37.65057155479553,0.07945971460847745,1396.5829379558563,171.8700807094574,1009.6530237197876,8428,2109,6319,6319,0,31,2138000.0
2138,2138999,21.148708302583053,37.644835671943774,0.07945292953398175,1397.1145815849304,171.9454004764557,1010.7695093154907,8428,2109,6319,6319,0,31,2139000.0
2139,2139999,21.14593231813001,37.64041453960568,0.07944441289594639,1397.7189936637878,172.01954579353333,1011.3525857925415,8430,2110,6320,6320,0,31,2140000.0
2140,2140999,21.14312419067784,37.63538083677079,0.07942281222029313,1398.3631565570831,172.09510040283203,1011.932785987854,8430,2110,6320,6320,0,31,2141000.0
2141,2141999,21.140897269904293,37.63131830662002,0.07940215970734787,1399.3233647346497,172.1706976890564,1010.9701089859009,8430,2110,6320,6320,0,31,2142000.0
2142,2142999,21.138989874537764,37.627232880002225,0.07936904708803227,1399.8551247119904,172.2442421913147,1012.0451135635376,8430,2110,6320,6320,0,31,2143000.0
2143,2143999,21.13744372290407,37.62365672202617,0.07934933898569763,1400.5658490657806,172.3200409412384,1012.1111993789673,8443,2111,6332,6332,0,31,2144000.0
2144,2144999,21.135445952909063,37.61907356211296,0.07933537353792319,1401.2706129550934,172.39610052108765,1012.207932472229,8447,2112,6335,6335,0,31,2145000.0
2145,2145999,21.134052880028566,37.615990028468296,0.0793153497464798,1401.7644073963165,172.47078275680542,1013.3120355606079,8449,2113,6336,6336,0,31,2146000.0
2146,2146999,21.132443520533357,37.612112261854755,0.07929413350999959,1402.399157524109,172.545339345932,1013.9002923965454,8450,2113,6337,6337,0,31,2147000.0
2147,2147999,21.129362070894164,37.606781235867324,0.07928640894302919,1402.7102644443512,172.61819767951965,1016.0121011734009,8450,2113,6337,6337,0,31,2148000.0
2148,2148999,21.125950208552364,37.60095684256141,0.07927370766532249,1403.0617611408234,172.68872594833374,1017.8428888320923,8471,2114,6357,6357,0,31,2149000.0
2149,2149999,21.122048426337617,37.59492774704366,0.07927293247664369,1403.5035934448242,172.7580966949463,1019.0228204727173,8478,2116,6362,6362,0,31,2150000.0
2150,2150999,21.117980564673136,37.58913340859167,0.07929748064660702,1403.8377203941345,172.8302938938141,1020.6680154800415,8483,2118,6365,6365,0,31,2151000.0
2151,2151999,21.11439588234449,37.58508011195809,0.0793043892700469,1404.5139465332031,172.90301370620728,1020.7118844985962,8487,2120,6367,6367,0,31,2152000.0
2152,2152999,21.110816007636373,37.582470707280365,0.07930260844210435,1405.1712138652802,172.97724294662476,1020.9045877456665,8491,2122,6369,6369,0,31,2153000.0
2153,2153999,21.107425023467027,37.57816865541571,0.07929951784643474,1405.882340669632,173.04825043678284,1020.4222955703735,8499,2126,6373,6373,0,31,2154000.0
2154,2154999,21.103510754819258,37.57253896519419,0.07931214828135613,1406.3912932872772,173.12003302574158,1021.7283182144165,8499,2126,6373,6373,0,31,2155000.0
2155,2155999,21.100072866883558,37.568553242102844,0.07931340527507436,1406.8944869041443,173.19212579727173,1023.0546274185181,8499,2126,6373,6373,0,31,2156000.0
2156,2156999,21.096727024641606,37.56337062901493,0.0793119055870759,1407.3221514225006,173.26282715797424,1024.6684579849243,8499,2126,6373,6373,0,31,2157000.0
2157,2157999,21.093734500182595,37.55800346938459,0.07929540576522787,1407.9316153526306,173.33471488952637,1025.1738061904907,8502,2127,6375,6375,0,31,2158000.0
2158,2158999,21.090818711101154,37.55275543090377,0.07926020449872717,1408.4614963531494,173.40583848953247,1026.2803049087524,8502,2127,6375,6375,0,31,2159000.0
2159,2159999,21.088296742883863,37.54863025967395,0.07923682936742205,1409.2330005168915,173.47920179367065,1026.2095575332642,8502,2127,6375,6375,0,31,2160000.0
2160,2160999,21.085612053711493,37.54427151657451,0.07923015643277431,1409.7572100162506,173.54970145225525,1027.283974647522,8502,2127,6375,6375,0,31,2161000.0
2161,2161999,21.083317624366547,37.54057134938581,0.07921864584436311,1410.253512620926,173.62246918678284,1028.297631263733,8510,2128,6382,6382,0,31,2162000.0
2162,2162999,21.081707262565377,37.547572637469386,0.07916939797638411,1410.9717869758606,173.69393944740295,1028.2472085952759,8512,2129,6383,6383,0,31,2163000.0
2163,2163999,21.079955711467804,37.544422229072545,0.079164118600482,1411.7736155986786,173.76507687568665,1027.9103937149048,8514,2130,6384,6384,0,31,2164000.0
2164,2164999,21.078127750494,37.54013083065685,0.07915213357023931,1412.4477314949036,173.83761262893677,1028.0360116958618,8520,2132,6388,6388,0,31,2165000.0
2165,2165999,21.076180804764046,37.53654278065995,0.07914554510251182,1413.0719730854034,173.90838098526,1028.63321018219,8520,2132,6388,6388,0,31,2166000.0
2166,2166999,21.074293688711503,37.53231186165103,0.07914459021105447,1419.2895984649658,173.98277354240417,1028.6658563613892,8529,2134,6395,6395,0,31,2167000.0
2167,2167999,21.072272119230583,37.527866486700105,0.07913748422556188,1419.915592432022,174.05825209617615,1029.3448419570923,8530,2134,6396,6396,0,31,2168000.0
2168,2168999,21.06935919856171,37.5223790812848,0.07914005740463814,1420.388501882553,174.12941217422485,1030.1820840835571,8535,2136,6399,6399,0,31,2169000.0
2169,2169999,21.066246647574314,37.51772157709422,0.0791595455652565,1420.891134262085,174.20101499557495,1031.5177545547485,8551,2136,6415,6415,0,31,2170000.0
2170,2170999,21.062814269998047,37.512185516109625,0.07918770027865352,1421.2921061515808,174.27195596694946,1033.238305091858,8554,2136,6418,6418,0,31,2171000.0
2171,2171999,21.059405705594653,37.506623348027794,0.0792223803879536,1421.7114083766937,174.34358596801758,1034.9193353652954,8554,2136,6418,6418,0,31,2172000.0
2172,2172999,21.056929825069563,37.503127466461216,0.07923180725896262,1422.338790178299,174.41337537765503,1035.3579950332642,8557,2137,6420,6420,0,31,2173000.0
2173,2173999,21.054623546257197,37.499523386025636,0.07923668677634221,1423.071742773056,174.48822927474976,1034.8111124038696,8566,2141,6425,6425,0,31,2174000.0
2174,2174999,21.05195679208581,37.49604082956498,0.07924736675333544,1423.9518761634827,174.56383323669434,1034.0155115127563,8570,2143,6427,6427,0,31,2175000.0
2175,2175999,21.049264911771687,37.49255615990064,0.07925229636539666,1424.4025909900665,174.63531470298767,1035.3209924697876,8574,2145,6429,6429,0,31,2176000.0
2176,2176999,21.04640105592938,37.487999093436216,0.07927003856606052,1424.8092532157898,174.70607137680054,1037.207818031311,8574,2145,6429,6429,0,31,2177000.0
2177,2177999,21.043767074511692,37.48345071331859,0.07928713030062806,1425.6046376228333,174.77762866020203,1036.7279138565063,8578,2147,6431,6431,0,31,2178000.0
2178,2178999,21.04072393696957,37.47864005356475,0.079305362175768,1426.0526299476624,174.8507525920868,1038.330864906311,8578,2147,6431,6431,0,31,2179000.0
2179,2179999,21.038538913080497,37.47454628419865,0.07931468514036999,1426.702535867691,174.92409110069275,1038.5305795669556,8581,2148,6433,6433,0,31,2180000.0
2180,2180999,21.036008631594093,37.46983090140421,0.07932444976004172,1427.4139301776886,174.99729657173157,1038.5068445205688,8585,2150,6435,6435,0,31,2181000.0
2181,2181999,21.03358951064475,37.46489470315219,0.07934902466451599,1428.4918179512024,175.07049369812012,1037.1875467300415,8585,2150,6435,6435,0,31,2182000.0
2182,2182999,21.030999994590566,37.4596516340776,0.07937234144815986,1428.8473784923553,175.14053583145142,1038.749680519104,8591,2152,6439,6439,0,31,2183000.0
2183,2183999,21.029324693333876,37.455365115896356,0.07938467352216771,1429.2082800865173,175.2170467376709,1040.9220819473267,8591,2152,6439,6439,0,31,2184000.0
2184,2184999,21.027351295342008,37.45074605919637,0.07939772455400174,1430.07612657547,175.29014372825623,1040.4585428237915,8591,2152,6439,6439,0,31,2185000.0
2185,2185999,21.024681848282803,37.44536350487746,0.07941705242517216,1430.7477428913116,175.36505103111267,1040.7527017593384,8593,2153,6440,6440,0,31,2186000.0
2186,2186999,21.02228874579569,37.44040944649277,0.07941161251298623,1431.6107532978058,175.4376893043518,1040.4055795669556,8603,2153,6450,6450,0,31,2187000.0
2187,2187999,21.020385593583608,37.4383771773285,0.07939631133144287,1431.7757260799408,175.50736665725708,1043.2895135879517,8613,2153,6460,6460,0,31,2188000.0
2188,2188999,21.018357766174784,37.437025546226934,0.07937422869599453,1431.9632880687714,175.57713103294373,1046.0440301895142,8614,2153,6461,6461,0,31,2189000.0
2189,2189999,21.01600223783479,37.433330857793344,0.07937826416729998,1432.6860797405243,175.64855360984802,1046.3835000991821,8614,2153,6461,6461,0,31,2190000.0
2190,2190999,21.012884772252086,37.42808680981875,0.07939397661066139,1433.2221386432648,175.71965289115906,1046.8638315200806,8621,2156,6465,6465,0,31,2191000.0
2191,2191999,21.00936902241915,37.42220780498081,0.07941363042109939,1433.6720361709595,175.7965738773346,1047.8733987808228,8628,2159,6469,6469,0,31,2192000.0
2192,2192999,21.00590681617847,37.41957105154246,0.07941464022984857,1434.3151931762695,175.868891954422,1047.980278968811,8635,2162,6473,6473,0,31,2193000.0
2193,2193999,21.00212329692306,37.41344157568538,0.07942679314615408,1434.8600432872772,175.94148802757263,1048.8500604629517,8639,2164,6475,6475,0,31,2194000.0
2194,2194999,20.999171116326202,37.40859960812287,0.0794256529575712,1435.3846147060394,176.01446771621704,1050.000771522522,8639,2164,6475,6475,0,31,2195000.0
2195,2195999,20.99586514304934,37.4029976768148,0.07943215454210595,1435.9150030612946,176.08882451057434,1051.1213464736938,8639,2164,6475,6475,0,31,2196000.0
2196,2196999,20.993349967448196,37.39858596605506,0.07941218105787995,1436.6998245716095,176.1622438430786,1050.317650794983,8645,2167,6478,6478,0,31,2197000.0
2197,2197999,20.991956244054883,37.400874879170814,0.07935563181966798,1437.4799382686615,176.23603701591492,1049.8586435317993,8650,2169,6481,6481,0,31,2198000.0
2198,2198999,20.990156632158623,37.39726706267074,0.07932425312457836,1438.2505230903625,176.30917954444885,1049.0270013809204,8656,2172,6484,6484,0,31,2199000.0
2199,2199999,20.988786974000785,37.395106554165594,0.07929493575206814,1438.774065732956,176.38193273544312,1050.1660623550415,8656,2172,6484,6484,0,31,2200000.0
2200,2200999,20.987190723846638,37.3928062478285,0.07927476382879661,1439.2596912384033,176.4555308818817,1051.2491464614868,8658,2173,6485,6485,0,31,2201000.0
2201,2201999,20.986159073497703,37.39477715219224,0.07922444251760774,1440.0045969486237,176.5294497013092,1051.3172769546509,8658,2173,6485,6485,0,31,2202000.0
2202,2202999,20.985932406692815,37.3947579910893,0.07919795365748805,1440.520336151123,176.60282111167908,1052.4102182388306,8658,2173,6485,6485,0,31,2203000.0
2203,2203999,20.98503507017223,37.39225788928444,0.07916188890437037,1441.3420271873474,176.67591214179993,1051.909592628479,8660,2174,6486,6486,0,31,2204000.0
2204,2204999,20.9841412952487,37.39330062690195,0.07912248166279778,1442.3107650279999,176.75416564941406,1050.9501733779907,8660,2174,6486,6486,0,31,2205000.0
2205,2205999,20.982937123874983,37.389768651733974,0.07909288927954794,1443.0237753391266,176.83151364326477,1050.9618921279907,8662,2175,6487,6487,0,31,2206000.0
2206,2206999,20.980984284202098,37.385806387266854,0.07908082617607293,1443.393483877182,176.90221571922302,1052.7094202041626,8675,2176,6499,6499,0,31,2207000.0
2207,2207999,20.976819314593428,37.38276269307038,0.07908671232087794,1443.9375433921814,176.97348546981812,1053.2315225601196,8681,2178,6503,6503,0,31,2208000.0
2208,2208999,20.97226960008494,37.37756627584391,0.07911457619741236,1444.3294706344604,177.0445430278778,1054.931191444397,8682,2178,6504,6504,0,31,2209000.0
2209,2209999,20.967786148267784,37.371747485816385,0.07914609655959781,1444.8128900527954,177.11481928825378,1056.2852869033813,8682,2178,6504,6504,0,31,2210000.0
2210,2210999,20.963833103881047,37.36898083351437,0.07915497472481292,1445.4209916591644,177.1859393119812,1056.862732887268,8684,2179,6505,6505,0,31,2211000.0
2211,2211999,20.959367230906228,37.362478201824864,0.07919139931409303,1446.0532565116882,177.2582709789276,1056.854058265686,8690,2182,6508,6508,0,31,2212000.0
2212,2212999,20.9549727468207,37.356657580606324,0.07921202371237379,1446.7425048351288,177.33007216453552,1057.0246210098267,8692,2183,6509,6509,0,31,2213000.0
2213,2213999,20.950492254759894,37.34999539788065,0.07924313600954846,1447.3792004585266,177.40157294273376,1057.6376123428345,8692,2183,6509,6509,0,31,2214000.0
2214,2214999,20.94638963224077,37.34421878641815,0.07926778041887461,1448.0528736114502,177.4745500087738,1057.553505897522,8695,2185,6510,6510,0,31,2215000.0
2215,2215999,20.94216612380738,37.33809254028425,0.07929515659333797,1448.7416443824768,177.54886746406555,1057.6491479873657,8696,2186,6510,6510,0,31,2216000.0
2216,2216999,20.938537733377782,37.33235528349454,0.07931250393952272,1449.3755300045013,177.62301087379456,1058.18887424469,8696,2186,6510,6510,0,31,2217000.0
2217,2217999,20.93512706932943,37.32682155580984,0.07932137850970011,1450.2184743881226,177.69689512252808,1057.8548974990845,8696,2186,6510,6510,0,31,2218000.0
2218,2218999,20.9318623857056,37.32225486930087,0.07932539610316114,1450.8874940872192,177.7722282409668,1058.4704751968384,8696,2186,6510,6510,0,31,2219000.0
2219,2219999,20.92878880471038,37.31862608809768,0.07932373283566296,1451.4946513175964,177.84643387794495,1059.0114908218384,8698,2187,6511,6511,0,31,2220000.0
2220,2220999,20.926083106233758,37.31405512948792,0.07932004767363432,1452.355869293213,177.92256045341492,1058.5215921401978,8698,2187,6511,6511,0,31,2221000.0
2221,2221999,20.92352500841739,37.3107490894668,0.07932055925333115,1452.9627177715302,177.9970304965973,1059.0254678726196,8700,2188,6512,6512,0,31,2222000.0
2222,2222999,20.921049338225274,37.3063593307218,0.07932990087943759,1453.3592219352722,178.07918572425842,1060.743432044983,8714,2189,6525,6525,0,31,2223000.0
2223,2223999,20.918240035719467,37.30107827916451,0.0793439045298443,1454.0973765850067,178.15411043167114,1060.9094552993774,8714,2189,6525,6525,0,31,2224000.0
2224,2224999,20.91667059393517,37.30220039194864,0.07931729498418794,1454.8383574485779,178.22946166992188,1060.3960580825806,8718,2191,6527,6527,0,31,2225000.0
2225,2225999,20.914319374287142,37.29805905594999,0.07932445210435479,1455.5785419940948,178.3057553768158,1060.5170984268188,8718,2191,6527,6527,0,31,2226000.0
2226,2226999,20.911432676865147,37.29270284207409,0.0793358574286267,1455.952538728714,178.3831160068512,1062.0839166641235,8721,2192,6529,6529,0,31,2227000.0
2227,2227999,20.90835205345893,37.28752231695829,0.07933870554024558,1456.2690963745117,178.45620322227478,1064.3629388809204,8744,2192,6552,6552,0,31,2228000.0
2228,2228999,20.904228918852333,37.28372530046875,0.0793563014816625,1456.5426623821259,178.52557516098022,1066.7366647720337,8749,2192,6557,6557,0,31,2229000.0
2229,2229999,20.900344695537566,37.27924121325633,0.07938097582401993,1456.8386189937592,178.59573030471802,1068.9923334121704,8750,2192,6558,6558,0,31,2230000.0
2230,2230999,20.896423002622516,37.27351972700831,0.07940632614219756,1457.1052548885345,178.6679139137268,1071.2204141616821,8752,2193,6559,6559,0,31,2231000.0
2231,2231999,20.89302935632811,37.27028131894322,0.07940819504271612,1457.924037694931,178.74277687072754,1070.5487756729126,8758,2196,6562,6562,0,31,2232000.0
2232,2232999,20.888861727814206,37.26407136914322,0.07943269171634049,1458.6985974311829,178.81531476974487,1069.7027750015259,8772,2201,6571,6571,0,31,2233000.0
2233,2233999,20.88478413946491,37.25793090075979,0.07945917974206929,1459.1822438240051,178.8890597820282,1070.9190454483032,8774,2202,6572,6572,0,31,2234000.0
2234,2234999,20.88148302081294,37.2530363884786,0.07947843967541834,1460.0270223617554,178.96272253990173,1069.5298700332642,8786,2207,6579,6579,0,31,2235000.0
2235,2235999,20.87808307128578,37.24746806659698,0.07948838207437803,1460.5245950222015,179.03559470176697,1070.6843118667603,8788,2208,6580,6580,0,31,2236000.0
2236,2236999,20.875393401860144,37.242728476272866,0.07949071583067668,1461.2204985618591,179.109858751297,1070.9984140396118,8790,2209,6581,6581,0,31,2237000.0
2237,2237999,20.873697006188443,37.239832860838796,0.07947934114939437,1461.6944372653961,179.1822865009308,1072.308632850647,8794,2210,6584,6584,0,31,2238000.0
2238,2238999,20.87278284231989,37.23913485232667,0.07945911071988865,1462.0028574466705,179.25507140159607,1074.3147439956665,8796,2211,6585,6585,0,31,2239000.0
2239,2239999,20.873240075060078,37.248370877177805,0.07937919830673457,1462.6252646446228,179.32909655570984,1074.7769784927368,8798,2212,6586,6586,0,31,2240000.0
2240,2240999,20.873645851368043,37.26057443931875,0.07930620067306382,1463.2345757484436,179.40394520759583,1075.3433771133423,8800,2213,6587,6587,0,31,2241000.0
2241,2241999,20.874148862387994,37.274937871649016,0.07922112005388138,1464.0807926654816,179.47584080696106,1074.8408823013306,8802,2214,6588,6588,0,31,2242000.0
2242,2242999,20.87626094868617,37.29188233418423,0.079124688778483,1464.8973786830902,179.54814982414246,1074.103455543518,8808,2216,6592,6592,0,31,2243000.0
2243,2243999,20.87798993616326,37.29712695381664,0.07906462792549251,1465.5840072631836,179.62234711647034,1074.085030555725,8812,2218,6594,6594,0,31,2244000.0
2244,2244999,20.878873738006355,37.30303863000554,0.07901623785395107,1466.3212354183197,179.6963713169098,1073.4905405044556,8822,2222,6600,6600,0,31,2245000.0
2245,2245999,20.878946058285102,37.303735934126465,0.07898561998231168,1466.7459435462952,179.7692165374756,1075.1701440811157,8822,2222,6600,6600,0,31,2246000.0
2246,2246999,20.87866675243348,37.30367427391138,0.0789563966365392,1467.4720351696014,179.8422293663025,1075.2357034683228,8824,2223,6601,6601,0,31,2247000.0
2247,2247999,20.877772936465707,37.302814142033185,0.07891236576648897,1467.644335269928,179.91433906555176,1078.2414865493774,8846,2223,6623,6623,0,31,2248000.0
2248,2248999,20.877131627065513,37.304185271821964,0.07887453599220806,1467.975495815277,179.98443698883057,1079.9198083877563,8852,2225,6627,6627,0,31,2249000.0
2249,2249999,20.877126562941537,37.30630425805694,0.07885756073440309,1468.2438371181488,180.05659413337708,1082.436463356018,8852,2225,6627,6627,0,31,2250000.0
2250,2250999,20.876841985871042,37.305946556246774,0.07885033434303923,1468.7043797969818,180.12898206710815,1083.563172340393,8859,2227,6632,6632,0,31,2251000.0
2251,2251999,20.877840338323608,37.30819764031025,0.07888311081174715,1469.161039352417,180.20056891441345,1084.6620798110962,8863,2229,6634,6634,0,31,2252000.0
2252,2252999,20.879196950472338,37.31023514294286,0.07898653471922146,1469.801251411438,180.27417421340942,1085.1224908828735,8867,2231,6636,6636,0,31,2253000.0
2253,2253999,20.879849804334356,37.3109242041967,0.07913589410134214,1470.6133210659027,180.3455832004547,1084.3626260757446,8873,2234,6639,6639,0,31,2254000.0
2254,2254999,20.881860977053975,37.31530364233983,0.07933360507698639,1471.1813549995422,180.41822171211243,1084.8665628433228,8877,2236,6641,6641,0,31,2255000.0
2255,2255999,20.882985090347614,37.31553450264865,0.07951793263065754,1471.6515061855316,180.49318385124207,1085.9119882583618,8882,2238,6644,6644,0,31,2256000.0
2256,2256999,20.885562951861715,37.32073992755842,0.07976314246904337,1472.363466501236,180.56783366203308,1085.6079950332642,8886,2240,6646,6646,0,31,2257000.0
2257,2257999,20.8885680448822,37.326604260207716,0.08004387595333085,1473.1148872375488,180.6400866508484,1085.8046579360962,8886,2240,6646,6646,0,31,2258000.0
2258,2258999,20.890550025080753,37.328933907204465,0.08032507216622065,1473.4327447414398,180.7123041152954,1087.9571313858032,8886,2240,6646,6646,0,31,2259000.0
2259,2259999,20.89230700971883,37.3307249829294,0.08053051591013327,1474.0909533500671,180.78508925437927,1088.1258554458618,8890,2242,6648,6648,0,31,2260000.0
2260,2260999,20.894171135980564,37.33398785060109,0.0806683263178859,1474.7671899795532,180.8563621044159,1088.1695489883423,8896,2244,6652,6652,0,31,2261000.0
2261,2261999,20.8964805171103,37.3374913999482,0.08080719362767219,1475.6165878772736,180.92918062210083,1087.7486734390259,8896,2244,6652,6652,0,31,2262000.0
2262,2262999,20.89871905634777,37.3406133337365,0.08094800760395437,1482.2566180229187,181.00047779083252,1087.3629388809204,8902,2246,6656,6656,0,31,2263000.0
2263,2263999,20.901341492686782,37.342961039987564,0.08097729430775635,1482.736517906189,181.07572865486145,1088.4382486343384,8906,2247,6659,6659,0,31,2264000.0
2264,2264999,20.903194714491057,37.34348345166736,0.08100585442422481,1483.5537724494934,181.15141558647156,1087.9560098648071,8908,2248,6660,6660,0,31,2265000.0
2265,2265999,20.905140936656224,37.344205434397864,0.08101655538970698,1484.044485092163,181.22360396385193,1089.030701637268,8921,2249,6672,6672,0,31,2266000.0
2266,2266999,20.90523716811794,37.341837658802035,0.08099691274134002,1484.6678853034973,181.2968258857727,1089.638352394104,8921,2249,6672,6672,0,31,2267000.0
2267,2267999,20.902832018190878,37.33990976876472,0.08096702841441183,1485.3598566055298,181.37074303627014,1089.5191278457642,8942,2251,6691,6691,0,31,2268000.0
2268,2268999,20.899344923911706,37.33509046055956,0.08097754689869385,1485.817831993103,181.44403171539307,1090.5490732192993,8947,2253,6694,6694,0,31,2269000.0
2269,2269999,20.89622956950565,37.33047605863083,0.08098228406943497,1486.2931661605835,181.51581954956055,1091.718201637268,8949,2254,6695,6695,0,31,2270000.0
2270,2270999,20.89371036983027,37.32701408826366,0.08097982203804643,1486.7089760303497,181.58867478370667,1093.4230432510376,8950,2254,6696,6696,0,31,2271000.0
2271,2271999,20.890604123163047,37.32218307840304,0.08098695048572357,1487.447597503662,181.66264462471008,1093.0455713272095,8956,2257,6699,6699,0,31,2272000.0
2272,2272999,20.88796752138815,37.31780667121468,0.08100481061163112,1488.1255960464478,181.7372431755066,1093.110909461975,8960,2259,6701,6701,0,31,2273000.0
2273,2273999,20.88552062569078,37.31411250458918,0.08102650924814925,1488.656464099884,181.813250541687,1094.246735572815,8960,2259,6701,6701,0,31,2274000.0
2274,2274999,20.883862808789853,37.312363701976686,0.08107652683324496,1489.1628904342651,181.88640594482422,1095.3133172988892,8962,2260,6702,6702,0,31,2275000.0
2275,2275999,20.882896071759028,37.31892539897009,0.08107057381492944,1489.9787242412567,181.9600863456726,1094.7642679214478,8963,2261,6702,6702,0,31,2276000.0
2276,2276999,20.882393197666456,37.31994856835282,0.08113621090439793,1490.8497138023376,182.03697609901428,1093.6253900527954,8969,2264,6705,6705,0,31,2277000.0
2277,2277999,20.883111889465912,37.322668378014185,0.08124347165701529,1491.3727157115936,182.1138129234314,1094.7908716201782,8969,2264,6705,6705,0,31,2278000.0
2278,2278999,20.88483402860018,37.32890452241655,0.08137713506513577,1492.0736458301544,182.18956661224365,1095.0149240493774,8971,2265,6706,6706,0,31,2279000.0
2279,2279999,20.88601747714586,37.33289329858536,0.08152055998782981,1492.61372590065,182.26491475105286,1096.1185693740845,8971,2265,6706,6706,0,31,2280000.0
2280,2280999,20.887998585299457,37.336090767894085,0.08163247163451992,1493.0726177692413,182.34424424171448,1097.7092752456665,8971,2265,6706,6706,0,31,2281000.0
2281,2281999,20.89079758593923,37.34505983569891,0.08171250263605245,1494.2477450370789,182.4210810661316,1095.7928705215454,8971,2265,6706,6706,0,31,2282000.0
2282,2282999,20.89399364206076,37.35083917743334,0.08183284760720144,1494.897192955017,182.49794960021973,1096.4325189590454,8971,2265,6706,6706,0,31,2283000.0
2283,2283999,20.895974718830683,37.3523950558677,0.08194039243017126,1495.5023002624512,182.57671761512756,1097.0485620498657,8986,2266,6720,6720,0,31,2284000.0
2284,2284999,20.899663327643903,37.35728750140513,0.082087874567633,1495.9963009357452,182.65433049201965,1098.221001625061,8990,2267,6723,6723,0,31,2285000.0
2285,2285999,20.902883656410815,37.3614781678232,0.08214359283957817,1496.4033992290497,182.73036861419678,1100.0133981704712,8990,2267,6723,6723,0,31,2286000.0
2286,2286999,20.904450994138497,37.36136531103365,0.08220057906821132,1497.1178948879242,182.80849289894104,1099.7447290420532,8995,2269,6726,6726,0,31,2287000.0
2287,2287999,20.904048055661633,37.35890979573235,0.08217708464226392,1497.7362384796143,182.88358211517334,1100.624939918518,9018,2269,6749,6749,0,31,2288000.0
2288,2288999,20.900561290066435,37.353407393112604,0.08218268051542843,1497.9127187728882,182.9548854827881,1103.4700479507446,9021,2269,6752,6752,0,31,2289000.0
2289,2289999,20.898168968614467,37.3490663493109,0.08218418376991232,1498.4782242774963,183.0276596546173,1104.1129236221313,9025,2271,6754,6754,0,31,2290000.0
2290,2290999,20.897015865570957,37.346804404413874,0.0821725256147866,1498.958508491516,183.0987741947174,1105.2819757461548,9034,2273,6761,6761,0,31,2291000.0
2291,2291999,20.896282990318365,37.346645776444944,0.08215517749834189,1499.3033859729767,183.17083740234375,1106.9529504776,9040,2275,6765,6765,0,31,2292000.0
2292,2292999,20.89612545233611,37.34639764433386,0.08214638068774938,1499.9432232379913,183.2435405254364,1107.0477380752563,9046,2278,6768,6768,0,31,2293000.0
2293,2293999,20.89479562858167,37.3431330487765,0.08215688697507906,1500.830943107605,183.31673169136047,1105.8653650283813,9054,2282,6772,6772,0,31,2294000.0
2294,2294999,20.89471399799873,37.34193475909998,0.08214321288028259,1501.3120000362396,183.39093327522278,1107.144471168518,9059,2283,6776,6776,0,31,2295000.0
2295,2295999,20.895087233089175,37.34193975985339,0.08214939198798088,1501.738421201706,183.46318674087524,1108.8226861953735,9059,2283,6776,6776,0,31,2296000.0
2296,2296999,20.895527992304174,37.3420761488516,0.08215319699895718,1502.3799839019775,183.5347695350647,1109.4424600601196,9059,2283,6776,6776,0,31,2297000.0
2297,2297999,20.89590979792756,37.34206955021902,0.08217792901148646,1502.8919250965118,183.60613679885864,1110.3956232070923,9063,2284,6779,6779,0,31,2298000.0
2298,2298999,20.896008874991654,37.34055181729467,0.0822357757871427,1503.4646680355072,183.67872285842896,1111.3289957046509,9063,2284,6779,6779,0,31,2299000.0
2299,2299999,20.89691443413169,37.340549726649655,0.08224589267204963,1504.1685297489166,183.75211548805237,1111.158226966858,9067,2286,6781,6781,0,31,2300000.0
2300,2300999,20.898406338131835,37.34317322963772,0.08227313929545288,1504.8089468479156,183.82561659812927,1111.7891778945923,9067,2286,6781,6781,0,31,2301000.0
2301,2301999,20.899593737884047,37.34381006891017,0.08231129575666696,1505.2779998779297,183.90001583099365,1112.8211374282837,9071,2288,6783,6783,0,31,2302000.0
2302,2302999,20.90126316350685,37.34687356123344,0.08235663022678164,1506.0007276535034,183.97171211242676,1112.7971963882446,9073,2289,6784,6784,0,31,2303000.0
2303,2303999,20.90305408288032,37.34869415583781,0.08239084752738857,1506.7074553966522,184.04486727714539,1112.9185342788696,9075,2290,6785,6785,0,31,2304000.0
2304,2304999,20.90524963974946,37.35725361128085,0.08241368575640884,1507.4633984565735,184.11750555038452,1112.369912147522,9081,2293,6788,6788,0,31,2305000.0
2305,2305999,20.907092939327065,37.35922518369878,0.08242717735174265,1508.3229701519012,184.1912875175476,1112.0102319717407,9081,2293,6788,6788,0,31,2306000.0
2306,2306999,20.909657888019783,37.3648420083768,0.082413335924156,1509.0628914833069,184.26570439338684,1112.1144571304321,9083,2293,6790,6790,0,31,2307000.0
2307,2307999,20.910199160705826,37.36362965612821,0.08242781135052157,1509.8547942638397,184.3373246192932,1111.8454904556274,9085,2294,6791,6791,0,31,2308000.0
2308,2308999,20.908802689787905,37.360751617401725,0.08245937765184752,1510.1406559944153,184.4085671901703,1114.2022333145142,9102,2294,6808,6808,0,31,2309000.0
2309,2309999,20.906057669038116,37.359082704985546,0.08246468547530872,1510.6917777061462,184.47954630851746,1114.8535623550415,9112,2296,6816,6816,0,31,2310000.0
2310,2310999,20.902931254489573,37.353824865309036,0.08250102161182404,1511.0946505069733,184.55387949943542,1116.7565774917603,9113,2296,6817,6817,0,31,2311000.0
2311,2311999,20.89972776312739,37.348493201216485,0.08253580993922482,1511.6336543560028,184.62538027763367,1117.2976694107056,9120,2299,6821,6821,0,31,2312000.0
2312,2312999,20.896690413963423,37.34316707747469,0.08256561683703467,1512.2049024105072,184.69884777069092,1117.8852472305298,9124,2301,6823,6823,0,31,2313000.0
2313,2313999,20.893507092739938,37.33763967917771,0.08259491968438348,1512.8130614757538,184.77053451538086,1118.013123512268,9145,2305,6840,6840,0,31,2314000.0
2314,2314999,20.889928815167163,37.33167352038184,0.08263646611400799,1513.4364776611328,184.8462769985199,1118.5257806777954,9148,2306,6842,6842,0,31,2315000.0
2315,2315999,20.886800093082826,37.326220980570604,0.08266965546507887,1514.4345586299896,184.92034697532654,1117.084412574768,9154,2309,6845,6845,0,31,2316000.0
2316,2316999,20.88362281061928,37.32063059606737,0.08270258502488392,1515.1453771591187,184.99500584602356,1117.1872415542603,9156,2310,6846,6846,0,31,2317000.0
2317,2317999,20.88009742372007,37.314763884586995,0.08274466871390374,1515.5752403736115,185.06666374206543,1118.8580102920532,9156,2310,6846,6846,0,31,2318000.0
2318,2318999,20.87697163052202,37.30959035312434,0.08277556202937286,1516.1208283901215,185.1415662765503,1119.9478921890259,9156,2310,6846,6846,0,31,2319000.0
2319,2319999,20.874551214071356,37.30546898564642,0.08278524460440173,1516.660353422165,185.21364331245422,1121.0348443984985,9156,2310,6846,6846,0,31,2320000.0
2320,2320999,20.872608497765746,37.30137299906439,0.08280189007972794,1517.3836634159088,185.2875418663025,1121.0669412612915,9158,2311,6847,6847,0,31,2321000.0
2321,2321999,20.870305636441486,37.297642484601184,0.08282098321544928,1518.366226196289,185.36514377593994,1120.0982904434204,9158,2311,6847,6847,0,31,2322000.0
2322,2322999,20.8681312521636,37.29315009912111,0.08284681444103992,1518.8342673778534,185.43834471702576,1121.1687707901,9171,2313,6858,6858,0,31,2323000.0
2323,2323999,20.865791028746326,37.28843791347822,0.08287096070454258,1519.5550634860992,185.50980496406555,1121.3816995620728,9175,2314,6861,6861,0,31,2324000.0
2324,2324999,20.863310705195357,37.28323921198569,0.08291298064475017,1520.2179856300354,185.5816686153412,1121.3354501724243,9184,2317,6867,6867,0,31,2325000.0
2325,2325999,20.860360948327852,37.27820241866204,0.0829438300869586,1521.0427768230438,185.65477347373962,1120.836480140686,9186,2318,6868,6868,0,31,2326000.0
2326,2326999,20.857423125771856,37.27720347235115,0.0829501382980159,1521.2077040672302,185.7254843711853,1123.8869180679321,9211,2318,6893,6893,0,31,2327000.0
2327,2327999,20.854349887631365,37.27559817171233,0.08297285957793821,1521.4943180084229,185.79693603515625,1126.1843881607056,9212,2318,6894,6894,0,31,2328000.0
2328,2328999,20.850934893247437,37.27010258928716,0.08302091256105992,1521.9442963600159,185.86894869804382,1127.3501062393188,9216,2320,6896,6896,0,31,2329000.0
2329,2329999,20.847751795136883,37.26483923987771,0.0830561169824654,1522.451959848404,185.94152307510376,1128.0896005630493,9222,2323,6899,6899,0,31,2330000.0
2330,2330999,20.844200839402987,37.25931040154066,0.0830966789872073,1522.9374525547028,186.01499557495117,1129.4300775527954,9224,2324,6900,6900,0,31,2331000.0
2331,2331999,20.84052702604753,37.25413140929864,0.08312223186017631,1523.4799864292145,186.0889961719513,1130.2716302871704,9228,2326,6902,6902,0,31,2332000.0
2332,2332999,20.83695144127444,37.249197095913836,0.08314617350692555,1524.1570780277252,186.16247582435608,1130.3605127334595,9232,2328,6904,6904,0,31,2333000.0
2333,2333999,20.8335695974688,37.243902771619275,0.0831720869389121,1524.7345266342163,186.2359094619751,1131.1425867080688,9234,2329,6905,6905,0,31,2334000.0
2334,2334999,20.830698570550172,37.241755739497826,0.08317170425822118,1525.0539915561676,186.30958771705627,1133.2921380996704,9234,2329,6905,6905,0,31,2335000.0
2335,2335999,20.828034677270075,37.23848318768224,0.08317319726729744,1525.845944404602,186.3840036392212,1133.1108102798462,9236,2330,6906,6906,0,31,2336000.0
2336,2336999,20.825644409809605,37.23451621235444,0.08317215206727735,1526.2568218708038,186.45769119262695,1134.5216836929321,9238,2331,6907,6907,0,31,2337000.0
2337,2337999,20.824114111371895,37.238466731602735,0.08312666510052114,1527.2863554954529,186.53202438354492,1133.3592386245728,9240,2332,6908,6908,0,31,2338000.0
2338,2338999,20.82224201838395,37.235119316818036,0.08311369685502767,1528.0036435127258,186.6042001247406,1133.6295557022095,9240,2332,6908,6908,0,31,2339000.0
2339,2339999,20.819793314626207,37.23061977960478,0.08311170248111699,1528.8291177749634,186.6787428855896,1133.1393823623657,9245,2333,6912,6912,0,31,2340000.0
2340,2340999,20.818441969978398,37.22810651484469,0.0830908762301461,1529.2895584106445,186.75376105308533,1134.5551080703735,9245,2333,6912,6912,0,31,2341000.0
2341,2341999,20.816374474372534,37.223735282330374,0.0830873305857428,1529.8134298324585,186.82536673545837,1135.6483011245728,9245,2333,6912,6912,0,31,2342000.0
2342,2342999,20.814864109589926,37.22541546149108,0.08306218875301452,1530.5468780994415,186.89942359924316,1135.6980447769165,9245,2333,6912,6912,0,31,2343000.0
2343,2343999,20.813173180363027,37.22161363651366,0.08304567050293821,1531.2923431396484,186.97458148002625,1135.4190454483032,9247,2334,6913,6913,0,31,2344000.0
2344,2344999,20.81138135059469,37.218122718874305,0.08302036758332643,1532.2953758239746,187.04924941062927,1134.504921913147,9247,2334,6913,6913,0,31,2345000.0
2345,2345999,20.808622825679773,37.21276882504769,0.08301028825609691,1532.5645048618317,187.12050008773804,1136.59854221344,9249,2335,6914,6914,0,31,2346000.0
2346,2346999,20.805172349236855,37.21337106448015,0.08300888125371586,1532.915386915207,187.19223833084106,1138.4871377944946,9261,2336,6925,6925,0,31,2347000.0
2347,2347999,20.801130327448927,37.20807253043695,0.08303772181910529,1533.4127323627472,187.26288676261902,1139.8082208633423,9263,2336,6927,6927,0,31,2348000.0
2348,2348999,20.796631272430737,37.20156274509958,0.08308009198152333,1533.9992141723633,187.3333089351654,1140.4855127334595,9265,2337,6928,6928,0,31,2349000.0
2349,2349999,20.792857201918647,37.19667493807681,0.08310879797829152,1534.5677573680878,187.40392398834229,1140.9221353530884,9269,2339,6930,6930,0,31,2350000.0
2350,2350999,20.788837774348366,37.190728026568095,0.08313847065359814,1535.1679074764252,187.47751998901367,1141.7713174819946,9269,2339,6930,6930,0,31,2351000.0
2351,2351999,20.785045984406405,37.18544877228153,0.08316218510384366,1535.9506421089172,187.5490198135376,1141.5379724502563,9271,2340,6931,6931,0,31,2352000.0
2352,2352999,20.781049549726163,37.179306862945545,0.0831876894287622,1536.4681043624878,187.62173557281494,1142.6172723770142,9271,2340,6931,6931,0,31,2353000.0
2353,2353999,20.77714939120591,37.17405908292705,0.08321090190354108,1537.2894232273102,187.69353914260864,1142.3399286270142,9271,2340,6931,6931,0,31,2354000.0
2354,2354999,20.773896721659572,37.16943849232495,0.08322706311009653,1537.8161268234253,187.76526021957397,1143.4256219863892,9271,2340,6931,6931,0,31,2355000.0
2355,2355999,20.770808740894505,37.16449379876016,0.08323267844877191,1538.4398503303528,187.84004306793213,1144.1568841934204,9271,2340,6931,6931,0,31,2356000.0
2356,2356999,20.76865669890633,37.16059718940411,0.08321888497951979,1538.9702579975128,187.912442445755,1145.2217721939087,9271,2340,6931,6931,0,31,2357000.0
2357,2357999,20.766843530003523,37.15716511724872,0.08320344065511909,1539.9198534488678,187.98598980903625,1143.9592370986938,9273,2341,6932,6932,0,31,2358000.0
2358,2358999,20.765769125661475,37.15537390338132,0.08316641299838112,1540.5316219329834,188.06040406227112,1144.6655130386353,9273,2341,6932,6932,0,31,2359000.0
2359,2359999,20.76442893018753,37.152775253224114,0.08313426973263693,1541.3869667053223,188.13597774505615,1143.8482370376587,9288,2343,6945,6945,0,31,2360000.0
2360,2360999,20.76380922219303,37.1514076557373,0.08310725340324221,1541.7486505508423,188.2089340686798,1145.2158288955688,9297,2345,6952,6952,0,31,2361000.0
2361,2361999,20.763644931655605,37.15061949771506,0.08307910804719754,1542.2353901863098,188.28242254257202,1146.2286386489868,9299,2346,6953,6953,0,31,2362000.0
2362,2362999,20.763271437252804,37.14908944876368,0.08306368870592362,1548.8008487224579,188.3564190864563,1148.4566812515259,9299,2346,6953,6953,0,31,2363000.0
2363,2363999,20.763866596134758,37.14889226436277,0.08305065703507075,1549.3934619426727,188.43066477775574,1149.049012184143,9301,2347,6954,6954,0,31,2364000.0
2364,2364999,20.763317058896753,37.14758113932368,0.08304193909162316,1550.0201802253723,188.5038719177246,1149.8100290298462,9301,2347,6954,6954,0,31,2365000.0
2365,2365999,20.762001950939272,37.14377863506469,0.08304096890503354,1550.785230398178,188.57681441307068,1149.7545862197876,9302,2347,6955,6955,0,31,2366000.0
2366,2366999,20.760307029168864,37.14076036173588,0.08303047406309316,1551.3019857406616,188.6539294719696,1150.975365638733,9311,2347,6964,6964,0,31,2367000.0
2367,2367999,20.75661464551975,37.135334756331446,0.0830575537254008,1551.7533686161041,188.71687006950378,1152.2561349868774,9316,2348,6968,6968,0,31,2368000.0
2368,2368999,20.753624209553767,37.13336652373519,0.08305522379338826,1552.360365152359,188.78184747695923,1152.8999490737915,9318,2348,6970,6970,0,31,2369000.0
2369,2369999,20.749759447643168,37.12716469088771,0.08308406843819616,1552.9536445140839,188.84751439094543,1153.7181329727173,9321,2348,6973,6973,0,31,2370000.0
2370,2370999,20.746734269118736,37.122276869567834,0.08308598011228696,1553.5163218975067,188.91098833084106,1154.1043939590454,9325,2350,6975,6975,0,31,2371000.0
2371,2371999,20.743472910546867,37.117372971821865,0.08309827053256813,1554.1994669437408,188.97723841667175,1154.1424036026,9343,2353,6990,6990,0,31,2372000.0
2372,2372999,20.740351502166895,37.11449689652173,0.08310194827170592,1554.485642194748,189.04184341430664,1156.4229593276978,9343,2353,6990,6990,0,31,2373000.0
2373,2373999,20.737060977517057,37.108941672405074,0.08311912660854281,1554.9973118305206,189.1059205532074,1157.5854959487915,9344,2353,6991,6991,0,31,2374000.0
2374,2374999,20.73397011082846,37.103654073950715,0.08313374899087078,1555.4143011569977,189.17080855369568,1159.2435235977173,9344,2353,6991,6991,0,31,2375000.0
2375,2375999,20.730956356408587,37.098433764631956,0.0831442207312112,1556.105001449585,189.23585677146912,1159.0769891738892,9348,2355,6993,6993,0,31,2376000.0
2376,2376999,20.727906217550405,37.09337628133687,0.08315382169124141,1556.9115061759949,189.3026294708252,1158.891167640686,9348,2355,6993,6993,0,31,2377000.0
2377,2377999,20.725731026418618,37.089594737138434,0.08314174989254164,1557.3234839439392,189.36788535118103,1160.5129251480103,9348,2355,6993,6993,0,31,2378000.0
2378,2378999,20.72336125937226,37.08559987978427,0.08313356599337385,1557.952190876007,189.43261122703552,1161.106484413147,9349,2355,6994,6994,0,31,2379000.0
2379,2379999,20.72228034583396,37.084358199393925,0.08309531336835363,1558.8839888572693,189.49770522117615,1160.2831506729126,9349,2355,6994,6994,0,31,2380000.0
2380,2380999,20.72305642140918,37.092414596877035,0.0830116825520103,1559.5145778656006,189.56502652168274,1160.8563776016235,9350,2355,6995,6995,0,31,2381000.0
2381,2381999,20.72427192291758,37.095312694112,0.08294964540100302,1560.2473948001862,189.63136434555054,1160.9069833755493,9350,2355,6995,6995,0,31,2382000.0
2382,2382999,20.725926390350306,37.09798231694183,0.08288989325702023,1560.876484632492,189.6979742050171,1161.6143808364868,9351,2355,6996,6996,0,31,2383000.0
2383,2383999,20.728073377099047,37.10277196574831,0.08282875281853952,1561.3974149227142,189.76281094551086,1162.6792306900024,9351,2355,6996,6996,0,31,2384000.0
2384,2384999,20.730309727714513,37.10545867470889,0.08276734066671176,1562.0951611995697,189.82843923568726,1162.6848993301392,9353,2356,6997,6997,0,31,2385000.0
2385,2385999,20.7320364064632,37.10782434662158,0.08270576392316675,1562.9743399620056,189.8949043750763,1161.668511390686,9358,2358,7000,7000,0,31,2386000.0
2386,2386999,20.733498042025698,37.10885776868738,0.08264752415186871,1563.7578518390656,189.96048760414124,1161.0799722671509,9361,2360,7001,7001,0,31,2387000.0
2387,2387999,20.731553721326378,37.10419835821199,0.08263724367754322,1564.4770064353943,190.02804470062256,1161.3322534561157,9368,2360,7008,7008,0,31,2388000.0
2388,2388999,20.72881300454747,37.099744304590665,0.08264334121014894,1564.8683545589447,190.09352612495422,1163.182686805725,9370,2360,7010,7010,0,31,2389000.0
2389,2389999,20.726864654371006,37.09750135106018,0.08263319087851106,1565.4722890853882,190.16093468666077,1163.7873010635376,9372,2361,7011,7011,0,31,2390000.0
2390,2390999,20.724357996756854,37.09338942590186,0.08263443160350603,1566.2925095558167,190.22855877876282,1163.4475412368774,9375,2362,7013,7013,0,31,2391000.0
2391,2391999,20.72188803574981,37.08862997748683,0.08262981662555935,1567.0970222949982,190.29380321502686,1162.9388818740845,9379,2364,7015,7015,0,31,2392000.0
2392,2392999,20.719380754194322,37.083587118877375,0.08263756450765392,1567.9139556884766,190.36058449745178,1162.349289894104,9383,2366,7017,7017,0,31,2393000.0
2393,2393999,20.717430744460565,37.07894245111181,0.0826282900301909,1568.4519786834717,190.42638659477234,1163.4631280899048,9383,2366,7017,7017,0,31,2394000.0
2394,2394999,20.715057549179054,37.073802220701516,0.08263474766027246,1569.0770740509033,190.49141120910645,1163.923020362854,9385,2367,7018,7018,0,31,2395000.0
2395,2395999,20.7127664865217,37.069651930456274,0.08263572694282584,1569.8064122200012,190.55680203437805,1163.8583002090454,9400,2368,7032,7032,0,31,2396000.0
2396,2396999,20.71061992567829,37.06642174919477,0.08262841806327303,1570.223816871643,190.6237552165985,1165.5728693008423,9401,2368,7033,7033,0,31,2397000.0
2397,2397999,20.708711464029232,37.06216095152742,0.08262017847621594,1571.1710505485535,190.6897416114807,1164.5125741958618,9403,2369,7034,7034,0,31,2398000.0
2398,2398999,20.707322749052032,37.05890159912765,0.08260571741884504,1571.9080047607422,190.75476837158203,1164.6208810806274,9403,2369,7034,7034,0,31,2399000.0
2399,2399999,20.70636550621442,37.05684750533175,0.08259233560490731,1572.5334258079529,190.82224130630493,1165.0458307266235,9405,2370,7035,7035,0,31,2400000.0
2400,2400999,20.70683673206067,37.057082784804585,0.08255371135991463,1572.8409729003906,190.88793015480042,1167.1623315811157,9405,2370,7035,7035,0,31,2401000.0
2401,2401999,20.70673508709497,37.05578634387725,0.08252504572712438,1573.3652052879333,190.95376658439636,1168.2542963027954,9405,2370,7035,7035,0,31,2402000.0
2402,2402999,20.707112116041454,37.055312175122594,0.08249649859215635,1574.3687903881073,191.0202980041504,1167.0134592056274,9407,2371,7036,7036,0,31,2403000.0
2403,2403999,20.710372010102233,37.06195395249583,0.08243864399685996,1575.0289506912231,191.09239435195923,1167.6072473526,9407,2371,7036,7036,0,31,2404000.0
2404,2404999,20.71351705299971,37.06934925366701,0.08237216620296228,1575.5587770938873,191.1576681137085,1168.6764993667603,9407,2371,7036,7036,0,31,2405000.0
2405,2405999,20.716976724178735,37.07469044835159,0.0823334586715968,1576.5633215904236,191.231525182724,1167.39639377594,9411,2373,7038,7038,0,31,2406000.0
2406,2406999,20.71915668187381,37.076385740533844,0.08233401701810172,1577.0827207565308,191.2983021736145,1168.4910440444946,9411,2373,7038,7038,0,31,2407000.0
2407,2407999,20.718381971613688,37.075940311702944,0.08233726766379146,1577.4242944717407,191.3652355670929,1170.0629892349243,9424,2375,7049,7049,0,31,2408000.0
2408,2408999,20.71694175520651,37.08562809174267,0.08225240698876723,1577.9390184879303,191.4339120388031,1171.226098060608,9424,2375,7049,7049,0,31,2409000.0
2409,2409999,20.714776811953254,37.082320488439706,0.0822412227595879,1578.144556760788,191.50729656219482,1173.9030771255493,9424,2375,7049,7049,0,31,2410000.0
2410,2410999,20.712844218386923,37.07850873283603,0.0822420996136568,1579.1392652988434,191.57429718971252,1172.4040994644165,9429,2377,7052,7052,0,31,2411000.0
2411,2411999,20.71056136092307,37.074658714119344,0.08222744081480049,1579.6291377544403,191.63972449302673,1173.6157236099243,9431,2378,7053,7053,0,31,2412000.0
2412,2412999,20.70872579772012,37.07112073056389,0.08221926862544726,1580.4009728431702,191.7060775756836,1173.3283624649048,9435,2380,7055,7055,0,31,2413000.0
2413,2413999,20.706140143913945,37.06614932506736,0.08222521922566761,1581.3574879169464,191.77238249778748,1172.2581796646118,9442,2381,7061,7061,0,31,2414000.0
2414,2414999,20.704371737347888,37.062111555619786,0.08222746046080343,1581.8906190395355,191.8376109600067,1173.3164987564087,9442,2381,7061,7061,0,31,2415000.0
2415,2415999,20.702207128932336,37.058387644039165,0.0822249851005219,1582.3250606060028,191.90421795845032,1174.9099969863892,9442,2381,7061,7061,0,31,2416000.0
2416,2416999,20.700025590452935,37.05398638201613,0.08222700214477363,1583.1034128665924,191.9708285331726,1175.0088968276978,9442,2381,7061,7061,0,31,2417000.0
2417,2417999,20.698302453406836,37.050900836874256,0.08221553362309508,1584.1854364871979,192.03822803497314,1173.5258798599243,9442,2381,7061,7061,0,31,2418000.0
2418,2418999,20.696308931141576,37.04688293691654,0.08219911687714077,1584.9495182037354,192.10578203201294,1173.4742441177368,9442,2381,7061,7061,0,31,2419000.0
2419,2419999,20.695178958696005,37.04541954913742,0.0821825354312844,1585.4718322753906,192.1734561920166,1174.6158609390259,9442,2381,7061,7061,0,31,2420000.0
2420,2420999,20.694421517242002,37.044197882065546,0.08216426226498841,1585.9921646118164,192.24156880378723,1175.4131326675415,9444,2382,7062,7062,0,31,2421000.0
2421,2421999,20.695250873763467,37.04626082146014,0.08214658823904641,1586.8172125816345,192.3076786994934,1174.9148797988892,9446,2383,7063,7063,0,31,2422000.0
2422,2422999,20.695569426832066,37.04849468173349,0.08213906499194701,1587.546847820282,192.37585520744324,1175.1210641860962,9447,2383,7064,7064,0,31,2423000.0
2423,2423999,20.69794678326117,37.05267985461599,0.08212313051758302,1588.0449388027191,192.4448845386505,1176.1190881729126,9449,2384,7065,7065,0,31,2424000.0
2424,2424999,20.699986693867793,37.05691149955351,0.08213453418984296,1588.8466691970825,192.51486802101135,1175.84654712677,9452,2385,7067,7067,0,31,2425000.0
2425,2425999,20.70261942393421,37.06286707163352,0.08210437023117689,1589.3771932125092,192.58309030532837,1176.9152269363403,9452,2385,7067,7067,0,31,2426000.0
2426,2426999,20.7036874719446,37.063847415108384,0.08209777991153977,1590.3401896953583,192.6512598991394,1175.9288835525513,9452,2385,7067,7067,0,31,2427000.0
2427,2427999,20.705272696094106,37.06844206486022,0.08206236201626127,1590.8382005691528,192.71866703033447,1176.842885017395,9454,2386,7068,7068,0,31,2428000.0
2428,2428999,20.7044828727782,37.067063297203084,0.08202506885053573,1591.558667421341,192.78493118286133,1177.1288423538208,9467,2386,7081,7081,0,31,2429000.0
2429,2429999,20.703527840519662,37.06710989578522,0.08196713409131606,1592.070868730545,192.85206985473633,1178.2939805984497,9468,2386,7082,7082,0,31,2430000.0
2430,2430999,20.70196699110957,37.06459949533226,0.08196334138856509,1592.5551505088806,192.91702008247375,1179.400143623352,9471,2387,7084,7084,0,31,2431000.0
2431,2431999,20.699868917751758,37.06096503275447,0.08194349375627874,1593.1620409488678,192.98803234100342,1179.9570360183716,9474,2388,7086,7086,0,31,2432000.0
2432,2432999,20.698195522565392,37.057537143620685,0.0819182687320894,1593.6937654018402,193.0537486076355,1181.0493822097778,9474,2388,7086,7086,0,31,2433000.0
2433,2433999,20.697002196970182,37.05638676444759,0.08188761699638714,1594.7193882465363,193.1215877532959,1179.7001466751099,9476,2389,7087,7087,0,31,2434000.0
2434,2434999,20.695460999454713,37.054561307484,0.08185608029505143,1595.3005752563477,193.18781423568726,1180.5473375320435,9478,2390,7088,7088,0,31,2435000.0
2435,2435999,20.69383819485468,37.05083866133768,0.08183172453114107,1596.0530543327332,193.25515294075012,1180.5871782302856,9478,2390,7088,7088,0,31,2436000.0
2436,2436999,20.692070808240537,37.04674629794957,0.08181177273870854,1596.5978128910065,193.32187032699585,1181.5891771316528,9478,2390,7088,7088,0,31,2437000.0
2437,2437999,20.690698930865107,37.04298012574412,0.08178322238746683,1597.0169868469238,193.38809418678284,1183.1552019119263,9478,2390,7088,7088,0,31,2438000.0
2438,2438999,20.689189852925466,37.03929128728598,0.08176264929296528,1597.7477807998657,193.45671916007996,1183.0080919265747,9480,2391,7089,7089,0,31,2439000.0
2439,2439999,20.68774723950304,37.035730815988984,0.08174185703298009,1598.461092710495,193.52415585517883,1183.027226448059,9482,2392,7090,7090,0,31,2440000.0
2440,2440999,20.686704374846663,37.03322280624341,0.08170784252548058,1599.207659482956,193.59229922294617,1182.9981355667114,9484,2393,7091,7091,0,31,2441000.0
2441,2441999,20.686072847907663,37.03122065699305,0.08167510425409574,1599.631477355957,193.6580228805542,1184.601445198059,9484,2393,7091,7091,0,31,2442000.0
2442,2442999,20.685027887026536,37.0277034164283,0.0816417249090804,1600.1704258918762,193.72710585594177,1185.6025285720825,9484,2393,7091,7091,0,31,2443000.0
2443,2443999,20.684669571316007,37.02570171238244,0.0816030410213976,1600.7979581356049,193.79390668869019,1186.1546144485474,9484,2393,7091,7091,0,31,2444000.0
2444,2444999,20.68434301853191,37.02293163721523,0.08156802620410564,1601.5203812122345,193.86411499977112,1186.161213874817,9486,2394,7092,7092,0,31,2445000.0
2445,2445999,20.68419348599373,37.020774646485265,0.08152893566424224,1602.6894128322601,193.93657279014587,1184.1320161819458,9486,2394,7092,7092,0,31,2446000.0
2446,2446999,20.68367332013942,37.01828964444716,0.08149676815409912,1603.3161809444427,194.00722217559814,1184.8650407791138,9486,2394,7092,7092,0,31,2447000.0
2447,2447999,20.683482240566686,37.015529507104105,0.08146906985127433,1604.1623873710632,194.07599520683289,1184.36803150177,9486,2394,7092,7092,0,31,2448000.0
2448,2448999,20.683079083789632,37.015501494375144,0.0814377412260342,1604.5772075653076,194.14437627792358,1185.9283876419067,9486,2394,7092,7092,0,31,2449000.0
2449,2449999,20.682876362311156,37.01656033328765,0.08138985551758826,1605.3969373703003,194.2121295928955,1185.508038520813,9497,2395,7102,7102,0,31,2450000.0
2450,2450999,20.681809291949374,37.01355019051858,0.08135211628847328,1605.7986767292023,194.28031539916992,1187.1781129837036,9501,2395,7106,7106,0,31,2451000.0
2451,2451999,20.68079070737097,37.01034259295599,0.08133501496857254,1606.4268548488617,194.34942150115967,1187.801251411438,9502,2395,7107,7107,0,31,2452000.0
2452,2452999,20.67957251363972,37.00714753675924,0.08131680708751443,1606.996746301651,194.41598916053772,1188.415982246399,9506,2397,7109,7109,0,31,2453000.0
2453,2453999,20.678571440106676,37.00521966167548,0.08129302412878014,1607.6089494228363,194.4854302406311,1188.9905061721802,9508,2398,7110,7110,0,31,2454000.0
2454,2454999,20.678187954315074,37.00469408182087,0.08126255790786241,1608.3384006023407,194.55198168754578,1188.9266481399536,9514,2401,7113,7113,0,31,2455000.0
2455,2455999,20.67745482297122,37.00163953210926,0.08123898984316336,1608.87700009346,194.61748099327087,1190.0345659255981,9514,2401,7113,7113,0,31,2456000.0
2456,2456999,20.67718568649095,37.00063040575046,0.08120443500668495,1609.9132890701294,194.6855251789093,1188.7040224075317,9516,2402,7114,7114,0,31,2457000.0
2457,2457999,20.67632521494281,36.99811834320198,0.08118704948577804,1610.5771009922028,194.75501680374146,1189.2723360061646,9516,2402,7114,7114,0,31,2458000.0
2458,2458999,20.675405460082235,36.9946984250921,0.08116273930416817,1611.0825819969177,194.82541131973267,1189.9791917800903,9520,2404,7116,7116,0,31,2459000.0
2459,2459999,20.67507725723181,36.99260606316758,0.08114343106715338,1611.3992567062378,194.89047265052795,1192.117802619934,9520,2404,7116,7116,0,31,2460000.0
2460,2460999,20.674655401407623,36.99457415169151,0.08111001557814157,1612.4432418346405,194.95720982551575,1190.5648469924927,9524,2405,7119,7119,0,31,2461000.0
2461,2461999,20.674630928068026,36.99284160860627,0.08110550025056451,1613.1093456745148,195.02807641029358,1190.8289308547974,9526,2406,7120,7120,0,31,2462000.0
2462,2462999,20.67405113501854,36.989539729856574,0.08109941288614575,1614.083466053009,195.09664583206177,1189.8585939407349,9526,2406,7120,7120,0,31,2463000.0
2463,2463999,20.673437957246005,36.98624848259319,0.08110349936447947,1614.7245004177094,195.16571307182312,1190.4167375564575,9526,2406,7120,7120,0,31,2464000.0
2464,2464999,20.6734883243439,36.983661919117274,0.0810934063121097,1615.0387074947357,195.23227667808533,1192.5112886428833,9526,2406,7120,7120,0,31,2465000.0
2465,2465999,20.672601265581992,36.979673191611404,0.08108654074045873,1615.7788712978363,195.30020093917847,1192.5439500808716,9526,2406,7120,7120,0,31,2466000.0
2466,2466999,20.671931128288055,36.97597208014366,0.08106763711460152,1616.3060069084167,195.37333011627197,1193.589566230774,9526,2406,7120,7120,0,31,2467000.0
2467,2467999,20.67112866832749,36.9758852984241,0.08104436184466957,1616.7970712184906,195.44081139564514,1194.9473237991333,9540,2406,7134,7134,0,31,2468000.0
2468,2468999,20.670194886626355,36.97446882724948,0.08103236026616112,1617.2762322425842,195.50655817985535,1196.050862312317,9547,2407,7140,7140,0,31,2469000.0
2469,2469999,20.6688972349414,36.97275502566989,0.0810182681918743,1617.581894159317,202.05736136436462,1198.2298593521118,9548,2407,7141,7141,0,31,2470000.0
2470,2470999,20.667792973698997,36.97030856365174,0.08100459753027711,1618.2371289730072,202.1250250339508,1198.491723060608,9554,2409,7145,7145,0,31,2471000.0
2471,2471999,20.66689948583331,36.96796415816975,0.08099088947955457,1619.0652117729187,202.19190621376038,1198.0364999771118,9556,2410,7146,7146,0,31,2472000.0
2472,2472999,20.665248294265925,36.96404047625038,0.08098087292420741,1619.5679919719696,202.2574806213379,1199.372742652893,9556,2410,7146,7146,0,31,2473000.0
2473,2473999,20.665108149666622,36.96338716316589,0.08095869790277688,1620.4927537441254,202.3248929977417,1198.3039102554321,9560,2412,7148,7148,0,31,2474000.0
2474,2474999,20.66385743327572,36.96034537313396,0.08095063816920467,1621.0248384475708,202.39358735084534,1199.1176843643188,9562,2413,7149,7149,0,31,2475000.0
2475,2475999,20.663457312337247,36.96605041243101,0.08089793130908851,1621.5576050281525,202.45998430252075,1200.1997003555298,9562,2413,7149,7149,0,31,2476000.0
2476,2476999,20.662727266964914,36.963993844136105,0.08087259510458977,1622.096066236496,202.52897810935974,1200.985047340393,9564,2414,7150,7150,0,31,2477000.0
2477,2477999,20.662961465630836,36.9664243092024,0.08084139039484783,1622.6186273097992,202.59793281555176,1202.0539102554321,9566,2415,7151,7151,0,31,2478000.0
2478,2478999,20.66318720211694,36.96514531443188,0.0808162678484633,1623.34090590477,202.6658079624176,1202.2042398452759,9579,2416,7163,7163,0,31,2479000.0
2479,2479999,20.66460370835819,36.96584282182098,0.08077341109791503,1624.0726954936981,202.73502802848816,1202.43447971344,9579,2416,7163,7163,0,31,2480000.0
2480,2480999,20.66550845385863,36.965792054687654,0.08074402521466806,1625.0475783348083,202.80631351470947,1201.4345026016235,9579,2416,7163,7163,0,31,2481000.0
2481,2481999,20.66777631003935,36.96797649336447,0.08070616880609593,1626.0984473228455,202.8738877773285,1199.9025049209595,9581,2417,7164,7164,0,31,2482000.0
2482,2482999,20.670141318779404,36.97605900979867,0.08064066030145978,1626.6309788227081,202.94044518470764,1200.963173866272,9581,2417,7164,7164,0,31,2483000.0
2483,2483999,20.672284929911182,36.97909915250742,0.0806056861592781,1627.5534119606018,203.00837445259094,1200.0363397598267,9586,2418,7168,7168,0,31,2484000.0
2484,2484999,20.673763879795995,36.97897916237953,0.08058488518479445,1628.1899495124817,203.07860898971558,1200.582947731018,9586,2418,7168,7168,0,31,2485000.0
2485,2485999,20.675785843711296,36.98219379424123,0.08054781411159517,1628.6103720664978,203.14852023124695,1202.1411142349243,9586,2418,7168,7168,0,31,2486000.0
2486,2486999,20.67566070321236,36.97959636457515,0.0805355742432482,1629.4282777309418,203.2175817489624,1201.6243829727173,9589,2419,7170,7170,0,31,2487000.0
2487,2487999,20.674143634481453,36.97765128947156,0.0805147883988615,1630.1235990524292,203.28351759910583,1201.7991800308228,9603,2420,7183,7183,0,31,2488000.0
2488,2488999,20.672772043879714,36.9761941818471,0.0805011040317648,1630.4217813014984,203.34890842437744,1203.9807443618774,9605,2420,7185,7185,0,31,2489000.0
2489,2489999,20.671563015147704,36.97436787630851,0.08049188935486384,1631.0194039344788,203.4171268939972,1204.5888833999634,9607,2421,7186,7186,0,31,2490000.0
2490,2490999,20.670537588657673,36.97306407484796,0.08048194351895444,1631.6291909217834,203.48451352119446,1205.1483240127563,9609,2422,7187,7187,0,31,2491000.0
2491,2491999,20.668976500343618,36.97171565249139,0.08047141497514165,1632.1773192882538,203.55177116394043,1205.5985193252563,9617,2425,7192,7192,0,31,2492000.0
2492,2492999,20.667370027346166,36.96884448518711,0.08046718001420405,1632.7448337078094,203.61984205245972,1206.2895669937134,9621,2427,7194,7194,0,31,2493000.0
2493,2493999,20.665948579737382,36.966266316947426,0.08044931813873313,1633.3907141685486,203.68740344047546,1206.9031457901,9621,2427,7194,7194,0,31,2494000.0
2494,2494999,20.664254677500743,36.962590451834096,0.0804424323611651,1634.0425825119019,203.75504899024963,1207.4760599136353,9621,2427,7194,7194,0,31,2495000.0
2495,2495999,20.66317398179723,36.961839194765616,0.08042482812104856,1634.7925572395325,203.8213288784027,1207.6849069595337,9621,2427,7194,7194,0,31,2496000.0
2496,2496999,20.66125403263863,36.95708590961977,0.0804170019976892,1635.8359334468842,203.88931322097778,1206.1209878921509,9627,2428,7199,7199,0,31,2497000.0
2497,2497999,20.659861090064656,36.95804271431354,0.0803901625670379,1636.4509918689728,203.9583067893982,1206.5898447036743,9634,2429,7205,7205,0,31,2498000.0
2498,2498999,20.658555118080525,36.95483882680438,0.08038476011887286,1637.1828832626343,204.0244619846344,1206.4955224990845,9636,2430,7206,7206,0,31,2499000.0
2499,2499999,20.657243385303072,36.951120899699596,0.08037677783031927,1637.5628643035889,204.08998823165894,1207.895936012268,9640,2432,7208,7208,0,31,2500000.0
2500,2500999,20.6564731828854,36.94970722408176,0.08035932456395012,1638.4147036075592,204.15623140335083,1207.4485177993774,9640,2432,7208,7208,0,31,2501000.0
2501,2501999,20.65524996076039,36.94580896179287,0.08035523177073434,1639.5105519294739,204.22372198104858,1205.7894830703735,9652,2433,7219,7219,0,31,2502000.0
2502,2502999,20.654174359183052,36.94218905612553,0.08034529608409924,1640.0361971855164,204.29125809669495,1206.8624277114868,9652,2433,7219,7219,0,31,2503000.0
2503,2503999,20.653608531846142,36.938855009299374,0.08033447266505822,1640.5582029819489,204.35939025878906,1207.9371271133423,9652,2433,7219,7219,0,31,2504000.0
2504,2504999,20.65241112226616,36.93460820307331,0.08033732038469532,1641.3795058727264,204.4298038482666,1207.4458322525024,9663,2434,7229,7229,0,31,2505000.0
2505,2505999,20.651310783190613,36.93076531624975,0.08033392771411518,1642.5461902618408,204.49803686141968,1205.349190711975,9670,2435,7235,7235,0,31,2506000.0
2506,2506999,20.65045269191068,36.92686520822865,0.08032749494114177,1643.4106533527374,204.56803941726685,1204.8368768692017,9670,2435,7235,7235,0,31,2507000.0
2507,2507999,20.648441679599276,36.92284700886428,0.08031162663762037,1644.0113461017609,204.6345076560974,1205.3487558364868,9682,2436,7246,7246,0,31,2508000.0
2508,2508999,20.645466784322505,36.917070830230664,0.08033089333240029,1644.411628484726,204.69881415367126,1207.0767221450806,9687,2436,7251,7251,0,31,2509000.0
2509,2509999,20.64345398919725,36.91356890941072,0.08033772669155959,1645.0888121128082,204.76753854751587,1207.0787363052368,9694,2438,7256,7256,0,31,2510000.0
2510,2510999,20.641100070466585,36.909594949997114,0.08035668247726813,1645.3977146148682,204.8336877822876,1209.2712259292603,9695,2438,7257,7257,0,31,2511000.0
2511,2511999,20.639034555860302,36.909184513391615,0.08035762387022649,1646.0309460163116,204.89974308013916,1210.03750705719,9696,2438,7258,7258,0,31,2512000.0
2512,2512999,20.636373789876334,36.90416848313852,0.08037551790439557,1647.0015263557434,204.9717755317688,1208.6800699234009,9708,2441,7267,7267,0,31,2513000.0
2513,2513999,20.633931832178067,36.90020049729235,0.08039727324649648,1647.79536318779,205.0427372455597,1208.5576028823853,9711,2442,7269,7269,0,31,2514000.0
2514,2514999,20.631061380553103,36.894894329558014,0.08041059733940026,1648.2091960906982,205.11099886894226,1210.024682044983,9713,2443,7270,7270,0,31,2515000.0
2515,2515999,20.62808395658789,36.89125087336171,0.08042576481551811,1648.7247278690338,205.17741417884827,1211.0675134658813,9721,2444,7277,7277,0,31,2516000.0
2516,2516999,20.62524611734832,36.88592310353593,0.08044453442929889,1649.529664516449,205.2465808391571,1210.5228967666626,9725,2446,7279,7279,0,31,2517000.0
2517,2517999,20.623051931740175,36.88152414344251,0.08045679293400554,1650.2539019584656,205.3152105808258,1210.568428993225,9736,2448,7288,7288,0,31,2518000.0
2518,2518999,20.620612811050933,36.87740176909141,0.0804678189199729,1651.1846814155579,205.383727312088,1209.3166131973267,9740,2450,7290,7290,0,31,2519000.0
2519,2519999,20.61818496436049,36.87237576761697,0.0804800642208312,1651.9394433498383,205.45277070999146,1209.497254371643,9740,2450,7290,7290,0,31,2520000.0
2520,2520999,20.615569582309895,36.86715721173273,0.08049199934143692,1652.3518121242523,205.52144122123718,1211.1186380386353,9740,2450,7290,7290,0,31,2521000.0
2521,2521999,20.613237166984177,36.862709708069,0.08049899616033329,1652.9941937923431,205.5891842842102,1211.6915826797485,9740,2450,7290,7290,0,31,2522000.0
2522,2522999,20.610976922300015,36.858423938958694,0.08051049653228204,1653.1960923671722,205.6543595790863,1214.312653541565,9740,2450,7290,7290,0,31,2523000.0
2523,2523999,20.60928434552032,36.85493910304021,0.08051724263032212,1654.0740847587585,205.72235345840454,1213.9775323867798,9740,2450,7290,7290,0,31,2524000.0
2524,2524999,20.607598758376696,36.85071192836157,0.08052888266158187,1655.0332355499268,205.7891309261322,1213.01691532135,9741,2450,7291,7291,0,31,2525000.0
2525,2525999,20.605774182242836,36.84663338260843,0.08053367657798427,1656.0313427448273,205.85784435272217,1211.874291419983,9741,2450,7291,7291,0,31,2526000.0
2526,2526999,20.603470644711336,36.84207085746184,0.08054806423534022,1656.6392557621002,205.9242672920227,1212.6950464248657,9741,2450,7291,7291,0,31,2527000.0
2527,2527999,20.60130877014736,36.837808483080565,0.08055822650399536,1657.525384426117,205.99172639846802,1211.99307346344,9806,2452,7354,7354,0,31,2528000.0
2528,2528999,20.598712955522743,36.83325320266359,0.08057204815370245,1658.3648264408112,206.06131887435913,1211.7561655044556,9822,2452,7370,7370,0,31,2529000.0
2529,2529999,20.59589198949768,36.829863512018186,0.08058305676727717,1658.5474474430084,206.12761616706848,1214.5225992202759,9824,2452,7372,7372,0,31,2530000.0
2530,2530999,20.59311541703044,36.82533625584393,0.08060038083974497,1659.1566064357758,206.19413423538208,1215.1691980361938,9828,2453,7375,7375,0,31,2531000.0
2531,2531999,20.590830312554846,36.82475359201406,0.08059208629795367,1659.6275203227997,206.26214241981506,1216.2346353530884,9835,2455,7380,7380,0,31,2532000.0
2532,2532999,20.587975890908382,36.82025932008295,0.08060524916882061,1660.0946996212006,206.32850527763367,1217.3328714370728,9844,2457,7387,7387,0,31,2533000.0
2533,2533999,20.58615244330979,36.816799365247,0.0806099121238869,1660.6656637191772,206.39645433425903,1218.0385370254517,9848,2459,7389,7389,0,31,2534000.0
2534,2534999,20.58367465279621,36.811955777167654,0.08062408197207205,1661.0308606624603,206.46407842636108,1219.5931329727173,9852,2461,7391,7391,0,31,2535000.0
2535,2535999,20.581030211518573,36.80711270220538,0.08063297368061728,1661.967375278473,206.53306317329407,1218.6509103775024,9854,2462,7392,7392,0,31,2536000.0
2536,2536999,20.579072467189512,36.80340216273496,0.08063794213251785,1662.5190663337708,206.60225772857666,1219.141900062561,9860,2465,7395,7395,0,31,2537000.0
2537,2537999,20.576600847369072,36.79838463035799,0.08064696627635615,1663.450858592987,206.67117166519165,1218.5685510635376,9860,2465,7395,7395,0,31,2538000.0
2538,2538999,20.574382109933506,36.794358942414455,0.08064922197120528,1663.966013431549,206.73824071884155,1219.5140161514282,9862,2466,7396,7396,0,31,2539000.0
2539,2539999,20.5721907184503,36.789704781244374,0.08065024605597393,1664.6111109256744,206.8055078983307,1220.1179666519165,9862,2466,7396,7396,0,31,2540000.0
2540,2540999,20.570140973491778,36.78561156920421,0.08065225443318502,1665.2511756420135,206.87288284301758,1220.708291053772,9862,2466,7396,7396,0,31,2541000.0
2541,2541999,20.568526767648756,36.78247503308625,0.08064409814292495,1666.1071271896362,206.94166803359985,1220.253716468811,9862,2466,7396,7396,0,31,2542000.0
2542,2542999,20.568535692086954,36.785903088339836,0.08060228109000978,1666.7768993377686,207.00901818275452,1220.1639413833618,9878,2469,7409,7409,0,31,2543000.0
2543,2543999,20.569148640977183,36.786849396809245,0.08057831184483077,1667.5235481262207,207.0776035785675,1220.2426767349243,9878,2469,7409,7409,0,31,2544000.0
2544,2544999,20.569609775436838,36.78755706278563,0.08056931563095815,1668.269638299942,207.14587426185608,1220.31192111969,9879,2469,7410,7410,0,31,2545000.0
2545,2545999,20.570874655864564,36.79182725885548,0.08054180201676253,1668.7958445549011,207.21586537361145,1221.3921365737915,9879,2469,7410,7410,0,31,2546000.0
2546,2546999,20.572469511449132,36.79306995811449,0.08052418902023228,1669.6445724964142,207.28287291526794,1220.6707773208618,9881,2470,7411,7411,0,31,2547000.0
2547,2547999,20.572130719545704,36.79046359749674,0.08052640267965472,1670.223376274109,207.35421895980835,1221.3777780532837,9883,2471,7412,7412,0,31,2548000.0
2548,2548999,20.57088474984186,36.787410858521916,0.08054109541065457,1670.7386195659637,207.42321801185608,1222.523949623108,9888,2471,7417,7417,0,31,2549000.0
2549,2549999,20.56836346904043,36.78463162627848,0.08054566915507577,1671.1141419410706,207.49012112617493,1224.5001459121704,9904,2471,7433,7433,0,31,2550000.0
2550,2550999,20.566243352250503,36.78187038020569,0.08055511809971116,1671.5174374580383,207.55537295341492,1226.2342004776,9904,2471,7433,7433,0,31,2551000.0
2551,2551999,20.56366745143918,36.777188045509114,0.08057417124312705,1671.8921928405762,207.62109899520874,1227.9206094741821,9907,2472,7435,7435,0,31,2552000.0
2552,2552999,20.560973844971453,36.77243681550746,0.08059089449918222,1672.2749121189117,207.68754529953003,1229.5691003799438,9909,2473,7436,7436,0,31,2553000.0
2553,2553999,20.559632993214247,36.770754362164716,0.08057715173704727,1672.7152202129364,207.75387716293335,1230.9524011611938,9913,2475,7438,7438,0,31,2554000.0
2554,2554999,20.557923637538252,36.767401236128165,0.08057863135620436,1673.4315555095673,207.8213756084442,1230.4365701675415,9921,2479,7442,7442,0,31,2555000.0
2555,2555999,20.556680189081707,36.766920252045445,0.0805571802467564,1673.9062581062317,207.88809823989868,1231.5033807754517,9932,2481,7451,7451,0,31,2556000.0
2556,2556999,20.555800860152814,36.7728453727955,0.0805181786674466,1674.5628740787506,207.95514583587646,1231.8102731704712,9936,2483,7453,7453,0,31,2557000.0
2557,2557999,20.555134858017237,36.7718004867346,0.08051224513035882,1675.0610072612762,208.0218276977539,1232.5895547866821,9947,2485,7462,7462,0,31,2558000.0
2558,2558999,20.554118976977705,36.76953568180667,0.08050676443549742,1675.7000477313995,208.0891923904419,1233.2212076187134,9947,2485,7462,7462,0,31,2559000.0
2559,2559999,20.554283712435666,36.77044758444012,0.08049076021168633,1676.1564457416534,208.16127800941467,1234.8491067886353,9947,2485,7462,7462,0,31,2560000.0
2560,2560999,20.554098975243125,36.76980189990878,0.08048252103206588,1677.0899949073792,208.2286388874054,1233.900689125061,9949,2486,7463,7463,0,31,2561000.0
2561,2561999,20.555284689154227,36.7724102488659,0.08046145509313907,1677.6342215538025,208.2967987060547,1234.4186563491821,9955,2489,7466,7466,0,31,2562000.0
2562,2562999,20.55782255269858,36.778370441440096,0.08042149298397017,1678.3440940380096,208.365553855896,1234.556565284729,9964,2490,7474,7474,0,31,2563000.0
2563,2563999,20.559926095476026,36.781095917218494,0.08041537692473666,1679.2837874889374,208.43376922607422,1233.5908823013306,9968,2491,7477,7477,0,31,2564000.0
2564,2564999,20.562922816539132,36.78627263016625,0.08043409637338506,1680.1424443721771,208.5023283958435,1232.3349618911743,9988,2495,7493,7493,0,31,2565000.0
2565,2565999,20.567063727586802,36.793009302285746,0.08041195581503235,1680.9925844669342,208.5703296661377,1231.918038368225,9989,2495,7494,7494,0,31,2566000.0
2566,2566999,20.57246857089619,36.803337309374015,0.0803937223542136,1681.4956448078156,208.6380910873413,1232.952172279358,9998,2496,7502,7502,0,31,2567000.0
2567,2567999,20.576664835112993,36.81196725935042,0.08037893416853825,1682.2876603603363,208.70804262161255,1232.4555139541626,10008,2498,7510,7510,0,31,2568000.0
2568,2568999,20.582011394794634,36.82126695053567,0.08039213264557787,1682.487450838089,208.77581000328064,1235.1404809951782,10008,2498,7510,7510,0,31,2569000.0
2569,2569999,20.58380769925584,36.826661789044294,0.08038583269943622,1683.2110323905945,208.84494996070862,1235.5157251358032,10032,2498,7534,7534,0,31,2570000.0
2570,2570999,20.581778871289345,36.82335215244227,0.08037880215763948,1683.3672246932983,208.91101217269897,1238.4162530899048,10036,2498,7538,7538,0,31,2571000.0
2571,2571999,20.579441787908326,36.82053283552032,0.08038317789392024,1683.7605757713318,208.97852849960327,1240.1603631973267,10036,2498,7538,7538,0,31,2572000.0
2572,2572999,20.57794604326819,36.82095465159062,0.08036263127282184,1684.1306807994843,209.04540371894836,1241.8565454483032,10038,2499,7539,7539,0,31,2573000.0
2573,2573999,20.57612740266893,36.81747093532845,0.08036803424674699,1684.5519165992737,209.1151795387268,1243.5459299087524,10038,2499,7539,7539,0,31,2574000.0
2574,2574999,20.57443651031755,36.81455889275355,0.08036316462511717,1685.200623512268,209.18399715423584,1243.5949792861938,10044,2502,7542,7542,0,31,2575000.0
2575,2575999,20.572492103731957,36.811196898501834,0.08036648766285315,1685.9576497077942,209.25188207626343,1243.3530130386353,10048,2504,7544,7544,0,31,2576000.0
2576,2576999,20.570661569570365,36.80752853525196,0.08036719288333583,1686.5042824745178,209.32080602645874,1243.8523950576782,10061,2507,7554,7554,0,31,2577000.0
2577,2577999,20.56949373372987,36.80457696610782,0.08036597331424433,1687.0362875461578,209.39080286026,1244.372368812561,10067,2510,7557,7557,0,31,2578000.0
2578,2578999,20.568674183670375,36.803288886142894,0.08035190542234938,1687.4641335010529,209.45806908607483,1246.0191583633423,10067,2510,7557,7557,0,31,2579000.0
2579,2579999,20.567070072590738,36.79996899067243,0.08035047859820321,1694.7908647060394,209.52519917488098,1247.1433038711548,10067,2510,7557,7557,0,31,2580000.0
2580,2580999,20.566622833757698,36.79864570615197,0.08033875579224192,1695.39763712883,209.5937798023224,1247.6961755752563,10069,2511,7558,7558,0,31,2581000.0
2581,2581999,20.566177366514218,36.79750924268061,0.08033070910663187,1696.0849766731262,209.6609082221985,1248.47451877594,10069,2511,7558,7558,0,31,2582000.0
2582,2582999,20.56616688373034,36.797203618933466,0.08030911951264674,1696.689031124115,209.72988080978394,1249.1273889541626,10071,2512,7559,7559,0,31,2583000.0
2583,2583999,20.566543955462848,36.797892117594564,0.08029129794351775,1697.2773439884186,209.7989411354065,1249.862328529358,10073,2513,7560,7560,0,31,2584000.0
2584,2584999,20.5669359453823,36.79862200849707,0.08028154682635047,1697.8921840190887,209.86839890480042,1250.3925867080688,10078,2514,7564,7564,0,31,2585000.0
2585,2585999,20.567796418419444,36.798732932862485,0.0802721897082127,1698.8169164657593,209.93815803527832,1249.4733743667603,10080,2515,7565,7565,0,31,2586000.0
2586,2586999,20.56936195780731,36.800124783168044,0.08024986554227753,1699.6359786987305,210.00736689567566,1249.0509271621704,10083,2516,7567,7567,0,31,2587000.0
2587,2587999,20.570755168219325,36.8011438334416,0.0802264689647193,1700.4627022743225,210.07703590393066,1248.2718896865845,10098,2518,7580,7580,0,31,2588000.0
2588,2588999,20.57327676678688,36.8036942328395,0.08020090374308397,1700.96307015419,210.14622688293457,1249.390694618225,10108,2519,7589,7589,0,31,2589000.0
2589,2589999,20.576477671347817,36.80919810863585,0.08015995518791952,1701.7816243171692,210.21541476249695,1248.8663873672485,10110,2520,7590,7590,0,31,2590000.0
2590,2590999,20.576187484388146,36.80726405479304,0.08015083987246907,1702.123830318451,210.28227472305298,1250.6778955459595,10136,2522,7614,7614,0,31,2591000.0
2591,2591999,20.573793174608223,36.80478373351991,0.08015581806302263,1702.4054071903229,210.34933710098267,1253.0549631118774,10142,2522,7620,7620,0,31,2592000.0
2592,2592999,20.571522232834965,36.801814254262084,0.08017072335675368,1702.8758141994476,210.41679191589355,1254.3127908706665,10145,2523,7622,7622,0,31,2593000.0
2593,2593999,20.568813604480997,36.7972847804724,0.08018941611767294,1703.1492505073547,210.48294925689697,1256.5205011367798,10147,2524,7623,7623,0,31,2594000.0
2594,2594999,20.56616543892873,36.79253377289634,0.08020336258329475,1703.4264402389526,210.5492606163025,1258.7169046401978,10149,2525,7624,7624,0,31,2595000.0
2595,2595999,20.563566738437377,36.78795305338061,0.08022346632799959,1703.9768931865692,210.61601090431213,1259.2806787490845,10155,2528,7627,7627,0,31,2596000.0
2596,2596999,20.56096623500654,36.783189946937426,0.08022863213896458,1704.554743051529,210.6845622062683,1259.8538675308228,10162,2530,7632,7632,0,31,2597000.0
2597,2597999,20.558413544471502,36.77897705233081,0.08023882674363492,1705.1580836772919,210.7536859512329,1260.4768686294556,10164,2531,7633,7633,0,31,2598000.0
2598,2598999,20.556286446988363,36.77532298315021,0.0802416938074344,1705.927478313446,210.82149171829224,1259.9685907363892,10179,2534,7645,7645,0,31,2599000.0
2599,2599999,20.55388339445733,36.77083534894733,0.08025099289334359,1706.5186581611633,210.88971972465515,1260.5280847549438,10183,2536,7647,7647,0,31,2600000.0
2600,2600999,20.552217437903987,36.76777088747397,0.0802447889003648,1707.132056236267,210.95759296417236,1261.4332056045532,10184,2536,7648,7648,0,31,2601000.0
2601,2601999,20.550698961335865,36.764438972397556,0.08025132256641232,1707.8260703086853,211.03160095214844,1261.5769510269165,10194,2538,7656,7656,0,31,2602000.0
2602,2602999,20.54963917864535,36.76213308892612,0.08025191525325492,1708.4331653118134,211.10006761550903,1262.1507730484009,10196,2539,7657,7657,0,31,2603000.0
2603,2603999,20.54869916447395,36.759649139002576,0.08024716035595747,1709.7306830883026,211.1685929298401,1259.0458536148071,10202,2542,7660,7660,0,31,2604000.0
2604,2604999,20.54855785575226,36.75841005459258,0.08022845395655354,1710.2527086734772,211.2361421585083,1260.1459894180298,10202,2542,7660,7660,0,31,2605000.0
2605,2605999,20.548986028027397,36.75782103933397,0.08022228417693911,1710.8730008602142,211.3045551776886,1260.8093347549438,10203,2542,7661,7661,0,31,2606000.0
2606,2606999,20.54888296918147,36.75704053802169,0.08020558387548338,1711.0681309700012,211.37107825279236,1263.486008644104,10203,2542,7661,7661,0,31,2607000.0
2607,2607999,20.549447282458864,36.7558797177964,0.08019692461085504,1711.555980205536,211.43823409080505,1264.5439004898071,10205,2543,7662,7662,0,31,2608000.0
2608,2608999,20.547255663396847,36.75212100602206,0.08020677087138195,1711.938613653183,211.50681972503662,1266.5782861709595,10235,2543,7692,7692,0,31,2609000.0
2609,2609999,20.544493199985,36.74754838209456,0.08022780376248151,1712.2108778953552,211.57286500930786,1268.9306955337524,10238,2543,7695,7695,0,31,2610000.0
2610,2610999,20.541889684419402,36.74371068312517,0.08024850270279649,1712.601866722107,211.64198446273804,1270.6785516738892,10240,2543,7697,7697,0,31,2611000.0
2611,2611999,20.538740742185038,36.738404536002236,0.0802753698838129,1713.076330423355,211.70952701568604,1271.9259195327759,10242,2544,7698,7698,0,31,2612000.0
2612,2612999,20.535635004653354,36.733741532966974,0.08030821328083093,1713.478859424591,211.77664160728455,1273.6738290786743,10242,2544,7698,7698,0,31,2613000.0
2613,2613999,20.53244094150779,36.7284165860955,0.08033926028569216,1713.9724025726318,211.84443426132202,1274.7665872573853,10244,2545,7699,7699,0,31,2614000.0
2614,2614999,20.529296117068384,36.7240088542561,0.08035766835472546,1714.5052320957184,211.91298723220825,1275.3788614273071,10260,2548,7712,7712,0,31,2615000.0
2615,2615999,20.5261514373784,36.7191306762367,0.0803797387496632,1714.8688592910767,211.98052525520325,1277.2097787857056,10262,2549,7713,7713,0,31,2616000.0
2616,2616999,20.523086605101582,36.713741884965394,0.08040331663814637,1715.7021017074585,212.04870891571045,1276.707558631897,10264,2550,7714,7714,0,31,2617000.0
2617,2617999,20.520428838870355,36.70942142174539,0.08041255565055194,1716.3957381248474,212.11772465705872,1276.7021417617798,10268,2552,7716,7716,0,31,2618000.0
2618,2618999,20.517585790693985,36.7049159117133,0.08041685422101208,1716.956194639206,212.18717122077942,1277.364052772522,10272,2554,7718,7718,0,31,2619000.0
2619,2619999,20.515577495281843,36.70206854387384,0.08042077328552066,1717.2760062217712,212.25602221488953,1279.5229196548462,10272,2554,7718,7718,0,31,2620000.0
2620,2620999,20.514017669402655,36.70028684770344,0.08040304765875905,1718.0173196792603,212.3245713710785,1279.4804697036743,10278,2557,7721,7721,0,31,2621000.0
2621,2621999,20.51281628761599,36.698757397411214,0.08039393728821731,1719.1957368850708,212.39472270011902,1276.7362070083618,10286,2561,7725,7725,0,31,2622000.0
2622,2622999,20.513788479519057,36.704962603436606,0.08032504304554311,1720.1518404483795,212.46425104141235,1275.8292322158813,10286,2561,7725,7725,0,31,2623000.0
2623,2623999,20.514058888246065,36.70527121089904,0.08028563347320172,1720.9646508693695,212.53614115715027,1275.459267616272,10289,2562,7727,7727,0,31,2624000.0
2624,2624999,20.514681152746505,36.70580924225389,0.08026055211705674,1721.576308965683,212.6054482460022,1276.01406955719,10300,2563,7737,7737,0,31,2625000.0
2625,2625999,20.51497764820321,36.705618076485266,0.08024239210050543,1721.8833391666412,212.67475867271423,1278.193657875061,10300,2563,7737,7737,0,31,2626000.0
2626,2626999,20.514595254007723,36.70339471572615,0.08023582228722881,1722.807538509369,212.74516105651855,1276.7966089248657,10308,2567,7741,7741,0,31,2627000.0
2627,2627999,20.513122379954762,36.69988705517311,0.08023203512157151,1723.306206703186,212.812748670578,1277.887505531311,10310,2568,7742,7742,0,31,2628000.0
2628,2628999,20.51018160272642,36.69474398363799,0.08023718012794834,1723.845909833908,212.88211345672607,1278.8253870010376,10340,2570,7770,7770,0,31,2629000.0
2629,2629999,20.506813767454187,36.691629481502396,0.08023788006286647,1724.127552986145,212.95012140274048,1281.136658668518,10343,2570,7773,7773,0,31,2630000.0
2630,2630999,20.503414403291092,36.686478914413364,0.08025171001628184,1724.6270442008972,213.0168263912201,1282.4782190322876,10345,2570,7775,7775,0,31,2631000.0
2631,2631999,20.50055896907304,36.68204999480244,0.08026183945184706,1725.0147252082825,213.08328676223755,1284.4351587295532,10345,2570,7775,7775,0,31,2632000.0
2632,2632999,20.497403013007403,36.67712406671205,0.08027328328709615,1725.6643373966217,213.14982676506042,1284.8786172866821,10349,2572,7777,7777,0,31,2633000.0
2633,2633999,20.494418926940654,36.672996973835986,0.0802833417791583,1726.1625018119812,213.2243196964264,1285.997612953186,10354,2574,7780,7780,0,31,2634000.0
2634,2634999,20.4910938788371,36.66830094283889,0.08029649814721496,1726.6613657474518,213.29255557060242,1287.1056909561157,10356,2575,7781,7781,0,31,2635000.0
2635,2635999,20.487994866691796,36.663132944242875,0.08030735986521276,1727.5142755508423,213.36416912078857,1285.7103815078735,10366,2580,7786,7786,0,31,2636000.0
2636,2636999,20.48516813534652,36.66083801335494,0.08030225991037265,1727.720346212387,213.4324188232422,1288.4063501358032,10366,2580,7786,7786,0,31,2637000.0
2637,2637999,20.48260558582036,36.6565879804783,0.0803060251413047,1728.6870291233063,213.50177764892578,1286.8569498062134,10370,2582,7788,7788,0,31,2638000.0
2638,2638999,20.47974370067025,36.651894552636726,0.08030875032601392,1729.1002054214478,213.56927371025085,1288.6785287857056,10370,2582,7788,7788,0,31,2639000.0
2639,2639999,20.47722273145027,36.648814594887185,0.08030743381519101,1729.8392777442932,213.63804459571838,1288.9838190078735,10370,2582,7788,7788,0,31,2640000.0
2640,2640999,20.475091964939914,36.64470476647111,0.08030449500993153,1730.4087128639221,213.70525407791138,1289.6306924819946,10374,2584,7790,7790,0,31,2641000.0
2641,2641999,20.47338701504371,36.64159288112541,0.08028998939570209,1730.950135231018,213.77486515045166,1290.7406091690063,10374,2584,7790,7790,0,31,2642000.0
2642,2642999,20.472292840287885,36.63931301355539,0.08027128165264885,1731.9900968074799,213.84573578834534,1289.4704217910767,10376,2585,7791,7791,0,31,2643000.0
2643,2643999,20.47140312819759,36.63680138053256,0.08025262969582436,1732.5833058357239,213.91261458396912,1290.1134805679321,10378,2586,7792,7792,0,31,2644000.0
2644,2644999,20.470982102787225,36.634965470905634,0.0802337212184524,1733.1028861999512,213.97952556610107,1291.241639137268,10380,2586,7794,7794,0,31,2645000.0
2645,2645999,20.47256995424319,36.63626232388216,0.08019982777573742,1733.8239991664886,214.04776525497437,1291.5234537124634,10380,2586,7794,7794,0,31,2646000.0
2646,2646999,20.473439974859772,36.635502676956555,0.08018349620774701,1734.4532282352448,214.11481714248657,1292.134934425354,10380,2586,7794,7794,0,31,2647000.0
2647,2647999,20.474753780122757,36.636608712799415,0.08018330167930765,1735.0308785438538,214.1832036972046,1292.6887369155884,10384,2588,7796,7796,0,31,2648000.0
2648,2648999,20.47467363701874,36.636331883376826,0.08017683268164855,1735.7441651821136,214.2529537677765,1292.9581460952759,10384,2588,7796,7796,0,31,2649000.0
2649,2649999,20.47203489224921,36.63270380911991,0.08017104751948534,1736.0937795639038,214.3208634853363,1294.9531183242798,10417,2589,7828,7828,0,31,2650000.0
2650,2650999,20.468810586221554,36.62846599832846,0.08016999034961014,1736.5937643051147,214.3882806301117,1296.223427772522,10417,2589,7828,7828,0,31,2651000.0
2651,2651999,20.46575170287299,36.6238882065056,0.0801698568947572,1736.935504436493,214.45457673072815,1297.9254083633423,10432,2591,7841,7841,0,31,2652000.0
2652,2652999,20.46314846003414,36.62021689774595,0.08016234821616941,1737.4240736961365,214.5207598209381,1299.0870447158813,10434,2592,7842,7842,0,31,2653000.0
2653,2653999,20.46059799397345,36.61683823322437,0.08016020175769978,1737.8575932979584,214.58994722366333,1300.1691446304321,10441,2595,7846,7846,0,31,2654000.0
2654,2654999,20.458377182713107,36.61389829900991,0.08015419306086569,1738.3246886730194,214.65922665596008,1301.3397226333618,10455,2597,7858,7858,0,31,2655000.0
2655,2655999,20.45623329981459,36.61036618939577,0.0801493695678056,1738.8966002464294,214.72659587860107,1302.18000125885,10457,2598,7859,7859,0,31,2656000.0
2656,2656999,20.454279636945852,36.6066003580704,0.08014708396129777,1739.468294620514,214.79480266571045,1302.7427072525024,10461,2600,7861,7861,0,31,2657000.0
2657,2657999,20.45278553262932,36.60414304792694,0.08013807499435821,1740.0754420757294,214.86216831207275,1303.3199167251587,10463,2601,7862,7862,0,31,2658000.0
2658,2658999,20.452075329603794,36.60309889632176,0.08011165186149827,1740.608298778534,214.92997026443481,1304.4449701309204,10463,2601,7862,7862,0,31,2659000.0
2659,2659999,20.453630422737376,36.60635902507691,0.08004536486833558,1741.2201039791107,214.99954676628113,1304.9943323135376,10465,2602,7863,7863,0,31,2660000.0
2660,2660999,20.456075417457033,36.61109527592521,0.07997706671957605,1741.990462064743,215.0686845779419,1304.4734659194946,10471,2605,7866,7866,0,31,2661000.0
2661,2661999,20.45880120659912,36.61671829563097,0.07992504616727991,1742.558660030365,215.1362385749817,1305.2054147720337,10487,2607,7880,7880,0,31,2662000.0
2662,2662999,20.46317900712107,36.62984447932507,0.07984929564523457,1743.4011375904083,215.20553994178772,1304.5275201797485,10505,2610,7895,7895,0,31,2663000.0
2663,2663999,20.468470638259227,36.64621285372274,0.0797957491601663,1744.0227484703064,215.27314639091492,1304.925576210022,10513,2613,7900,7900,0,31,2664000.0
2664,2664999,20.47367627804031,36.659325926257004,0.07976196161162774,1744.715769290924,215.34330248832703,1304.6711511611938,10532,2616,7916,7916,0,31,2665000.0
2665,2665999,20.477977909730622,36.66519430629913,0.07976988846073063,1745.6944253444672,215.4128143787384,1303.1632165908813,10554,2620,7934,7934,0,31,2666000.0
2666,2666999,20.484619923266575,36.67691259681986,0.07979910012054192,1746.3035717010498,215.4845314025879,1303.8558740615845,10556,2621,7935,7935,0,31,2667000.0
2667,2667999,20.488757446721625,36.681463176465236,0.07981974224944388,1747.3647224903107,215.5534040927887,1302.2282037734985,10562,2624,7938,7938,0,31,2668000.0
2668,2668999,20.492156623467032,36.68657007828172,0.07982645378679398,1747.8961544036865,215.62320256233215,1303.4697427749634,10562,2624,7938,7938,0,31,2669000.0
2669,2669999,20.49045530472365,36.68622048270175,0.07980571567060335,1748.0577986240387,215.69187784194946,1306.5429697036743,10591,2624,7967,7967,0,31,2670000.0
2670,2670999,20.489091884419594,36.68697801244682,0.07975471900271014,1748.2281489372253,215.7589030265808,1309.3517923355103,10593,2624,7969,7969,0,31,2671000.0
2671,2671999,20.48670427941856,36.68315259881301,0.07975773181788426,1748.4931325912476,215.826726436615,1311.5706186294556,10597,2625,7972,7972,0,31,2672000.0
2672,2672999,20.484244398472256,36.68001767012854,0.0797471644403186,1748.8639352321625,215.89289045333862,1313.2387552261353,10599,2626,7973,7973,0,31,2673000.0
2673,2673999,20.48180526514755,36.676580668310024,0.07974828757935148,1749.535198688507,215.95970559120178,1313.2982873916626,10604,2628,7976,7976,0,31,2674000.0
2674,2674999,20.479234615963623,36.67238588219911,0.07974734626565039,1750.0826296806335,216.02654242515564,1314.0895929336548,10621,2630,7991,7991,0,31,2675000.0
2675,2675999,20.476596718568384,36.667765657568346,0.07974851289591744,1750.8411393165588,216.09557938575745,1314.153618812561,10621,2630,7991,7991,0,31,2676000.0
2676,2676999,20.47479515869913,36.66513352568347,0.07975779272029027,1751.6613521575928,216.16502118110657,1313.5900964736938,10627,2633,7994,7994,0,31,2677000.0
2677,2677999,20.472668756637287,36.66217181442359,0.07976096107558339,1751.8844196796417,216.23326706886292,1316.260293006897,10627,2633,7994,7994,0,31,2678000.0
2678,2678999,20.47125848648195,36.662077863060624,0.07974082499416091,1752.6167011260986,216.3020658493042,1316.468529701233,10627,2633,7994,7994,0,31,2679000.0
2679,2679999,20.471937367188975,36.66901413888354,0.07969920941616171,1753.2408702373505,216.36911821365356,1317.4130029678345,10627,2633,7994,7994,0,31,2680000.0
2680,2680999,20.474451636346554,36.678874162896946,0.07964998612787666,1753.9919965267181,216.43695545196533,1316.7708597183228,10646,2637,8009,8009,0,31,2681000.0
2681,2681999,20.477336711466805,36.68791606121989,0.07961347863248391,1754.5990931987762,216.50707697868347,1317.3943796157837,10648,2638,8010,8010,0,31,2682000.0
2682,2682999,20.48277353832823,36.706284399625865,0.07958968877182793,1755.4961290359497,216.57615900039673,1316.5137720108032,10652,2640,8012,8012,0,31,2683000.0
2683,2683999,20.487686729257643,36.7207666030309,0.0795719906245067,1756.166564464569,216.64559721946716,1316.5095682144165,10668,2643,8025,8025,0,31,2684000.0
2684,2684999,20.493450494287885,36.73506189174376,0.07964077129580616,1756.9993832111359,216.7131848335266,1315.850380897522,10673,2645,8028,8028,0,31,2685000.0
2685,2685999,20.501263661529773,36.75317517091715,0.0796341775509184,1757.5929601192474,216.78085684776306,1315.9355478286743,10693,2648,8045,8045,0,31,2686000.0
2686,2686999,20.50916962410666,36.77006037535003,0.07969385094005965,1758.2730054855347,216.848801612854,1316.0937051773071,10697,2650,8047,8047,0,31,2687000.0
2687,2687999,20.516120290009482,36.785314957193165,0.0797244613215028,1758.7969198226929,216.91891956329346,1317.5561075210571,10697,2650,8047,8047,0,31,2688000.0
2688,2688999,20.522159095484234,36.79750286767513,0.07977503279670617,1759.4037175178528,216.9897482395172,1317.9835062026978,10701,2652,8049,8049,0,31,2689000.0
2689,2689999,20.523560233004574,36.79801706921261,0.07975158418385597,1759.798032283783,217.05773329734802,1319.9914560317993,10730,2652,8078,8078,0,31,2690000.0
2690,2690999,20.52192552346438,36.79913619627098,0.07972328441192977,1760.0560793876648,217.12487602233887,1322.4169702529907,10733,2652,8081,8081,0,31,2691000.0
2691,2691999,20.519565398424145,36.79519117308581,0.07972020131617297,1760.3148620128632,217.18975830078125,1324.6402826309204,10751,2653,8098,8098,0,31,2692000.0
2692,2692999,20.51753709388308,36.79230728142778,0.07970906740446826,1768.0386459827423,217.25875616073608,1325.3514108657837,10754,2654,8100,8100,0,31,2693000.0
2693,2693999,20.51495079967743,36.78845855719422,0.07970816524094138,1768.736344575882,217.3259472846985,1325.535080909729,10757,2655,8102,8102,0,31,2694000.0
2694,2694999,20.51238960718683,36.784509455310065,0.07970102418395575,1769.5640406608582,217.39614486694336,1325.2647867202759,10775,2657,8118,8118,0,31,2695000.0
2695,2695999,20.510488520662765,36.78268685914906,0.0796835068007703,1769.837631225586,217.46321392059326,1327.3980875015259,10777,2658,8119,8119,0,31,2696000.0
2696,2696999,20.508159417892898,36.778937292494746,0.07967145037478851,1770.5187265872955,217.53178548812866,1327.8719415664673,10779,2659,8120,8120,0,31,2697000.0
2697,2697999,20.505347832294717,36.77428235805174,0.07967683491203814,1771.4848322868347,217.6003453731537,1326.5741357803345,10785,2662,8123,8123,0,31,2698000.0
2698,2698999,20.50288237933548,36.77006418498939,0.07967040566113825,1771.7963094711304,217.6679491996765,1328.3814630508423,10787,2663,8124,8124,0,31,2699000.0
2699,2699999,20.500836688023117,36.767813448808475,0.07965455632426832,1772.21404504776,217.73436880111694,1329.7355508804321,10789,2664,8125,8125,0,31,2700000.0
2700,2700999,20.499039106960947,36.76459357063469,0.07963946821467449,1772.9131164550781,217.80693221092224,1329.7984247207642,10817,2666,8151,8151,0,31,2701000.0
2701,2701999,20.497087018110374,36.761015811655426,0.07963325181143976,1773.4649021625519,217.8763861656189,1330.3117532730103,10837,2670,8167,8167,0,31,2702000.0
2702,2702999,20.495242376965354,36.757642070887215,0.07962473668847514,1774.1423494815826,217.94411516189575,1330.428147315979,10846,2673,8173,8173,0,31,2703000.0
2703,2703999,20.4943275667306,36.759905708240645,0.07958793606404624,1774.9835603237152,218.01354455947876,1329.6055994033813,10850,2675,8175,8175,0,31,2704000.0
2704,2704999,20.493138036281014,36.75734261872551,0.07957817000971468,1775.5897624492645,218.08503890037537,1330.1996088027954,10852,2676,8176,8176,0,31,2705000.0
2705,2705999,20.491519245548833,36.753847015677565,0.07957553583425991,1776.455194234848,218.15323209762573,1330.1117792129517,10853,2676,8177,8177,0,31,2706000.0
2706,2706999,20.490547677863873,36.75101672021683,0.07957237247676918,1777.1701638698578,218.22050023078918,1330.210862159729,10856,2677,8179,8179,0,31,2707000.0
2707,2707999,20.48991438349037,36.749348993083444,0.07955746404984743,1777.7036516666412,218.28841948509216,1331.3476648330688,10856,2677,8179,8179,0,31,2708000.0
2708,2708999,20.488616890367002,36.74609502199037,0.07955055978435455,1778.3978753089905,218.35608053207397,1331.2715311050415,10860,2679,8181,8181,0,31,2709000.0
2709,2709999,20.486805762025153,36.74250632924902,0.07954222856050897,1779.0131623744965,218.423597574234,1331.715889930725,10862,2680,8182,8182,0,31,2710000.0
2710,2710999,20.484509646943366,36.73811608987852,0.07953694772697695,1779.2988340854645,218.49379348754883,1334.188141822815,10893,2680,8213,8213,0,31,2711000.0
2711,2711999,20.48177163736968,36.7338360204298,0.07953800773968611,1779.6724030971527,218.56106305122375,1336.0388269424438,10902,2680,8222,8222,0,31,2712000.0
2712,2712999,20.478749478818862,36.728630543033994,0.07954591757124019,1779.8435039520264,218.62653470039368,1338.8101053237915,10903,2680,8223,8223,0,31,2713000.0
2713,2713999,20.476287402779025,36.7241638516615,0.0795517603705006,1780.3186259269714,218.69349837303162,1339.9777994155884,10905,2681,8224,8224,0,31,2714000.0
2714,2714999,20.473922494678984,36.72038695519067,0.07954808590310092,1780.7928550243378,218.7640504837036,1341.0764627456665,10921,2683,8238,8238,0,31,2715000.0
2715,2715999,20.47103469039594,36.71572968537969,0.0795542370042871,1781.2561593055725,218.83134841918945,1342.1994180679321,10925,2685,8240,8240,0,31,2716000.0
2716,2716999,20.468580319749222,36.71324875628163,0.07955765653503954,1781.795669555664,218.89931797981262,1342.7584314346313,10931,2688,8243,8243,0,31,2717000.0
2717,2717999,20.466484510195183,36.70960389979688,0.07956039122701164,1782.234361410141,218.96768760681152,1343.7742166519165,10937,2691,8246,8246,0,31,2718000.0
2718,2718999,20.46472172721308,36.706551311807544,0.0795559293601531,1783.00128865242,219.03541707992554,1343.2899026870728,10943,2694,8249,8249,0,31,2719000.0
2719,2719999,20.462719284220526,36.70314843259238,0.07955032808233442,1783.842155456543,219.10295701026917,1342.930588722229,10943,2694,8249,8249,0,31,2720000.0
2720,2720999,20.460974518787182,36.699707571643806,0.079544201742903,1784.1494846343994,219.17023158073425,1345.0937280654907,10943,2694,8249,8249,0,31,2721000.0
2721,2721999,20.460158610443962,36.69752660627924,0.07953975268660696,1784.35973238945,219.23692989349365,1347.7441110610962,10943,2694,8249,8249,0,31,2722000.0
2722,2722999,20.45970894343142,36.69694212555974,0.07952420976969143,1784.9967014789581,219.3050241470337,1348.0644693374634,10949,2697,8252,8252,0,31,2723000.0
2723,2723999,20.459570139717265,36.69578161786486,0.07951830302461504,1785.9913432598114,219.37314200401306,1346.7330713272095,10955,2699,8256,8256,0,31,2724000.0
2724,2724999,20.459671994536297,36.69513249975105,0.07950847525915261,1786.6163563728333,219.44212412834167,1347.3909616470337,10956,2699,8257,8257,0,31,2725000.0
2725,2725999,20.459772086000235,36.694308847422015,0.07951410034481365,1787.2497293949127,219.51025223731995,1347.3715677261353,10974,2703,8271,8271,0,31,2726000.0
2726,2726999,20.46006418894692,36.69387653656342,0.0795259783974217,1788.1338741779327,219.5786521434784,1346.5848932266235,10979,2705,8274,8274,0,31,2727000.0
2727,2727999,20.460447010143223,36.69378146400602,0.07952877671763525,1788.7347302436829,219.6464490890503,1347.204041481018,10982,2706,8276,8276,0,31,2728000.0
2728,2728999,20.461555622023244,36.69464336932921,0.07954063089027186,1789.0477120876312,219.71562886238098,1349.3893823623657,10982,2706,8276,8276,0,31,2729000.0
2729,2729999,20.46249708630955,36.69452027368336,0.07954658880592058,1790.1918437480927,219.78512001037598,1347.3785104751587,10984,2707,8277,8277,0,31,2730000.0
2730,2730999,20.462214691779256,36.69326700865859,0.07955877041538661,1790.5525562763214,219.85105562210083,1348.823998451233,10988,2709,8279,8279,0,31,2731000.0
2731,2731999,20.461059652389565,36.69100681170264,0.07954967895658305,1790.8364861011505,219.9189453125,1351.299126625061,11017,2709,8308,8308,0,31,2732000.0
2732,2732999,20.45786979892238,36.68717530961602,0.07957220248942998,1791.1124773025513,219.98643374443054,1353.7022638320923,11028,2709,8319,8319,0,31,2733000.0
2733,2733999,20.45543269890052,36.685572971091794,0.07957852769364537,1791.882616519928,220.05605173110962,1353.345986366272,11047,2711,8336,8336,0,31,2734000.0
2734,2734999,20.452393384424578,36.68075811650327,0.07960442209452911,1792.151701450348,220.12222290039062,1355.5303354263306,11049,2712,8337,8337,0,31,2735000.0
2735,2735999,20.449778569010046,36.676737452041124,0.07961729655361038,1792.560532093048,220.18940210342407,1357.3310556411743,11050,2712,8338,8338,0,31,2736000.0
2736,2736999,20.447234846769486,36.67331008179713,0.07963234927731933,1793.4302508831024,220.2584400177002,1356.3339014053345,11056,2715,8341,8341,0,31,2737000.0
2737,2737999,20.444985857514578,36.669932103354455,0.0796487505138308,1793.8157069683075,220.3273856639862,1357.977562904358,11058,2716,8342,8342,0,31,2738000.0
2738,2738999,20.442382684921604,36.66633369156783,0.07966261845450706,1794.310408115387,220.39566254615784,1359.216950416565,11060,2717,8343,8343,0,31,2739000.0
2739,2739999,20.44009743794707,36.663037970505826,0.0796759626821677,1795.0322840213776,220.4686017036438,1359.1939249038696,11064,2719,8345,8345,0,31,2740000.0
2740,2740999,20.437854480797334,36.65921332330291,0.07969271159039049,1795.4878749847412,220.53768754005432,1360.2392740249634,11070,2722,8348,8348,0,31,2741000.0
2741,2741999,20.435889911573216,36.65573254892025,0.07970491987898387,1795.9734423160553,220.6067430973053,1361.3875436782837,11078,2724,8354,8354,0,31,2742000.0
2742,2742999,20.433846556367307,36.653098527511716,0.07971077363915291,1797.0034663677216,220.67816376686096,1359.8740091323853,11082,2726,8356,8356,0,31,2743000.0
2743,2743999,20.432585514135088,36.65147609764524,0.07970214261277897,1797.3991074562073,220.7454104423523,1361.4869089126587,11084,2727,8357,8357,0,31,2744000.0
2744,2744999,20.43065157023445,36.647995558227834,0.07971930477125078,1798.4037561416626,220.81440329551697,1359.8353281021118,11090,2730,8360,8360,0,31,2745000.0
2745,2745999,20.42972470344368,36.646401715497014,0.07971349427058572,1798.9016852378845,220.88174748420715,1361.1910791397095,11091,2730,8361,8361,0,31,2746000.0
2746,2746999,20.427904067328708,36.642679524826896,0.0797331490034282,1799.4692542552948,220.95095324516296,1361.743332862854,11096,2732,8364,8364,0,31,2747000.0
2747,2747999,20.42615441230783,36.639043836406245,0.07974309657181211,1799.8787682056427,221.0222291946411,1363.6424341201782,11096,2732,8364,8364,0,31,2748000.0
2748,2748999,20.42400105795006,36.63514836658415,0.07976636825755745,1800.5645697116852,221.09427952766418,1363.6766901016235,11100,2734,8366,8366,0,31,2749000.0
2749,2749999,20.421322746010325,36.631283484344564,0.07978055964239561,1800.8497688770294,221.16389870643616,1366.190453529358,11134,2734,8400,8400,0,31,2750000.0
2750,2750999,20.417834559571787,36.6266340427508,0.0798120666921962,1801.0821821689606,221.23075127601624,1368.5346612930298,11142,2735,8407,8407,0,31,2751000.0
2751,2751999,20.41449323695749,36.621339929528496,0.07984916598174407,1801.3660950660706,221.298841714859,1370.8029108047485,11144,2735,8409,8409,0,31,2752000.0
2752,2752999,20.411365444401756,36.61696234531752,0.07987274500218577,1801.7059519290924,221.36483526229858,1373.0627450942993,11146,2735,8411,8411,0,31,2753000.0
2753,2753999,20.408468843144632,36.612756921280564,0.07990088172682064,1802.0057399272919,221.43037104606628,1375.2517175674438,11146,2735,8411,8411,0,31,2754000.0
2754,2754999,20.40542586885627,36.608405663699344,0.07992112096716675,1802.5408647060394,221.49687123298645,1376.0963068008423,11150,2737,8413,8413,0,31,2755000.0
2755,2755999,20.402593115787813,36.60466071622222,0.07993175603659575,1803.0180859565735,221.56348729133606,1377.0116739273071,11154,2739,8415,8415,0,31,2756000.0
2756,2756999,20.399919557985985,36.60093374440086,0.07993676183377108,1803.8895847797394,221.63473629951477,1375.9409799575806,11160,2742,8418,8418,0,31,2757000.0
2757,2757999,20.397539263596425,36.59721870341219,0.0799408322138283,1804.176742553711,221.70318746566772,1378.0572519302368,11162,2743,8419,8419,0,31,2758000.0
2758,2758999,20.39514667822664,36.59350250913426,0.07993934350350795,1804.6710937023163,221.77073526382446,1379.1717691421509,11164,2744,8420,8420,0,31,2759000.0
2759,2759999,20.393968023420467,36.59823275057364,0.07989541817995782,1805.15234541893,221.83797430992126,1380.391625404358,11166,2745,8421,8421,0,31,2760000.0
2760,2760999,20.392133214068682,36.595137376226994,0.0798883889913733,1805.6805176734924,221.90623450279236,1381.50674533844,11166,2745,8421,8421,0,31,2761000.0
2761,2761999,20.390802263661236,36.59262175336773,0.07987148230221441,1806.5449686050415,221.9739429950714,1380.456696510315,11172,2748,8424,8424,0,31,2762000.0
2762,2762999,20.389643706086623,36.59035116950603,0.07985190989712121,1807.3794486522675,222.04197549819946,1379.778489112854,11178,2751,8427,8427,0,31,2763000.0
2763,2763999,20.390005018309886,36.590464125951115,0.07982439165857735,1807.9468684196472,222.11205506324768,1380.6828393936157,11181,2752,8429,8429,0,31,2764000.0
2764,2764999,20.389374663886574,36.58895698329564,0.07980990293124846,1808.8818986415863,222.17946219444275,1379.7902765274048,11185,2753,8432,8432,0,31,2765000.0
2765,2765999,20.38941057626284,36.58818669792919,0.07978587282602578,1809.3760070800781,222.2465043067932,1380.8767938613892,11187,2754,8433,8433,0,31,2766000.0
2766,2766999,20.389376928660152,36.5870201903648,0.07976866823702289,1809.676192998886,222.31449556350708,1383.0475015640259,11187,2754,8433,8433,0,31,2767000.0
2767,2767999,20.389308415720066,36.5850601384404,0.07974282597312599,1810.0530128479004,222.38207745552063,1384.6309442520142,11189,2755,8434,8434,0,31,2768000.0
2768,2768999,20.388795085065023,36.58242983439433,0.07972655951482022,1810.5449285507202,222.45101237297058,1385.7419900894165,11191,2756,8435,8435,0,31,2769000.0
2769,2769999,20.386675916837728,36.579421058817815,0.07971084818317786,1811.4105660915375,222.5208969116211,1385.1742715835571,11227,2758,8469,8469,0,31,2770000.0
2770,2770999,20.383155574895465,36.57433739605009,0.07973470639147728,1811.814162015915,222.593279838562,1387.0047693252563,11232,2758,8474,8474,0,31,2771000.0
2771,2771999,20.380032566864507,36.569998864854725,0.07974793264796987,1812.2386393547058,222.66399574279785,1388.7864236831665,11234,2758,8476,8476,0,31,2772000.0
2772,2772999,20.376704592848107,36.566039761508044,0.07976411382460558,1812.6905992031097,222.7295572757721,1389.9424676895142,11238,2760,8478,8478,0,31,2773000.0
2773,2773999,20.373824191011305,36.56251024663096,0.07977286719607002,1813.1368029117584,222.79740405082703,1391.3440027236938,11243,2762,8481,8481,0,31,2774000.0
2774,2774999,20.370613914298154,36.55811404080438,0.07978663935701669,1813.6791360378265,222.8643763065338,1392.3388833999634,11262,2764,8498,8498,0,31,2775000.0
2775,2775999,20.367621728354234,36.55331721352947,0.07979846790546974,1814.1642391681671,222.9309685230255,1393.6843957901,11264,2765,8499,8499,0,31,2776000.0
2776,2776999,20.364502488947608,36.548399488547865,0.0798072348032044,1814.957947254181,222.99804401397705,1393.2421731948853,11268,2767,8501,8501,0,31,2777000.0
2777,2777999,20.361791812199424,36.54408345680333,0.0798105682456619,1815.5404181480408,223.0681231021881,1393.8399438858032,11272,2769,8503,8503,0,31,2778000.0
2778,2778999,20.35899853739455,36.53938979997413,0.07982279873112907,1816.1821627616882,223.13767886161804,1394.192452430725,11274,2770,8504,8504,0,31,2779000.0
2779,2779999,20.35625026161914,36.534750097308795,0.0798273250466679,1816.9526178836823,223.20630311965942,1394.3915719985962,11274,2770,8504,8504,0,31,2780000.0
2780,2780999,20.354338790195946,36.53184840918994,0.07981564211069914,1817.7717862129211,223.27435851097107,1393.7073068618774,11278,2772,8506,8506,0,31,2781000.0
2781,2781999,20.35214732227169,36.527932590642436,0.07981380316399889,1818.7889950275421,223.34328317642212,1392.5290231704712,11282,2774,8508,8508,0,31,2782000.0
2782,2782999,20.350424899028834,36.524876276853114,0.07979865347883963,1819.2189538478851,223.41200232505798,1394.167504310608,11282,2774,8508,8508,0,31,2783000.0
2783,2783999,20.348420326723648,36.52124168357383,0.0797904098709723,1819.691951751709,223.48169660568237,1395.2110376358032,11286,2776,8510,8510,0,31,2784000.0
2784,2784999,20.34664912145062,36.517758257457416,0.07978016501779561,1820.4197449684143,223.5511200428009,1395.2464990615845,11288,2777,8511,8511,0,31,2785000.0
2785,2785999,20.34512936232672,36.514880639261584,0.07977547348366121,1820.9370827674866,223.6193881034851,1396.4486017227173,11289,2777,8512,8512,0,31,2786000.0
2786,2786999,20.343439618589528,36.51127127546465,0.07977222344200674,1821.3503878116608,223.6874976158142,1398.08145236969,11290,2777,8513,8513,0,31,2787000.0
2787,2787999,20.341936114284668,36.50992751341596,0.07975365538351953,1822.088927268982,223.75505208969116,1397.9804849624634,11292,2778,8514,8514,0,31,2788000.0
2788,2788999,20.340149293637797,36.506596210069475,0.07974474337919757,1822.8012342453003,223.82577800750732,1398.0084924697876,11294,2779,8515,8515,0,31,2789000.0
2789,2789999,20.337656999502574,36.50237510783807,0.07974881865710759,1823.3199179172516,223.89291667938232,1399.1329278945923,11294,2779,8515,8515,0,31,2790000.0
2790,2790999,20.337637693030803,36.50968541789221,0.07955035086198192,1823.7240030765533,223.9646725654602,1401.1954736709595,11326,2779,8547,8547,0,31,2791000.0
2791,2791999,20.33823705901356,36.51134576760623,0.07950161400728073,1823.9705033302307,224.03054761886597,1403.488434791565,11331,2780,8551,8551,0,31,2792000.0
2792,2792999,20.33721093548029,36.511519968872925,0.07943170449294534,1824.432653427124,224.10244417190552,1404.7682428359985,11341,2782,8559,8559,0,31,2793000.0
2793,2793999,20.33619394368617,36.51139866652941,0.07941844581735158,1824.618522644043,224.16796708106995,1407.521653175354,11341,2782,8559,8559,0,31,2794000.0
2794,2794999,20.334901506514466,36.51031690211067,0.07941275707410411,1824.9826214313507,224.23432397842407,1409.33975315094,11344,2783,8561,8561,0,31,2795000.0
2795,2795999,20.334783744904698,36.512666808618704,0.07939050114470914,1825.4994411468506,224.30120754241943,1409.914475440979,11352,2787,8565,8565,0,31,2796000.0
2796,2796999,20.33333500236594,36.51061948492682,0.07939073920715256,1825.8567111492157,224.36765694618225,1411.514817237854,11356,2789,8567,8567,0,31,2797000.0
2797,2797999,20.33273446359741,36.51069667026364,0.07938667300309554,1826.9005327224731,224.4356336593628,1410.047059059143,11360,2791,8569,8569,0,31,2798000.0
2798,2798999,20.332443578106336,36.51062211190693,0.07938581228416919,1827.3018834590912,224.50569915771484,1411.5981760025024,11363,2792,8571,8571,0,31,2799000.0
2799,2799999,20.332205224281342,36.515964339462315,0.07935190205055176,1828.0182197093964,224.57471823692322,1411.5751810073853,11365,2793,8572,8572,0,31,2800000.0
2800,2800999,20.331629126974025,36.51470281394366,0.07936380168626622,1828.6127996444702,224.6462779045105,1412.1464700698853,11379,2795,8584,8584,0,31,2801000.0
2801,2801999,20.331108433416787,36.51323460507308,0.07936240730059241,1829.1258993148804,224.7164351940155,1413.5056619644165,11379,2795,8584,8584,0,31,2802000.0
2802,2802999,20.330865881020966,36.51294087094642,0.07935807110352422,1829.7432224750519,224.7846429347992,1414.06045627594,11381,2796,8585,8585,0,31,2803000.0
2803,2803999,20.330569457677566,36.51222205636024,0.07934646196235173,1830.520670890808,224.85242080688477,1413.6785898208618,11385,2798,8587,8587,0,31,2804000.0
2804,2804999,20.32992715147452,36.51064084735895,0.07932837703700457,1831.0074384212494,224.92218947410583,1414.7956476211548,11387,2799,8588,8588,0,31,2805000.0
2805,2805999,20.329742388820424,36.50907045949355,0.07931862692871594,1831.6948580741882,224.99110054969788,1414.4710474014282,11393,2802,8591,8591,0,31,2806000.0
2806,2806999,20.329958753891344,36.507793516563495,0.0793174250475861,1832.3308131694794,225.060054063797,1415.0694131851196,11395,2802,8593,8593,0,31,2807000.0
2807,2807999,20.330688616980922,36.51400900026574,0.07930182508326056,1833.1455466747284,225.12794518470764,1414.602074623108,11397,2803,8594,8594,0,31,2808000.0
2808,2808999,20.330616524146922,36.51228858283428,0.0792958871891346,1833.7518565654755,225.19568371772766,1415.4330759048462,11397,2803,8594,8594,0,31,2809000.0
2809,2809999,20.330338553525955,36.51025805580745,0.07928254770271237,1834.2857975959778,225.26261615753174,1416.5747079849243,11397,2803,8594,8594,0,31,2810000.0
2810,2810999,20.328899269174624,36.50660747880496,0.07926483824667296,1834.7791764736176,225.32978868484497,1417.6297540664673,11408,2804,8604,8604,0,31,2811000.0
2811,2811999,20.326371855558115,36.503028553569756,0.07923881269882616,1835.0072858333588,225.3969841003418,1420.2119989395142,11437,2805,8632,8632,0,31,2812000.0
2812,2812999,20.32357708808778,36.49920415209065,0.07923098438671494,1842.9429111480713,225.4636993408203,1422.5379571914673,11440,2805,8635,8635,0,31,2813000.0
2813,2813999,20.320723490969133,36.49535545790523,0.07923345000365489,1843.4275271892548,225.53105354309082,1423.9118127822876,11441,2805,8636,8636,0,31,2814000.0
2814,2814999,20.317745108785815,36.49075333555695,0.07924781734036501,1843.873322725296,225.59911108016968,1424.8217706680298,11449,2808,8641,8641,0,31,2815000.0
2815,2815999,20.315085910974165,36.48644694480726,0.07925075199658638,1844.3352599143982,225.66606330871582,1425.8986291885376,11453,2810,8643,8643,0,31,2816000.0
2816,2816999,20.31281464288987,36.48350726218039,0.07923916478453852,1844.7902247905731,225.73397374153137,1427.3702325820923,11455,2811,8644,8644,0,31,2817000.0
2817,2817999,20.310558488482194,36.48014169792935,0.0792281096964681,1845.4957430362701,225.801171541214,1427.4354791641235,11457,2812,8645,8645,0,31,2818000.0
2818,2818999,20.308296251415566,36.47637779841115,0.07921647894403994,1846.1359975337982,225.86801767349243,1427.5775156021118,11463,2815,8648,8648,0,31,2819000.0
2819,2819999,20.30590463915583,36.47201325315156,0.07920849799498608,1846.533051252365,225.93524312973022,1429.0871896743774,11465,2816,8649,8649,0,31,2820000.0
2820,2820999,20.303703818527936,36.46785516034647,0.07920231902068009,1847.0282189846039,226.00221991539001,1430.1965646743774,11467,2817,8650,8650,0,31,2821000.0
2821,2821999,20.302001109073114,36.46495559295946,0.07918349410827841,1847.8295540809631,226.0704357624054,1429.6704416275024,11472,2819,8653,8653,0,31,2822000.0
2822,2822999,20.301631884253585,36.472051857773856,0.07912391847916933,1848.594494819641,226.13975548744202,1429.3537149429321,11478,2822,8656,8656,0,31,2823000.0
2823,2823999,20.301612557450788,36.47253476028714,0.07908483253165555,1849.0850338935852,226.2074875831604,1430.5585794448853,11480,2823,8657,8657,0,31,2824000.0
2824,2824999,20.30178690658786,36.47288585206616,0.07905265253217952,1849.5809955596924,226.2761492729187,1431.6572885513306,11482,2824,8658,8658,0,31,2825000.0
2825,2825999,20.302757719116464,36.475176593148234,0.07901922525873573,1850.3511440753937,226.3486888408661,1432.0184183120728,11482,2824,8658,8658,0,31,2826000.0
2826,2826999,20.30343778150692,36.47582125521492,0.07899861747585568,1851.0321984291077,226.41628193855286,1431.8798685073853,11489,2827,8662,8662,0,31,2827000.0
2827,2827999,20.303448910349147,36.47445284018212,0.07898660351953857,1851.7615401744843,226.48768973350525,1432.0046854019165,11490,2827,8663,8663,0,31,2828000.0
2828,2828999,20.305197090088733,36.4761308975911,0.07897979413744793,1852.1799252033234,226.55596137046814,1433.6526193618774,11490,2827,8663,8663,0,31,2829000.0
2829,2829999,20.306382427960855,36.47623375077021,0.07896479065047113,1852.715224981308,226.6224718093872,1434.5751657485962,11492,2828,8664,8664,0,31,2830000.0
2830,2830999,20.306367808369554,36.47427238762355,0.07897010299599594,1853.0933480262756,226.69042873382568,1436.1710290908813,11494,2829,8665,8665,0,31,2831000.0
2831,2831999,20.30516342022158,36.47122280177284,0.07897785744662755,1853.7418866157532,226.7593629360199,1436.9316339492798,11516,2829,8687,8687,0,31,2832000.0
2832,2832999,20.303006574494994,36.46868298453872,0.07895704537854142,1854.0005881786346,226.82534980773926,1439.4469766616821,11536,2829,8707,8707,0,31,2833000.0
2833,2833999,20.300435250155527,36.46570481635366,0.07895781243955191,1854.3634612560272,226.8925552368164,1441.205979347229,11542,2830,8712,8712,0,31,2834000.0
2834,2834999,20.297656428643805,36.46095894712857,0.07896458095896974,1854.6280179023743,226.95993494987488,1443.4204263687134,11545,2831,8714,8714,0,31,2835000.0
2835,2835999,20.29579418625826,36.45751852247135,0.07895687692195441,1855.1243801116943,227.02643418312073,1444.764344215393,11546,2831,8715,8715,0,31,2836000.0
2836,2836999,20.294193978899155,36.455490533328735,0.07894421701345988,1855.8862857818604,227.09605264663696,1444.4859476089478,11551,2833,8718,8718,0,31,2837000.0
2837,2837999,20.29288668763821,36.45428556589117,0.07893173587299618,1856.2715783119202,227.1654372215271,1446.1228876113892,11554,2834,8720,8720,0,31,2838000.0
2838,2838999,20.29234901684181,36.45416598753531,0.07891329852511153,1856.8456060886383,227.2332136631012,1446.6691370010376,11558,2836,8722,8722,0,31,2839000.0
2839,2839999,20.292436781882444,36.45642015912485,0.07888546953928233,1857.5891587734222,227.30254340171814,1445.913025856018,11568,2841,8727,8727,0,31,2840000.0
2840,2840999,20.292822647107304,36.45861281686964,0.07888348861414218,1858.2301099300385,227.3709774017334,1446.5214548110962,11568,2841,8727,8727,0,31,2841000.0
2841,2841999,20.293800117141714,36.46172683365207,0.07889001456584444,1858.6427958011627,227.44163489341736,1447.9435892105103,11570,2842,8728,8728,0,31,2842000.0
2842,2842999,20.29585183248105,36.468248594467845,0.07889628227105228,1859.3329601287842,227.50995659828186,1447.954140663147,11574,2844,8730,8730,0,31,2843000.0
2843,2843999,20.299685951884182,36.48366420931845,0.07891073269521243,1859.712917804718,227.57951974868774,1449.7801599502563,11577,2845,8732,8732,0,31,2844000.0
2844,2844999,20.302794097792425,36.49209444347923,0.07891836139457498,1860.189858198166,227.64792203903198,1451.1569681167603,11579,2846,8733,8733,0,31,2845000.0
2845,2845999,20.307199436195138,36.50565451612588,0.07895538354134646,1860.8484456539154,227.71554398536682,1451.1571207046509,11585,2849,8736,8736,0,31,2846000.0
2846,2846999,20.311875161869114,36.517221484184674,0.0789957640372767,1861.4560668468475,227.78469848632812,1452.113205909729,11585,2849,8736,8736,0,31,2847000.0
2847,2847999,20.316839921631672,36.53110820014839,0.07904734067399544,1862.252798318863,227.85380363464355,1451.8796243667603,11607,2850,8757,8757,0,31,2848000.0
2848,2848999,20.321981764251106,36.54298873274222,0.07912588937574894,1863.227216243744,227.92387676239014,1450.4193964004517,11616,2853,8763,8763,0,31,2849000.0
2849,2849999,20.32610011759938,36.55042726564056,0.07919321882001751,1863.7074389457703,227.99222660064697,1451.5253534317017,11620,2855,8765,8765,0,31,2850000.0
2850,2850999,20.331166810293066,36.55965352775992,0.07930867856989932,1864.0665667057037,228.06011271476746,1453.104561805725,11624,2857,8767,8767,0,31,2851000.0
2851,2851999,20.333626351650288,36.56245331806676,0.07941255850980733,1864.6727974414825,228.13347506523132,1453.6582117080688,11626,2858,8768,8768,0,31,2852000.0
2852,2852999,20.333235211912818,36.56073703146967,0.07937064850690878,1864.849194765091,228.21099162101746,1456.8298654556274,11668,2858,8810,8810,0,31,2853000.0
2853,2853999,20.3311958771599,36.557798600369644,0.07936411470137972,1865.2268569469452,228.2773265838623,1458.6814661026,11674,2858,8816,8816,0,31,2854000.0
2854,2854999,20.32880738275188,36.55341883675394,0.07936946399130174,1865.5864448547363,228.34438371658325,1460.417260169983,11677,2859,8818,8818,0,31,2855000.0
2855,2855999,20.32811644752824,36.556552231217594,0.07933855170760018,1865.8471252918243,228.4115493297577,1462.6105966567993,11679,2860,8819,8819,0,31,2856000.0
2856,2856999,20.326368535197837,36.55324841292948,0.07933154705961132,1866.2431349754333,228.4797501564026,1464.4724206924438,11680,2860,8820,8820,0,31,2857000.0
2857,2857999,20.32495894405778,36.55043445621735,0.07932376073293113,1866.819097995758,228.54712319374084,1465.0856866836548,11684,2862,8822,8822,0,31,2858000.0
2858,2858999,20.323195261994734,36.546609543015855,0.07931744296453724,1867.3466608524323,228.61522269248962,1465.5726480484009,11692,2866,8826,8826,0,31,2859000.0
2859,2859999,20.321859481294553,36.54441599591782,0.07931680828309662,1868.3426506519318,228.68596863746643,1464.1694345474243,11698,2869,8829,8829,0,31,2860000.0
2860,2860999,20.321150542287416,36.54329915085886,0.07930353562777581,1868.8042044639587,228.75606751441956,1465.3899927139282,11724,2871,8853,8853,0,31,2861000.0
2861,2861999,20.320354135136345,36.541121359613726,0.07929094259685565,1869.1966569423676,228.82350707054138,1467.0651788711548,11726,2872,8854,8854,0,31,2862000.0
2862,2862999,20.31934083383068,36.539014995111245,0.07927923018557625,1869.620236158371,228.8923659324646,1468.6791009902954,11729,2873,8856,8856,0,31,2863000.0
2863,2863999,20.318938566617653,36.538485641651384,0.07926215203856746,1870.0164561271667,228.9593403339386,1470.4278116226196,11731,2874,8857,8857,0,31,2864000.0
2864,2864999,20.318485856779553,36.53660361963853,0.0792577961196459,1871.2876315116882,229.0300965309143,1467.7283868789673,11737,2877,8860,8860,0,31,2865000.0
2865,2865999,20.318268728371876,36.53598764531082,0.07924691631651837,1871.8556771278381,229.0989227294922,1467.8427286148071,11745,2881,8864,8864,0,31,2866000.0
2866,2866999,20.318440378408557,36.53496385269489,0.07924484864007042,1872.2381994724274,229.16736578941345,1469.5005197525024,11747,2882,8865,8865,0,31,2867000.0
2867,2867999,20.318553680624127,36.53524871133323,0.079231453416169,1872.8385932445526,229.23687171936035,1469.8578805923462,11751,2884,8867,8867,0,31,2868000.0
2868,2868999,20.31875862821357,36.534205624864384,0.07922753525896797,1873.6494419574738,229.30569648742676,1469.5826120376587,11754,2885,8869,8869,0,31,2869000.0
2869,2869999,20.31908402930875,36.53355058585326,0.07922465321715355,1874.3668813705444,229.37492179870605,1469.9093942642212,11755,2885,8870,8870,0,31,2870000.0
2870,2870999,20.31899722206986,36.53170765102255,0.07922752370239916,1875.1804976463318,229.44586658477783,1469.4577341079712,11758,2886,8872,8872,0,31,2871000.0
2871,2871999,20.31886072472935,36.52981278308006,0.07923010169998312,1875.6926882266998,229.51419305801392,1470.7158823013306,11758,2886,8872,8872,0,31,2872000.0
2872,2872999,20.31806704983436,36.52685956582292,0.07923054785187111,1876.3055675029755,229.58269953727722,1471.10293674469,11760,2887,8873,8873,0,31,2873000.0
2873,2873999,20.315780663180945,36.522648350666095,0.07923277599790057,1876.5754652023315,229.65310502052307,1473.6873331069946,11797,2887,8910,8910,0,31,2874000.0
2874,2874999,20.312579912613177,36.5183136300025,0.07925166349888946,1876.9509072303772,229.72736716270447,1475.5370416641235,11808,2888,8920,8920,0,31,2875000.0
2875,2875999,20.309948593941808,36.51592908683608,0.0792579137553151,1877.3430721759796,229.79431629180908,1477.3033533096313,11810,2888,8922,8922,0,31,2876000.0
2876,2876999,20.307394343048536,36.512267886673335,0.07926816885541976,1877.7368214130402,229.8643717765808,1478.9915628433228,11814,2889,8925,8925,0,31,2877000.0
2877,2877999,20.30459592875229,36.50778410731602,0.07928403018590424,1878.0308275222778,229.93100214004517,1481.2712335586548,11815,2889,8926,8926,0,31,2878000.0
2878,2878999,20.302106259817258,36.50434998371853,0.0792885956111653,1878.7902216911316,229.99916815757751,1481.3997964859009,11817,2890,8927,8927,0,31,2879000.0
2879,2879999,20.299736101920665,36.500411951437805,0.07929490857985255,1879.172417640686,230.06717324256897,1483.3361825942993,11817,2890,8927,8927,0,31,2880000.0
2880,2880999,20.2977285897075,36.497231493134535,0.0792955763352381,1879.664229631424,230.13451433181763,1484.4305276870728,11819,2891,8928,8928,0,31,2881000.0
2881,2881999,20.296070648046936,36.49446727473846,0.07928530833526404,1880.035382270813,230.20138335227966,1486.2034158706665,11821,2892,8929,8929,0,31,2882000.0
2882,2882999,20.29519211792986,36.493168444660704,0.07926099414675247,1880.4908845424652,230.26895570755005,1487.1636972427368,11827,2895,8932,8932,0,31,2883000.0
2883,2883999,20.294990794767017,36.49210064101396,0.079226848930679,1881.1928822994232,230.33807516098022,1487.732087135315,11829,2896,8933,8933,0,31,2884000.0
2884,2884999,20.295409550143138,36.49312094900989,0.07917522911425612,1882.036005973816,230.40798544883728,1487.6131448745728,11829,2896,8933,8933,0,31,2885000.0
2885,2885999,20.29597709378745,36.492943526199795,0.0791412141540655,1882.536924123764,230.47719740867615,1488.152123451233,11835,2899,8936,8936,0,31,2886000.0
2886,2886999,20.297195966877503,36.49420116738057,0.07910366566809734,1883.2949497699738,230.5438163280487,1488.2846612930298,11835,2899,8936,8936,0,31,2887000.0
2887,2887999,20.298595562665273,36.49498658407429,0.07907865028944072,1883.7865166664124,230.60892391204834,1489.4194421768188,11836,2899,8937,8937,0,31,2888000.0
2888,2888999,20.299561615309678,36.49476126000032,0.07905978899040145,1884.349208831787,230.67348313331604,1490.4602670669556,11837,2899,8938,8938,0,31,2889000.0
2889,2889999,20.300071174969293,36.493668430787594,0.07903879426633031,1884.73956823349,230.73856830596924,1491.562268257141,11843,2901,8942,8942,0,31,2890000.0
2890,2890999,20.29954123646552,36.49099265778314,0.07904043790328374,1885.2287249565125,230.80474257469177,1492.2882890701294,11847,2903,8944,8944,0,31,2891000.0
2891,2891999,20.298482100684886,36.49380204597927,0.07894883100194783,1885.4822249412537,230.87353134155273,1494.9657106399536,11888,2903,8985,8985,0,31,2892000.0
2892,2892999,20.29613394385142,36.491029712341835,0.07895816332539574,1885.8575766086578,230.93742609024048,1496.5851259231567,11897,2904,8993,8993,0,31,2893000.0
2893,2893999,20.293643486648634,36.486623418302315,0.07898868758012878,1886.0409202575684,231.00313353538513,1499.3621644973755,11899,2904,8995,8995,0,31,2894000.0
2894,2894999,20.292398871512432,36.48499946332099,0.07899698165540137,1886.509469985962,231.067054271698,1500.562382698059,11903,2905,8998,8998,0,31,2895000.0
2895,2895999,20.290454918424455,36.48191728765991,0.07900915482492676,1887.055097579956,231.13156533241272,1501.467007637024,11905,2906,8999,8999,0,31,2896000.0
2896,2896999,20.288518594317473,36.478665103356185,0.07901956096276508,1887.4142007827759,231.19909524917603,1503.0427751541138,11909,2908,9001,9001,0,31,2897000.0
2897,2897999,20.28622503911015,36.474632773626304,0.07903910306955109,1888.3194301128387,231.26532673835754,1501.6797380447388,11917,2912,9005,9005,0,31,2898000.0
2898,2898999,20.284206563690375,36.47120852561236,0.07905093506356975,1888.7195975780487,231.33175778388977,1503.368863105774,11917,2912,9005,9005,0,31,2899000.0
2899,2899999,20.282508361596495,36.46866480540327,0.07904971161816476,1889.0059638023376,231.3980712890625,1505.5206880569458,11919,2913,9006,9006,0,31,2900000.0
2900,2900999,20.28124609357657,36.46671064221692,0.07904522157830052,1889.8786401748657,231.46318864822388,1504.512532234192,11923,2915,9008,9008,0,31,2901000.0
2901,2901999,20.279793955424335,36.464004896985266,0.07904447725342267,1890.6451132297516,231.5288245677948,1504.1173524856567,11927,2917,9010,9010,0,31,2902000.0
2902,2902999,20.27881980659528,36.46214068278029,0.07903928605233734,1891.3465220928192,231.5961902141571,1504.5239305496216,11927,2917,9010,9010,0,31,2903000.0
2903,2903999,20.27818448187425,36.46367438528685,0.07902146380507269,1891.9384806156158,231.6632034778595,1505.0617265701294,11933,2918,9015,9015,0,31,2904000.0
2904,2904999,20.277731230777693,36.461973834268385,0.07901329136529278,1892.3251450061798,231.72778129577637,1506.9839906692505,11935,2918,9017,9017,0,31,2905000.0
2905,2905999,20.2776149413491,36.46107776841806,0.07899696193769412,1893.1847653388977,231.79647588729858,1506.3378419876099,11937,2919,9018,9018,0,31,2906000.0
2906,2906999,20.277612311783653,36.46081663686277,0.0789755094461857,1893.5393187999725,231.86380887031555,1507.9252061843872,11941,2921,9020,9020,0,31,2907000.0
2907,2907999,20.276613655165278,36.46072380727212,0.07895477652852023,1894.1115596294403,231.92855095863342,1508.3756303787231,11945,2923,9022,9022,0,31,2908000.0
2908,2908999,20.27379114469928,36.456154200092534,0.0789806685893244,1894.372708082199,231.99623799324036,1510.9761400222778,11979,2923,9056,9056,0,31,2909000.0
2909,2909999,20.27114475263024,36.45363236835024,0.07900275118722777,1894.6429698467255,232.0600233078003,1513.3073015213013,11984,2923,9061,9061,0,31,2910000.0
2910,2910999,20.268522672554415,36.450394689341124,0.079040074746345,1895.210102558136,232.12532949447632,1514.2135133743286,11985,2923,9062,9062,0,31,2911000.0
2911,2911999,20.265958620433505,36.44744981842158,0.07906917773638245,1895.5422830581665,232.18858528137207,1515.8564805984497,11991,2925,9066,9066,0,31,2912000.0
2912,2912999,20.26289764648657,36.44332116935646,0.07910925546734471,1895.9874892234802,232.25333523750305,1517.0050020217896,11995,2927,9068,9068,0,31,2913000.0
2913,2913999,20.26010398130693,36.43953974881463,0.07913159405923265,1896.5333108901978,232.3205897808075,1518.3686418533325,11995,2927,9068,9068,0,31,2914000.0
2914,2914999,20.25753480478778,36.435964775172806,0.07914988530071942,1897.2008061408997,232.3845193386078,1518.5022325515747,11999,2928,9071,9071,0,31,2915000.0
2915,2915999,20.256065694532086,36.4360078565729,0.07913419107910635,1897.9186923503876,232.4506323337555,1518.464108467102,12001,2929,9072,9072,0,31,2916000.0
2916,2916999,20.255198572685295,36.43673362878364,0.07910780580586407,1898.6916370391846,232.51623439788818,1518.2110872268677,12028,2930,9098,9098,0,31,2917000.0
2917,2917999,20.254388000176636,36.43779764927499,0.07908169401419851,1899.1730070114136,232.58490920066833,1519.1991624832153,12033,2932,9101,9101,0,31,2918000.0
2918,2918999,20.25431647847648,36.43896162005625,0.07907794934633305,1899.8769540786743,232.65360617637634,1518.8779802322388,12061,2935,9126,9126,0,31,2919000.0
2919,2919999,20.253647377474355,36.4385823893665,0.07907720433577414,1900.6078989505768,232.72079825401306,1518.4509782791138,12072,2939,9133,9133,0,31,2920000.0
2920,2920999,20.25344173499283,36.4388673110294,0.07907385444039006,1901.3551037311554,232.78647565841675,1517.621350288391,12080,2943,9137,9137,0,31,2921000.0
2921,2921999,20.2529125702768,36.43812386909998,0.0790707405761436,1901.7515540122986,232.851087808609,1519.3042192459106,12080,2943,9137,9137,0,31,2922000.0
2922,2922999,20.252918752182275,36.4379589905137,0.07904630605679464,1902.3217990398407,232.9196057319641,1520.1345109939575,12083,2944,9139,9139,0,31,2923000.0
2923,2923999,20.252907291138733,36.4400315957344,0.07903711612939757,1902.7196452617645,232.98357224464417,1521.7865953445435,12084,2944,9140,9140,0,31,2924000.0
2924,2924999,20.253324632723803,36.439815237105535,0.07902603818809129,1903.393904209137,233.0501844882965,1521.9097032546997,12088,2946,9142,9142,0,31,2925000.0
2925,2925999,20.252389992351496,36.437010709542875,0.0790238839758205,1903.9811534881592,233.11643290519714,1522.4591035842896,12090,2947,9143,9143,0,31,2926000.0
2926,2926999,20.251512783554176,36.434607795449914,0.07902527247893909,1904.8815596103668,233.1829595565796,1521.7002229690552,12090,2947,9143,9143,0,31,2927000.0
2927,2927999,20.249487969142173,36.43101443419768,0.07902788712470188,1905.2428336143494,233.24606370925903,1523.340413093567,12108,2948,9160,9160,0,31,2928000.0
2928,2928999,20.246951646474717,36.4272182687761,0.07902876652266722,1905.4939320087433,233.3125340938568,1525.9991731643677,12142,2948,9194,9194,0,31,2929000.0
2929,2929999,20.243683444349582,36.423055040322986,0.07904372023776085,1905.7641015052795,233.37635898590088,1528.332859992981,12146,2948,9198,9198,0,31,2930000.0
2930,2930999,20.24049561111647,36.418314309666506,0.07905863707215133,1906.0212059020996,233.44230127334595,1530.5934038162231,12151,2949,9202,9202,0,31,2931000.0
2931,2931999,20.237539253662817,36.41437750475916,0.07907649847776177,1906.3844196796417,233.50676441192627,1532.2890520095825,12154,2950,9204,9204,0,31,2932000.0
2932,2932999,20.234843706516127,36.41008545981523,0.07908477608016451,1906.807458639145,233.5715913772583,1533.8308610916138,12156,2951,9205,9205,0,31,2933000.0
2933,2933999,20.23236625494915,36.40586626716953,0.07909456081106758,1907.4005379676819,233.6375584602356,1533.7836122512817,12166,2956,9210,9210,0,31,2934000.0
2934,2934999,20.230126202192107,36.40242433110509,0.0790937422965855,1908.0346167087555,233.70367193222046,1533.8998537063599,12172,2959,9213,9213,0,31,2935000.0
2935,2935999,20.227651629047905,36.39826091064791,0.07910158401070233,1908.5578083992004,233.77008295059204,1534.4165544509888,12178,2962,9216,9216,0,31,2936000.0
2936,2936999,20.22568744437796,36.395544600503165,0.07909507948562888,1909.1770119667053,233.83508586883545,1534.814778327942,12180,2963,9217,9217,0,31,2937000.0
2937,2937999,20.22439623663455,36.395194113311845,0.07907922500002662,1909.5748553276062,233.90221571922302,1536.6246767044067,12180,2963,9217,9217,0,31,2938000.0
2938,2938999,20.2244785154067,36.39758640821033,0.07904977604244234,1909.9487030506134,233.96586418151855,1538.2422761917114,12182,2964,9218,9218,0,31,2939000.0
2939,2939999,20.224772527762095,36.40726670069139,0.07900919353664171,1910.5997178554535,234.03124046325684,1538.2910585403442,12186,2966,9220,9220,0,31,2940000.0
2940,2940999,20.225814355285305,36.41308609526242,0.07899146984461802,1919.6691629886627,234.09814167022705,1537.0490007400513,12192,2969,9223,9223,0,31,2941000.0
2941,2941999,20.226623186345815,36.416313261110005,0.07900506264376006,1920.4612245559692,234.1646478176117,1536.2214632034302,12200,2973,9227,9227,0,31,2942000.0
2942,2942999,20.22656342781402,36.41672431322545,0.07902179393000652,1921.0027112960815,234.2293517589569,1537.1510820388794,12202,2974,9228,9228,0,31,2943000.0
2943,2943999,20.227431259970988,36.41854970208795,0.07903416636409011,1921.3663449287415,234.29527807235718,1538.8040285110474,12205,2975,9230,9230,0,31,2944000.0
2944,2944999,20.227603102304098,36.419129872342175,0.07902789564986001,1921.9420194625854,234.36342406272888,1539.531132698059,12208,2976,9232,9232,0,31,2945000.0
2945,2945999,20.228685779764763,36.4216905200612,0.07905252790238393,1922.7141349315643,234.4293909072876,1539.5676927566528,12208,2976,9232,9232,0,31,2946000.0
2946,2946999,20.228217565348736,36.420644962663054,0.07907349706242794,1923.412228345871,234.49750542640686,1539.628270149231,12210,2977,9233,9233,0,31,2947000.0
2947,2947999,20.227684552293947,36.419572698710084,0.07908534085069063,1924.236697435379,234.56459784507751,1539.194348335266,12210,2977,9233,9233,0,31,2948000.0
2948,2948999,20.22700343685218,36.421800993586984,0.07907380421202814,1924.713474035263,234.63253211975098,1540.4714784622192,12241,2978,9263,9263,0,31,2949000.0
2949,2949999,20.224922520304748,36.4211102014576,0.07906011125440005,1924.968490600586,234.69683623313904,1542.8929643630981,12253,2978,9275,9275,0,31,2950000.0
2950,2950999,20.222949007042473,36.420121804752924,0.07904678600940584,1925.4460926055908,234.76190066337585,1544.148518562317,12254,2978,9276,9276,0,31,2951000.0
2951,2951999,20.22142753213442,36.419113926690706,0.07905841918493639,1925.8179881572723,234.826247215271,1545.996922492981,12256,2978,9278,9278,0,31,2952000.0
2952,2952999,20.2208751467482,36.42047568438006,0.07906050506829176,1926.0834918022156,234.89154934883118,1548.3896532058716,12257,2978,9279,9279,0,31,2953000.0
2953,2953999,20.22143466586367,36.42223737634284,0.07912981165870692,1926.8005509376526,234.95623517036438,1547.7679719924927,12265,2982,9283,9283,0,31,2954000.0
2954,2954999,20.22079561695482,36.42155219060446,0.07920443502254992,1927.1495833396912,235.02031660079956,1549.4026079177856,12269,2984,9285,9285,0,31,2955000.0
2955,2955999,20.220209728429747,36.420738807393676,0.07927300094417955,1927.6271679401398,235.08654236793518,1550.2892808914185,12273,2986,9287,9287,0,31,2956000.0
2956,2956999,20.219972436312272,36.42618357356116,0.07929836807849922,1928.1592540740967,235.15218138694763,1550.9712419509888,12279,2989,9290,9290,0,31,2957000.0
2957,2957999,20.219187098083157,36.42458243343338,0.07936847633453836,1928.7357664108276,235.2173628807068,1551.5776109695435,12281,2990,9291,9291,0,31,2958000.0
2958,2958999,20.21875294459909,36.42335957505191,0.0794205461333286,1929.2348339557648,235.2823896408081,1552.6944932937622,12281,2990,9291,9291,0,31,2959000.0
2959,2959999,20.218306284097284,36.421631177537506,0.07942731216381949,1929.9868535995483,235.34783673286438,1552.1850786209106,12285,2992,9293,9293,0,31,2960000.0
2960,2960999,20.218304252181586,36.421240686640076,0.07946021511771872,1930.787317276001,235.41536688804626,1551.7087984085083,12291,2995,9296,9296,0,31,2961000.0
2961,2961999,20.218784877961337,36.42454224624255,0.07949177711560662,1931.0626044273376,235.4815435409546,1553.8294878005981,12293,2996,9297,9297,0,31,2962000.0
2962,2962999,20.219204784481143,36.42407322866779,0.0795307962814139,1931.5618753433228,235.54605793952942,1554.9383363723755,12293,2996,9297,9297,0,31,2963000.0
2963,2963999,20.22033545929903,36.42511351667242,0.0795874024578922,1932.591341495514,235.6121003627777,1552.6799669265747,12301,3000,9301,9301,0,31,2964000.0
2964,2964999,20.2213429258336,36.42560494247484,0.07964636527046043,1932.982964515686,235.67829012870789,1554.351689338684,12303,3000,9303,9303,0,31,2965000.0
2965,2965999,20.22288813568642,36.42660475638004,0.07971793523565107,1933.466879606247,235.74561619758606,1555.474102973938,12305,3001,9304,9304,0,31,2966000.0
2966,2966999,20.224124336042493,36.42646353360765,0.07976695830093194,1934.1445007324219,235.81093502044678,1555.5419130325317,12307,3002,9305,9305,0,31,2967000.0
2967,2967999,20.2245747852539,36.42471426392476,0.07981646630798678,1934.6171231269836,235.8765881061554,1556.6235551834106,12309,3003,9306,9306,0,31,2968000.0
2968,2968999,20.22410172264828,36.422449073891066,0.0798386350405006,1935.2129640579224,235.9421510696411,1557.2240343093872,12309,3003,9306,9306,0,31,2969000.0
2969,2969999,20.22165257188725,36.418210025367664,0.07984641903910528,1935.4638676643372,236.00754141807556,1559.9313554763794,12352,3003,9349,9349,0,31,2970000.0
2970,2970999,20.219006192143716,36.41541103067378,0.0798476116037854,1935.6216032505035,236.07073593139648,1562.8082780838013,12355,3003,9352,9352,0,31,2971000.0
2971,2971999,20.216418856946024,36.412059385057155,0.0798604113590452,1935.9678139686584,236.13293886184692,1564.5678453445435,12359,3004,9355,9355,0,31,2972000.0
2972,2972999,20.214252448496254,36.41131496912074,0.07985202831255944,1936.1563198566437,236.20003819465637,1567.340703010559,12359,3004,9355,9355,0,31,2973000.0
2973,2973999,20.211758602290484,36.408211925477765,0.07985526684681554,1936.5692529678345,236.26381301879883,1568.4586687088013,12366,3007,9359,9359,0,31,2974000.0
2974,2974999,20.20951233823137,36.41093556343099,0.07983640478990772,1936.920119047165,236.32773542404175,1570.1541414260864,12370,3009,9361,9361,0,31,2975000.0
2975,2975999,20.20695029121717,36.40704971412451,0.07984648193282684,1937.6129462718964,236.39376282691956,1570.2574968338013,12372,3010,9362,9362,0,31,2976000.0
2976,2976999,20.204418481491675,36.40297725933824,0.07985538947457349,1938.2309918403625,236.4586465358734,1570.5834703445435,12376,3012,9364,9364,0,31,2977000.0
2977,2977999,20.202149400593463,36.39921176307864,0.07985951987408868,1938.662255525589,236.52663660049438,1571.6256380081177,12382,3015,9367,9367,0,31,2978000.0
2978,2978999,20.200534308852482,36.39683336514232,0.07984559077155151,1938.9622428417206,236.5909571647644,1573.8150987625122,12382,3015,9367,9367,0,31,2979000.0
2979,2979999,20.19917772352375,36.39484469633193,0.07982835493754348,1939.4392561912537,236.65601134300232,1574.9098405838013,12384,3016,9368,9368,0,31,2980000.0
2980,2980999,20.198565730932657,36.39410357046424,0.07980380369911066,1940.322636127472,236.7235186100006,1573.926594734192,12388,3018,9370,9370,0,31,2981000.0
2981,2981999,20.19838882414528,36.394296266930425,0.07976715285933533,1941.0659394264221,236.7904782295227,1573.6373262405396,12392,3020,9372,9372,0,31,2982000.0
2982,2982999,20.198789332657807,36.39514738657268,0.07973003451326899,1941.8164808750153,236.85714507102966,1573.263653755188,12396,3022,9374,9374,0,31,2983000.0
2983,2983999,20.199335902652553,36.395532988003914,0.07969400664626236,1942.2655520439148,236.92120575904846,1574.1687288284302,12400,3024,9376,9376,0,31,2984000.0
2984,2984999,20.200609425250622,36.39709031002854,0.07965627429373179,1942.553492307663,236.9842927455902,1576.3430910110474,12400,3024,9376,9376,0,31,2985000.0
2985,2985999,20.20298224734313,36.40054737547336,0.07961211758950149,1943.3182454109192,237.05134177207947,1576.190281867981,12404,3025,9379,9379,0,31,2986000.0
2986,2986999,20.204532335014648,36.40210959510873,0.07959513571578947,1943.93958902359,237.11667037010193,1576.7641344070435,12404,3025,9379,9379,0,31,2987000.0
2987,2987999,20.207173020142708,36.40530143658921,0.07956522952992806,1944.3172671794891,237.18164110183716,1578.5914125442505,12404,3025,9379,9379,0,31,2988000.0
2988,2988999,20.210410509705543,36.4114610536917,0.07954664989379823,1944.9837365150452,237.24700379371643,1578.7926988601685,12406,3026,9380,9380,0,31,2989000.0
2989,2989999,20.21168731886435,36.41473234187821,0.07952813678494719,1945.5885710716248,237.3110270500183,1579.3862047195435,12406,3026,9380,9380,0,31,2990000.0
2990,2990999,20.20998966357237,36.41437786774907,0.0795114878178077,1946.0316467285156,237.38333940505981,1580.7496309280396,12425,3027,9398,9398,0,31,2991000.0
2991,2991999,20.20803692217576,36.41380987927856,0.07950408570872913,1946.5802733898163,237.4445834159851,1581.4042177200317,12430,3028,9402,9402,0,31,2992000.0
2992,2992999,20.205479358778852,36.409580067656215,0.07951216499927838,1947.137392282486,237.50690722465515,1582.062870979309,12435,3029,9406,9406,0,31,2993000.0
2993,2993999,20.203287433814356,36.406831032022055,0.0795090960461019,1947.5188310146332,237.56820845603943,1583.708722114563,12435,3029,9406,9406,0,31,2994000.0
2994,2994999,20.201438327454703,36.40460797578639,0.07949575795649111,1948.1871573925018,237.6313977241516,1583.8312501907349,12438,3030,9408,9408,0,31,2995000.0
2995,2995999,20.199369539378168,36.400767338047395,0.07949686577838233,1948.8426666259766,237.69313836097717,1583.9745683670044,12440,3031,9409,9409,0,31,2996000.0
2996,2996999,20.19794607059704,36.39817704271046,0.07948394739405162,1949.3993484973907,237.7544960975647,1584.5299348831177,12443,3032,9411,9411,0,31,2997000.0
2997,2997999,20.196343943008976,36.394960720189125,0.07947668389781914,1950.043212890625,237.8196861743927,1584.6413164138794,12445,3034,9411,9411,0,31,2998000.0
2998,2998999,20.194675695837528,36.39181743171809,0.07947108978572481,1950.4147539138794,237.87993383407593,1586.273190498352,12445,3034,9411,9411,0,31,2999000.0
2999,2999999,20.193755406364726,36.38966023081925,0.07945328231142057,1951.3066403865814,237.94153547286987,1585.347882270813,12445,3034,9411,9411,0,31,3000000.0
3000,3000999,20.193239671152774,36.38823176678028,0.0794297816354671,1951.772323846817,238.00273323059082,1586.3283281326294,12448,3035,9413,9413,0,31,3001000.0
3001,3001999,20.192381662185458,36.385659261173195,0.07942710779402706,1952.3438320159912,238.06503438949585,1586.8325242996216,12450,3036,9414,9414,0,31,3002000.0
3002,3002999,20.192242076830038,36.38551535434463,0.07940557903759016,1953.115817308426,238.12886118888855,1586.3710298538208,12452,3037,9415,9415,0,31,3003000.0
3003,3003999,20.193382195945716,36.38824544192557,0.07938156415464526,1953.7472631931305,238.19514393806458,1586.9391603469849,12452,3037,9415,9415,0,31,3004000.0
3004,3004999,20.196304132656547,36.39460346412923,0.07934993757012976,1954.327052116394,238.2604537010193,1587.426968574524,12453,3038,9415,9415,0,31,3005000.0
3005,3005999,20.200485230711436,36.40489042649758,0.07934596110589909,1955.015237569809,238.32481408119202,1587.299771308899,12455,3039,9416,9416,0,31,3006000.0
3006,3006999,20.20546781347232,36.41409697857288,0.07937016965349375,1955.6089115142822,238.3901150226593,1588.0080461502075,12455,3039,9416,9416,0,31,3007000.0
3007,3007999,20.211962296361474,36.42710412971053,0.07939905772304412,1956.3014657497406,238.45788168907166,1588.1057634353638,12455,3039,9416,9416,0,31,3008000.0
3008,3008999,20.219420337726973,36.44339208534489,0.07944736345255887,1956.9813516139984,238.52170944213867,1588.1002626419067,12456,3040,9416,9416,0,31,3009000.0
3009,3009999,20.226628239946685,36.453970996540114,0.07953484880107631,1957.6873903274536,238.58832120895386,1588.375241279602,12456,3040,9416,9416,0,31,3010000.0
3010,3010999,20.230998218018012,36.4590882612812,0.07955190963854597,1958.0751957893372,238.65139150619507,1589.9581270217896,12456,3040,9416,9416,0,31,3011000.0
3011,3011999,20.232807627934335,36.46389183481913,0.07940897131855906,1958.6383345127106,238.71883511543274,1590.6249589920044,12471,3041,9430,9430,0,31,3012000.0
3012,3012999,20.231782540665147,36.46355479510863,0.07937081419751679,1959.1101412773132,238.78289198875427,1591.834942817688,12474,3041,9433,9433,0,31,3013000.0
3013,3013999,20.230773771032837,36.46162112114059,0.07935679971039589,1959.4950132369995,238.84632515907288,1593.459210395813,12474,3041,9433,9433,0,31,3014000.0
3014,3014999,20.22928844542667,36.45969986733828,0.07934404675063822,1960.0658152103424,238.9098699092865,1594.025959968567,12476,3042,9434,9434,0,31,3015000.0
3015,3015999,20.228276329884583,36.45889186447312,0.07932307475734424,1960.8061072826385,238.9771978855133,1593.542576789856,12494,3045,9449,9449,0,31,3016000.0
3016,3016999,20.22670707700135,36.456460792727434,0.07930575666812378,1961.6964838504791,239.04389667510986,1592.8676652908325,12494,3045,9449,9449,0,31,3017000.0
3017,3017999,20.22549529201731,36.45375284405045,0.07928931137623763,1962.0931131839752,239.1080276966095,1594.4698915481567,12494,3045,9449,9449,0,31,3018000.0
3018,3018999,20.22411400589558,36.45095125571982,0.07928566895318956,1962.6579985618591,239.173846244812,1594.914059638977,12497,3047,9450,9450,0,31,3019000.0
3019,3019999,20.22253501904897,36.44771598972462,0.07928454387814321,1963.123239517212,239.24114513397217,1596.211064338684,12513,3048,9465,9465,0,31,3020000.0
3020,3020999,20.221440340071712,36.445010626933666,0.07927466366199909,1963.7738618850708,239.30722618103027,1596.6686067581177,12513,3048,9465,9465,0,31,3021000.0
3021,3021999,20.220595298238695,36.442884636133044,0.0792771360104243,1964.1676223278046,239.37356853485107,1598.3528184890747,12513,3048,9465,9465,0,31,3022000.0
3022,3022999,20.220797853956487,36.44291795564944,0.07925746954609347,1964.8668015003204,239.44135785102844,1598.5224504470825,12513,3048,9465,9465,0,31,3023000.0
3023,3023999,20.221963309879634,36.443935792073525,0.07922993062220562,1965.265368938446,239.5059826374054,1599.799542427063,12515,3049,9466,9466,0,31,3024000.0
3024,3024999,20.222378486401468,36.44300825818143,0.079221840580468,1966.3131852149963,239.57224798202515,1597.9856004714966,12519,3051,9468,9468,0,31,3025000.0
3025,3025999,20.223291398903648,36.44620344210712,0.07918891444593978,1966.9344539642334,239.6413929462433,1598.5803728103638,12519,3051,9468,9468,0,31,3026000.0
3026,3026999,20.22372442213326,36.445114913665996,0.07920670210462921,1967.3208639621735,239.70966601371765,1600.1931047439575,12519,3051,9468,9468,0,31,3027000.0
3027,3027999,20.2232382412929,36.442528097378066,0.07920478777629969,1967.821313381195,239.7762553691864,1601.4215822219849,12520,3051,9469,9469,0,31,3028000.0
3028,3028999,20.222187381452898,36.43941279770487,0.07919156450786757,1968.8294637203217,239.843088388443,1600.0530519485474,12530,3051,9479,9479,0,31,3029000.0
3029,3029999,20.221266074311764,36.441427993699456,0.07916638233978013,1969.2184948921204,239.91428899765015,1601.8866319656372,12548,3052,9496,9496,0,31,3030000.0
3030,3030999,20.220089691857048,36.43984603836393,0.07916243375549514,1969.6791350841522,239.97957158088684,1603.3283433914185,12551,3052,9499,9499,0,31,3031000.0
3031,3031999,20.219866819479936,36.44012502671474,0.07916386945925835,1969.9746599197388,240.04522323608398,1605.5494966506958,12552,3052,9500,9500,0,31,3032000.0
3032,3032999,20.22001160238565,36.43997846613599,0.0791763219084185,1970.4999039173126,240.10993027687073,1606.1670274734497,12558,3055,9503,9503,0,31,3033000.0
3033,3033999,20.219762816362064,36.438850935174116,0.07921995688545413,1971.019000530243,240.19046330451965,1607.2961473464966,12562,3057,9505,9505,0,31,3034000.0
3034,3034999,20.219387942484637,36.437936633570466,0.07924646937782964,1971.4570541381836,240.25542402267456,1608.6480379104614,12566,3059,9507,9507,0,31,3035000.0
3035,3035999,20.21973558898912,36.43746014937695,0.07929334736955829,1971.9407494068146,240.3212287425995,1609.7492952346802,12569,3060,9509,9509,0,31,3036000.0
3036,3036999,20.21990078491904,36.43647743631027,0.07932443389553934,1972.6245203018188,240.38894486427307,1609.8607149124146,12571,3061,9510,9510,0,31,3037000.0
3037,3037999,20.22066267508427,36.437590197847115,0.07937682612123631,1973.3217437267303,240.45460033416748,1609.9951372146606,12571,3061,9510,9510,0,31,3038000.0
3038,3038999,20.222355187527338,36.44284286602304,0.07943663554797531,1974.0848062038422,240.5282289981842,1609.6618242263794,12590,3064,9526,9526,0,31,3039000.0
3039,3039999,20.2241612299841,36.44545690428472,0.07953605176487,1974.4889516830444,240.59494805335999,1611.326771736145,12590,3064,9526,9526,0,31,3040000.0
3040,3040999,20.225798381422262,36.446941178195274,0.07960963596061621,1975.0846827030182,240.66197204589844,1611.9014024734497,12592,3065,9527,9527,0,31,3041000.0
3041,3041999,20.22861962671957,36.45279213111989,0.07969013023508154,1975.7832899093628,240.73097801208496,1611.915005683899,12607,3067,9540,9540,0,31,3042000.0
3042,3042999,20.232570516938175,36.46669109587905,0.07976836007036281,1976.48854804039,240.79777598381042,1612.0844240188599,12607,3067,9540,9540,0,31,3043000.0
3043,3043999,20.236410633314364,36.47442361389546,0.07985732958993708,1976.8699629306793,240.86299800872803,1613.8945970535278,12607,3067,9540,9540,0,31,3044000.0
3044,3044999,20.239802075749402,36.47855936263894,0.0799821064494215,1977.4361276626587,240.92882680892944,1614.960057258606,12607,3067,9540,9540,0,31,3045000.0
3045,3045999,20.243831588061937,36.48291600078847,0.08006624396841866,1978.631400346756,240.99553608894348,1612.8674364089966,12607,3067,9540,9540,0,31,3046000.0
3046,3046999,20.248103768844317,36.48801208911996,0.08016738570093807,1979.0371646881104,241.0637011528015,1614.4603548049927,12607,3067,9540,9540,0,31,3047000.0
3047,3047999,20.25162708054863,36.494265992686316,0.08024548492407557,1979.569311618805,241.13453435897827,1615.208378791809,12609,3068,9541,9541,0,31,3048000.0
3048,3048999,20.25143468325248,36.49285854571441,0.08025856455380254,1980.2309279441833,241.19991040229797,1615.474217414856,12622,3070,9552,9552,0,31,3049000.0
3049,3049999,20.249695581869005,36.49186785172737,0.08024226499714193,1980.7707962989807,241.26549649238586,1616.0387773513794,12631,3072,9559,9559,0,31,3050000.0
3050,3050999,20.248234667958883,36.49123977215429,0.08022128840626819,1981.2218294143677,241.3280954360962,1617.2033205032349,12637,3073,9564,9564,0,31,3051000.0
3051,3051999,20.246929216956964,36.48893351163922,0.0802140930067563,1981.6817605495453,241.39195847511292,1618.3783235549927,12639,3074,9565,9565,0,31,3052000.0
3052,3052999,20.245756408449317,36.48763736829081,0.08019875116016972,1982.1446814537048,241.45587372779846,1619.489270210266,12641,3075,9566,9566,0,31,3053000.0
3053,3053999,20.24449136466355,36.484949770622094,0.08019196807175188,1982.865760564804,241.52229499816895,1619.5683183670044,12643,3076,9567,9567,0,31,3054000.0
3054,3054999,20.243862301788315,36.4832879563744,0.08017653371649625,1983.6500210762024,241.58914613723755,1619.088749885559,12645,3077,9568,9568,0,31,3055000.0
3055,3055999,20.243382646082956,36.48126404953523,0.08016640696829513,1984.1286189556122,241.65369081497192,1620.0845232009888,12647,3078,9569,9569,0,31,3056000.0
3056,3056999,20.243141702697187,36.47983174523377,0.0801549496191708,1984.6062898635864,241.71950364112854,1621.1963548660278,12649,3079,9570,9570,0,31,3057000.0
3057,3057999,20.24336290089347,36.47904286582204,0.08015642389075206,1985.4157309532166,241.7861557006836,1620.834973335266,12664,3080,9584,9584,0,31,3058000.0
3058,3058999,20.244439654330108,36.47926221018607,0.08016194157095768,1985.9117579460144,241.85436034202576,1621.7002305984497,12668,3082,9586,9586,0,31,3059000.0
3059,3059999,20.247385809642868,36.4840211724874,0.08019311575693877,1986.3063361644745,241.92168307304382,1623.4053163528442,12668,3082,9586,9586,0,31,3060000.0
3060,3060999,20.249636530781927,36.48702799725079,0.08026045386376623,1986.8994512557983,241.9909267425537,1624.012219429016,12671,3083,9588,9588,0,31,3061000.0
3061,3061999,20.252096470451743,36.490374212658956,0.08034291065056254,1987.183232307434,242.05698800086975,1626.3309679031372,12671,3083,9588,9588,0,31,3062000.0
3062,3062999,20.255575927012988,36.499068648742444,0.08040437509672471,1987.945030450821,242.12494206428528,1625.8863801956177,12675,3085,9590,9590,0,31,3063000.0
3063,3063999,20.260492294690305,36.50895981742885,0.0805412109702821,1989.0244400501251,242.19211387634277,1623.598843574524,12681,3088,9593,9593,0,31,3064000.0
3064,3064999,20.26474561755892,36.51548500222559,0.08067260078285043,1989.52894449234,242.2607798576355,1624.7844972610474,12681,3088,9593,9593,0,31,3065000.0
3065,3065999,20.26814084083834,36.51936910283096,0.08082184725239727,1990.0885837078094,242.32915711402893,1625.348156929016,12685,3090,9595,9595,0,31,3066000.0
3066,3066999,20.271732696267417,36.52377442204286,0.0809366075000777,1990.591747045517,242.39597034454346,1626.5013933181763,12685,3090,9595,9595,0,31,3067000.0
3067,3067999,20.27518859161653,36.527312486892924,0.0810013125541329,1991.2113237380981,242.4623236656189,1627.087727546692,12686,3090,9596,9596,0,31,3068000.0
3068,3068999,20.276701571835382,36.52750131224085,0.08101564384461102,1991.9052076339722,242.5285472869873,1627.0425310134888,12690,3091,9599,9599,0,31,3069000.0
3069,3069999,20.275399852832496,36.52756670778803,0.08100193190069704,1992.565211057663,242.59549403190613,1627.2781953811646,12699,3092,9607,9607,0,31,3070000.0
3070,3070999,20.2737479741976,36.52613850714152,0.08098722549547588,1993.0272552967072,242.66287541389465,1628.5293169021606,12715,3093,9622,9622,0,31,3071000.0
3071,3071999,20.27215949658519,36.52383471818443,0.0809873910283615,1993.2911825180054,242.72964096069336,1631.0008974075317,12718,3093,9625,9625,0,31,3072000.0
3072,3072999,20.27098057757404,36.5234643687014,0.08096368231594442,1993.6513345241547,242.79516196250916,1632.6846055984497,12721,3094,9627,9627,0,31,3073000.0
3073,3073999,20.26933881355479,36.52000929766477,0.08095758960394539,1994.3765122890472,242.86204409599304,1632.8196306228638,12725,3096,9629,9629,0,31,3074000.0
3074,3074999,20.26806208571749,36.51921453032711,0.08094393725240889,1994.8690848350525,242.92915439605713,1634.008526802063,12725,3096,9629,9629,0,31,3075000.0
3075,3075999,20.266697173652343,36.51696940500082,0.08093825864594195,1995.3593645095825,242.99677395820618,1634.9203157424927,12727,3097,9630,9630,0,31,3076000.0
3076,3076999,20.265571001263478,36.51472779468186,0.08093348316686655,1995.8556199073792,243.0614902973175,1636.0457048416138,12727,3097,9630,9630,0,31,3077000.0
3077,3077999,20.264473617603556,36.512346290591694,0.0809338145532359,1996.661006450653,243.1272954940796,1635.5717363357544,12729,3098,9631,9631,0,31,3078000.0
3078,3078999,20.264190643013038,36.511962166213436,0.08091760079136878,1997.3651118278503,243.19223546981812,1635.6549348831177,12729,3098,9631,9631,0,31,3079000.0
3079,3079999,20.263937183585394,36.510985214052816,0.08091346405692168,1998.4320318698883,243.25990509986877,1633.6310472488403,12734,3100,9634,9634,0,31,3080000.0
3080,3080999,20.264055398745647,36.510675090045,0.08091088726028084,1998.833902835846,243.32534265518188,1635.2665147781372,12734,3100,9634,9634,0,31,3081000.0
3081,3081999,20.263994482693402,36.5094864940882,0.08089462655230362,1999.1339342594147,243.389830827713,1637.3809633255005,12734,3100,9634,9634,0,31,3082000.0
3082,3082999,20.26468270060135,36.51000012109853,0.08089568392614033,2000.1543366909027,243.45682787895203,1635.226788520813,12753,3103,9650,9650,0,31,3083000.0
3083,3083999,20.265092971302735,36.509840252201094,0.08089296320599804,2000.6388156414032,243.52503371238708,1636.4923295974731,12753,3103,9650,9650,0,31,3084000.0
3084,3084999,20.26531274891232,36.50861105455618,0.08090328001715774,2010.0289771556854,243.5934088230133,1636.0534257888794,12755,3104,9651,9651,0,31,3085000.0
3085,3085999,20.266142358643325,36.50850838113448,0.08090386544129213,2010.4302139282227,243.6604471206665,1637.693081855774,12755,3104,9651,9651,0,31,3086000.0
3086,3086999,20.266429174683225,36.507582099527504,0.08090743992142069,2011.1291480064392,243.72663617134094,1637.8615312576294,12755,3104,9651,9651,0,31,3087000.0
3087,3087999,20.266193807418652,36.50546245890812,0.08091212421433491,2011.8063910007477,243.79370164871216,1637.785901069641,12759,3106,9653,9653,0,31,3088000.0
3088,3088999,20.26601172564798,36.50334698049791,0.08090210507446371,2012.4040660858154,243.8600254058838,1638.354992866516,12759,3106,9653,9653,0,31,3089000.0
3089,3089999,20.264812269529514,36.49999919376916,0.08089539689743219,2012.7597572803497,243.92476296424866,1640.0729188919067,12770,3107,9663,9663,0,31,3090000.0
3090,3090999,20.26259381714118,36.496769727292666,0.08089375391165232,2013.3255922794342,243.98950123786926,1640.8734788894653,12773,3107,9666,9666,0,31,3091000.0
3091,3091999,20.26001141385264,36.49312816557642,0.08090547233376444,2013.8019020557404,244.05303263664246,1642.0420656204224,12775,3107,9668,9668,0,31,3092000.0
3092,3092999,20.2581715692745,36.49185096528409,0.08089573402588368,2014.2642757892609,244.11655139923096,1643.1353960037231,12777,3108,9669,9669,0,31,3093000.0
3093,3093999,20.25603651463945,36.488493571718585,0.08089328313568378,2014.7374708652496,244.18161606788635,1644.2219133377075,12779,3109,9670,9670,0,31,3094000.0
3094,3094999,20.253839614129753,36.48539965841976,0.08089281264728221,2015.65016913414,244.24756240844727,1643.2965211868286,12781,3110,9671,9671,0,31,3095000.0
3095,3095999,20.251645056574553,36.48159131933653,0.0808905757407653,2016.1450688838959,244.31127524375916,1644.383542060852,12781,3110,9671,9671,0,31,3096000.0
3096,3096999,20.25017189883064,36.48083450231575,0.08086779611436001,2016.7332708835602,244.3801085948944,1644.9026231765747,12783,3111,9672,9672,0,31,3097000.0
3097,3097999,20.249039593132018,36.47988150988172,0.08084926058198405,2017.4605889320374,244.4469895362854,1644.3627290725708,12787,3114,9673,9673,0,31,3098000.0
3098,3098999,20.24819739940255,36.4777909770957,0.0808320352172528,2018.1650462150574,244.51504111289978,1644.315167427063,12789,3115,9674,9674,0,31,3099000.0
3099,3099999,20.247303362596032,36.47588014123711,0.08080699531256186,2018.7613127231598,244.58249425888062,1644.668454170227,12791,3116,9675,9675,0,31,3100000.0
3100,3100999,20.247333004366276,36.47576842767727,0.08077613255396021,2019.4688589572906,244.65005135536194,1644.7544145584106,12791,3116,9675,9675,0,31,3101000.0
3101,3101999,20.247941304267563,36.47759118852746,0.08073247290841101,2019.955944776535,244.7172474861145,1645.7218217849731,12793,3117,9676,9676,0,31,3102000.0
3102,3102999,20.248625024311334,36.47813665846906,0.08071358034852505,2020.796725988388,244.78832006454468,1645.0532579421997,12797,3119,9678,9678,0,31,3103000.0
3103,3103999,20.24917254643146,36.47878893928763,0.0806923699015607,2021.4787254333496,244.85609459877014,1645.0967454910278,12799,3120,9679,9679,0,31,3104000.0
3104,3104999,20.249427348633656,36.478211882090775,0.08066612153699793,2022.1757020950317,244.9232141971588,1645.0568056106567,12800,3121,9679,9679,0,31,3105000.0
3105,3105999,20.250660061940792,36.47922598711717,0.08064214255279001,2022.758231639862,244.99008297920227,1645.6346635818481,12802,3122,9680,9680,0,31,3106000.0
3106,3106999,20.25169344892444,36.480081973882804,0.08060788886296155,2023.4528074264526,245.0595064163208,1645.6344652175903,12833,3123,9710,9710,0,31,3107000.0
3107,3107999,20.25344000202972,36.48217208874139,0.0805851543382583,2024.2770357131958,245.12882137298584,1645.3452577590942,12833,3123,9710,9710,0,31,3108000.0
3108,3108999,20.254910716344874,36.48287445134211,0.0805569797337603,2025.0894961357117,245.2009711265564,1644.8643236160278,12833,3123,9710,9710,0,31,3109000.0
3109,3109999,20.255789323650912,36.48227584426381,0.08054253557476898,2025.5674123764038,245.2700638771057,1645.8257417678833,12834,3124,9710,9710,0,31,3110000.0
3110,3110999,20.254348470174804,36.48021814111674,0.0805308308620234,2026.031584739685,245.33709573745728,1647.3790407180786,12846,3124,9722,9722,0,31,3111000.0
3111,3111999,20.25207413831669,36.47676863590117,0.08053092595733513,2026.6197652816772,245.40203213691711,1647.7931261062622,12850,3125,9725,9725,0,31,3112000.0
3112,3112999,20.24998640628261,36.4742317944728,0.08053016810693048,2027.098156452179,245.46748399734497,1648.9456224441528,12851,3125,9726,9726,0,31,3113000.0
3113,3113999,20.24791073888889,36.47103217886271,0.08052774935523,2027.5724828243256,245.53303980827332,1650.266224861145,12851,3125,9726,9726,0,31,3114000.0
3114,3114999,20.245888024619855,36.46744412583626,0.08052736256146253,2028.330636024475,245.59770822525024,1649.7751665115356,12855,3127,9728,9728,0,31,3115000.0
3115,3115999,20.244129919469053,36.46579245420265,0.08052335755824969,2029.3758702278137,245.66395449638367,1647.4574708938599,12863,3131,9732,9732,0,31,3116000.0
3116,3116999,20.242950237566998,36.464354175470184,0.0805007861465763,2029.7593824863434,245.7315709590912,1649.1011095046997,12864,3131,9733,9733,0,31,3117000.0
3117,3117999,20.24200104317626,36.462427040115216,0.08048436972177075,2030.463039636612,245.79929518699646,1649.0522050857544,12865,3132,9733,9733,0,31,3118000.0
3118,3118999,20.24130616350085,36.460962753109385,0.08046533073489925,2030.9300622940063,245.86700773239136,1650.1509523391724,12866,3133,9733,9733,0,31,3119000.0
3119,3119999,20.241266031584928,36.46027255922034,0.08044752072850181,2031.4301919937134,245.9333996772766,1651.2623872756958,12866,3133,9733,9733,0,31,3120000.0
3120,3120999,20.24198000528687,36.46170811129857,0.08042251035278691,2031.9260597229004,245.9990713596344,1652.3583040237427,12866,3133,9733,9733,0,31,3121000.0
3121,3121999,20.241963739584012,36.46035622834076,0.08047226846269928,2032.700607061386,246.06754398345947,1651.9289445877075,12868,3134,9734,9734,0,31,3122000.0
3122,3122999,20.24240708295682,36.46073979339327,0.08050721826040341,2033.4897797107697,246.13543605804443,1651.467267036438,12874,3135,9739,9739,0,31,3123000.0
3123,3123999,20.243321842966406,36.46187320730214,0.08053305319090154,2033.9952557086945,246.20447039604187,1652.5206575393677,12876,3136,9740,9740,0,31,3124000.0
3124,3124999,20.244042853255824,36.46242151192035,0.08055715357089244,2034.597135066986,246.2748897075653,1652.9157915115356,12877,3137,9740,9740,0,31,3125000.0
3125,3125999,20.245507805764223,36.46403027096591,0.08056926270093412,2035.1960067749023,246.34440422058105,1653.6354036331177,12877,3137,9740,9740,0,31,3126000.0
3126,3126999,20.246370920886775,36.46391964263624,0.08056929938483148,2035.901495218277,246.41403079032898,1653.6799745559692,12877,3137,9740,9740,0,31,3127000.0
3127,3127999,20.2472184439855,36.4634637639784,0.08056902816142109,2036.4867289066315,246.4837567806244,1654.090947151184,12881,3139,9742,9742,0,31,3128000.0
3128,3128999,20.24836803289539,36.46351113481732,0.08055745049986385,2037.3903336524963,246.55206751823425,1653.0088548660278,12882,3140,9742,9742,0,31,3129000.0
3129,3129999,20.24896905580551,36.46263387759797,0.08053649343125746,2038.0138082504272,246.62322902679443,1653.5718202590942,12882,3140,9742,9742,0,31,3130000.0
3130,3130999,20.249004739868322,36.46079954351174,0.08051635142690095,2038.6370067596436,246.69318962097168,1654.0995836257935,12882,3140,9742,9742,0,31,3131000.0
3131,3131999,20.250645747452573,36.46411738079777,0.08042114510875875,2039.0033090114594,246.757479429245,1655.9157991409302,12893,3140,9753,9753,0,31,3132000.0
3132,3132999,20.25049769303069,36.46151076370718,0.08037676633984492,2039.5764482021332,246.82171726226807,1656.6016359329224,12898,3140,9758,9758,0,31,3133000.0
3133,3133999,20.249567328474136,36.4587112771672,0.08035675632647399,2040.031884431839,246.88792204856873,1657.698712348938,12900,3141,9759,9759,0,31,3134000.0
3134,3134999,20.248754104239186,36.45793504254955,0.0803325478714434,2040.4136700630188,246.95180869102478,1659.3397951126099,12900,3141,9759,9759,0,31,3135000.0
3135,3135999,20.24830122407673,36.45694246744992,0.08031420510467024,2041.2437183856964,247.0179307460785,1658.449330329895,12903,3143,9760,9760,0,31,3136000.0
3136,3136999,20.24766816145145,36.45587141128292,0.08029173473258666,2041.686796426773,247.08236241340637,1659.9868364334106,12903,3143,9760,9760,0,31,3137000.0
3137,3137999,20.247031193569857,36.45456134677235,0.08027339249793797,2042.3299140930176,247.1472134590149,1660.33141040802,12905,3144,9761,9761,0,31,3138000.0
3138,3138999,20.246804623799754,36.45431374582499,0.08025293795431487,2042.9153339862823,247.21296763420105,1660.8306703567505,12906,3145,9761,9761,0,31,3139000.0
3139,3139999,20.247435937275668,36.45447648349266,0.08023749451703532,2043.6220724582672,247.28164386749268,1660.9358568191528,12906,3145,9761,9761,0,31,3140000.0
3140,3140999,20.249528195288793,36.4625642251634,0.08020076981649316,2044.4619030952454,247.34777426719666,1660.2971544265747,12908,3146,9762,9762,0,31,3141000.0
3141,3141999,20.253737451801012,36.47119914563161,0.08019391959628597,2045.0711908340454,247.41586804389954,1660.600438117981,12910,3147,9763,9763,0,31,3142000.0
3142,3142999,20.26052141064999,36.48645570262003,0.08021165781098705,2045.693787574768,247.48254489898682,1661.142346382141,12910,3147,9763,9763,0,31,3143000.0
3143,3143999,20.268813459050563,36.51572028846689,0.08024940917548118,2046.6013395786285,247.55118131637573,1659.733868598938,12913,3149,9764,9764,0,31,3144000.0
3144,3144999,20.27788812143592,36.54087262771622,0.08035933090184255,2047.1261060237885,247.62255930900574,1660.8217287063599,12913,3149,9764,9764,0,31,3145000.0
3145,3145999,20.288928511083405,36.57438093545183,0.08049822011158403,2047.850814819336,247.6908721923828,1660.7845125198364,12914,3150,9764,9764,0,31,3146000.0
3146,3146999,20.302072806270825,36.611259789030726,0.08076612020370388,2048.564346075058,247.75942993164062,1660.863621711731,12914,3150,9764,9764,0,31,3147000.0
3147,3147999,20.314755576347263,36.645193896244386,0.08102128956667765,2049.1591515541077,247.82563185691833,1661.5454759597778,12914,3150,9764,9764,0,31,3148000.0
3148,3148999,20.32610621879243,36.66838787797816,0.08125805936312858,2050.060734272003,247.89528465270996,1660.5333070755005,12918,3151,9767,9767,0,31,3149000.0
3149,3149999,20.337888262883105,36.693913339254436,0.0815468631524574,2050.6814289093018,247.96388602256775,1661.071270942688,12918,3151,9767,9767,0,31,3150000.0
3150,3150999,20.34990374326139,36.71895272728272,0.08180098160746441,2051.4583785533905,248.0380311012268,1660.2454042434692,12923,3154,9769,9769,0,31,3151000.0
3151,3151999,20.357621692354922,36.73358387402344,0.08189894759019178,2051.9570128917694,248.1050968170166,1661.5221376419067,12933,3154,9779,9779,0,31,3152000.0
3152,3152999,20.35737334461429,36.73805931761163,0.08187268211150855,2052.521704673767,248.1711163520813,1662.190037727356,12943,3155,9788,9788,0,31,3153000.0
3153,3153999,20.35651081243664,36.73698164972047,0.08186019297318703,2053.0841312408447,248.24091792106628,1662.8186388015747,12961,3157,9804,9804,0,31,3154000.0
3154,3154999,20.355961880765417,36.73652360991089,0.0818437477030508,2053.5772387981415,248.30966567993164,1663.9083452224731,12963,3158,9805,9805,0,31,3155000.0
3155,3155999,20.355488007278318,36.73590994786796,0.081806405231591,2054.2824218273163,248.38031101226807,1664.0358400344849,12965,3159,9806,9806,0,31,3156000.0
3156,3156999,20.354871131170086,36.73446096640172,0.08179830058284399,2054.729650735855,248.4502739906311,1665.3233766555786,12969,3161,9808,9808,0,31,3157000.0
3157,3157999,20.35385381225118,36.731976820139145,0.08178693385969482,2055.4846711158752,248.51828980445862,1665.2694597244263,12971,3162,9809,9809,0,31,3158000.0
3158,3158999,20.3536228833396,36.73631657424306,0.08175023810538529,2055.988723039627,248.58548784255981,1666.0989198684692,12975,3164,9811,9811,0,31,3159000.0
3159,3159999,20.35277754221782,36.73429367264908,0.08173230697292855,2056.4772946834564,248.65284180641174,1667.213948249817,12977,3165,9812,9812,0,31,3160000.0
3160,3160999,20.352227774758113,36.732800063525005,0.08171375686001836,2057.261317014694,248.7226266860962,1666.8493242263794,12981,3167,9814,9814,0,31,3161000.0
3161,3161999,20.351805819681662,36.73161410082834,0.08167831531791436,2058.0192523002625,248.7939202785492,1667.1337785720825,12981,3167,9814,9814,0,31,3162000.0
3162,3162999,20.351836695625796,36.73182122701443,0.0816486122590735,2058.6237738132477,248.8615870475769,1667.719334602356,12981,3167,9814,9814,0,31,3163000.0
3163,3163999,20.35192195837185,36.73157605458505,0.08162866316631434,2059.1255145072937,248.92765522003174,1668.8075151443481,12981,3167,9814,9814,0,31,3164000.0
3164,3164999,20.3522454924435,36.731556830088444,0.08159400170007192,2059.6161592006683,249.0002670288086,1669.7020616531372,12985,3169,9816,9816,0,31,3165000.0
3165,3165999,20.35249692994036,36.7304446559489,0.08157087221097226,2060.52411031723,249.06896424293518,1668.847050666809,12985,3169,9816,9816,0,31,3166000.0
3166,3166999,20.3524143385988,36.72866261154283,0.08155748953036457,2061.347132921219,249.136465549469,1667.528775215149,12991,3172,9819,9819,0,31,3167000.0
3167,3167999,20.35271830651641,36.72785975802768,0.08153493749090102,2061.773320913315,249.20891666412354,1669.156720161438,12991,3172,9819,9819,0,31,3168000.0
3168,3168999,20.352924763140734,36.72648046450651,0.08152029517506942,2062.4900946617126,249.27708625793457,1669.2121095657349,12991,3172,9819,9819,0,31,3169000.0
3169,3169999,20.352353224717305,36.72545696008251,0.08150266357778413,2063.1749215126038,249.34714460372925,1669.240704536438,12993,3173,9820,9820,0,31,3170000.0
3170,3170999,20.352828009281296,36.72423950630412,0.08141944149888569,2063.71901512146,249.41380524635315,1669.962040901184,13013,3175,9838,9838,0,31,3171000.0
3171,3171999,20.351934731223604,36.721895082479335,0.08138073001746426,2064.3424282073975,249.48264050483704,1669.8227586746216,13024,3179,9845,9845,0,31,3172000.0
3172,3172999,20.350721526110934,36.71924821924982,0.08135963361677401,2064.52601480484,249.54943895339966,1672.5579805374146,13025,3179,9846,9846,0,31,3173000.0
3173,3173999,20.348880948498064,36.71529544280788,0.08135194697796333,2065.4652061462402,249.618022441864,1671.3076066970825,13034,3183,9851,9851,0,31,3174000.0
3174,3174999,20.34711702539556,36.71176162534989,0.08134877790584616,2065.835650920868,249.68602561950684,1672.8931093215942,13038,3185,9853,9853,0,31,3175000.0
3175,3175999,20.345351358870246,36.7092854331996,0.08134043323648321,2066.3067100048065,249.7524058818817,1674.1624727249146,13040,3186,9854,9854,0,31,3176000.0
3176,3176999,20.343367724475634,36.705530937896334,0.08133810096400529,2067.0116698741913,249.82139539718628,1674.1768465042114,13044,3188,9856,9856,0,31,3177000.0
3177,3177999,20.341563587997726,36.70186968897052,0.08133410519945239,2067.825259208679,249.88974571228027,1673.4334154129028,13048,3190,9858,9858,0,31,3178000.0
3178,3178999,20.339859468286825,36.6997559170752,0.08132512887973364,2068.5247237682343,249.958313703537,1673.7431840896606,13048,3190,9858,9858,0,31,3179000.0
3179,3179999,20.338542432364655,36.69718459821674,0.08131283433995451,2069.0528194904327,250.02822995185852,1674.6644716262817,13050,3191,9859,9859,0,31,3180000.0
3180,3180999,20.336975896325157,36.694062719054244,0.0813035655385741,2069.681125640869,250.09501576423645,1674.9719514846802,13052,3192,9860,9860,0,31,3181000.0
3181,3181999,20.335432542888864,36.69099318146782,0.08129612219739213,2070.204947948456,250.16557621955872,1676.1332902908325,13052,3192,9860,9860,0,31,3182000.0
3182,3182999,20.33416017130392,36.68793637582736,0.08128609280089583,2070.800450325012,250.2323513031006,1676.6959810256958,13054,3193,9861,9861,0,31,3183000.0
3183,3183999,20.333549657979933,36.68643734950386,0.08126747030840842,2071.689665079117,250.3038854598999,1675.828724861145,13058,3195,9863,9863,0,31,3184000.0
3184,3184999,20.333640474400656,36.68877240536109,0.08122896783701206,2072.4035680294037,250.3750503063202,1675.434681892395,13064,3198,9866,9866,0,31,3185000.0
3185,3185999,20.334178610577812,36.68947874632165,0.0812014976387837,2073.335695505142,250.4426567554474,1674.6632356643677,13064,3198,9866,9866,0,31,3186000.0
3186,3186999,20.33440962471936,36.68918837194026,0.08118210741059972,2073.977073431015,250.5171856880188,1675.245976448059,13064,3198,9866,9866,0,31,3187000.0
3187,3187999,20.335154386739774,36.690000679432295,0.08115902776426243,2074.4942507743835,250.58571219444275,1676.3565950393677,13064,3198,9866,9866,0,31,3188000.0
3188,3188999,20.33600583669297,36.6910357600731,0.08112933539166955,2075.011142730713,250.6534562110901,1677.4220476150513,13064,3198,9866,9866,0,31,3189000.0
3189,3189999,20.33643573681496,36.690353225189384,0.08110766882609222,2075.619564771652,250.720858335495,1678.0250062942505,13064,3198,9866,9866,0,31,3190000.0
3190,3190999,20.337278537838362,36.691269135502885,0.08102897426081945,2076.304693698883,250.78992223739624,1678.405758857727,13074,3198,9876,9876,0,31,3191000.0
3191,3191999,20.337715723355004,36.68979991053581,0.08089556226798922,2076.7696766853333,250.85653233528137,1679.5993700027466,13084,3199,9885,9885,0,31,3192000.0
3192,3192999,20.337317869673907,36.68839846504422,0.08083000892029002,2077.2308082580566,250.9258110523224,1680.547345161438,13089,3201,9888,9888,0,31,3193000.0
3193,3193999,20.336906566764654,36.68709289561196,0.08076519011257932,2077.8431367874146,250.99293756484985,1680.5088472366333,13106,3206,9900,9900,0,31,3194000.0
3194,3194999,20.335585445071715,36.685285840793775,0.08073941697632447,2078.238935947418,251.05989265441895,1681.9487962722778,13110,3208,9902,9902,0,31,3195000.0
3195,3195999,20.33387564238601,36.683682686745854,0.08072007896357858,2079.3458585739136,251.12889623641968,1679.9254655838013,13118,3212,9906,9906,0,31,3196000.0
3196,3196999,20.33213864814734,36.68039601562357,0.08069669902395371,2079.717128276825,251.19809198379517,1681.5764741897583,13120,3213,9907,9907,0,31,3197000.0
3197,3197999,20.33044064354717,36.67715018228866,0.08068381302921435,2080.3015065193176,251.2666072845459,1682.6274309158325,13120,3213,9907,9907,0,31,3198000.0
3198,3198999,20.329174805860326,36.676047997422295,0.08066219359656579,2080.8183183670044,251.333988904953,1683.7507829666138,13120,3213,9907,9907,0,31,3199000.0
3199,3199999,20.327823079757536,36.67302763235127,0.08064907742867455,2081.806505203247,251.40267825126648,1682.5291032791138,13122,3214,9908,9908,0,31,3200000.0
3200,3200999,20.327279258906554,36.67191295283256,0.08061883327726405,2082.6094431877136,251.47128915786743,1681.4123048782349,13130,3218,9912,9912,0,31,3201000.0
3201,3201999,20.327225139851134,36.67233020079068,0.08057956522802223,2082.929586172104,251.54451990127563,1683.563458442688,13130,3218,9912,9912,0,31,3202000.0
3202,3202999,20.326938439945913,36.67193585222078,0.08056296984261568,2083.5672178268433,251.61357402801514,1684.1472215652466,13130,3218,9912,9912,0,31,3203000.0
3203,3203999,20.328566128203963,36.67672801516012,0.08053802926650144,2084.2611513137817,251.6833519935608,1684.1231050491333,13134,3220,9914,9914,0,31,3204000.0
3204,3204999,20.331819543236474,36.684078744626305,0.0805126550354982,2084.882041454315,251.75225019454956,1684.6934633255005,13134,3220,9914,9914,0,31,3205000.0
3205,3205999,20.3350192465253,36.69498837771713,0.080492717890153,2085.7679789066315,251.8218822479248,1683.9267625808716,13143,3221,9922,9922,0,31,3206000.0
3206,3206999,20.338739838326905,36.70271034679247,0.08051311488220081,2086.066120862961,251.89210438728333,1686.1322679519653,13143,3221,9922,9922,0,31,3207000.0
3207,3207999,20.343031247101884,36.711048490519495,0.08053667475149262,2086.9643552303314,251.96302938461304,1685.269284248352,13145,3222,9923,9923,0,31,3208000.0
3208,3208999,20.347314314690703,36.71944623856458,0.08057463222097239,2087.520443916321,252.03227758407593,1685.9240083694458,13149,3224,9925,9925,0,31,3209000.0
3209,3209999,20.351108820634572,36.72745485392469,0.08060355537410424,2087.895082950592,252.10125827789307,1687.597653388977,13151,3225,9926,9926,0,31,3210000.0
3210,3210999,20.355463630559083,36.73508243555116,0.08068329014844888,2088.714992761612,252.17294836044312,1687.0533418655396,13153,3226,9927,9927,0,31,3211000.0
3211,3211999,20.358807082479952,36.74707956640322,0.08068780915403695,2089.480106830597,252.2452712059021,1687.2554216384888,13160,3226,9934,9934,0,31,3212000.0
3212,3212999,20.357392110155583,36.744942832686164,0.08066922551038058,2090.0572628974915,252.3160367012024,1687.8791704177856,13167,3227,9940,9940,0,31,3213000.0
3213,3213999,20.35608124744128,36.742006270696635,0.08065175680694314,2090.5204045772552,252.38441109657288,1688.871663093567,13172,3229,9943,9943,0,31,3214000.0
3214,3214999,20.35449347338247,36.73867186601795,0.08065196034284705,2091.0087208747864,252.45057487487793,1690.0116243362427,13176,3230,9946,9946,0,31,3215000.0
3215,3215999,20.35301393480973,36.73567526951026,0.08064692751027336,2091.6861460208893,252.51675152778625,1690.4726076126099,13176,3230,9946,9946,0,31,3216000.0
3216,3216999,20.3515905530813,36.73367662356364,0.0806353979621588,2092.4239208698273,252.58620977401733,1689.8985719680786,13184,3234,9950,9950,0,31,3217000.0
3217,3217999,20.35040424461116,36.73220153595694,0.08061962869280426,2093.0264286994934,252.6559603214264,1690.4880571365356,13186,3235,9951,9951,0,31,3218000.0
3218,3218999,20.349240431061727,36.730763060071546,0.08061313164977058,2093.7420566082,252.72332429885864,1690.3334550857544,13188,3236,9952,9952,0,31,3219000.0
3219,3219999,20.348850901868595,36.73124898992655,0.08058889593762553,2094.2536976337433,252.7911925315857,1691.440640449524,13188,3236,9952,9952,0,31,3220000.0
3220,3220999,20.34891449869069,36.73535000159427,0.08057382032282934,2094.8469939231873,252.85949444770813,1691.9972047805786,13190,3237,9953,9953,0,31,3221000.0
3221,3221999,20.35012444449064,36.74052262407405,0.08054213777865482,2095.1600844860077,252.92667746543884,1694.114743232727,13190,3237,9953,9953,0,31,3222000.0
3222,3222999,20.353721537315884,36.752280095643066,0.08049956438522377,2095.5841505527496,252.99777126312256,1695.7185716629028,13190,3237,9953,9953,0,31,3223000.0
3223,3223999,20.357538730254067,36.76680363534992,0.08047093037582864,2096.2865278720856,253.0662488937378,1695.9898653030396,13190,3237,9953,9953,0,31,3224000.0
3224,3224999,20.363446367747766,36.784631480809374,0.08045422487513665,2096.8731648921967,253.13520550727844,1696.6359605789185,13192,3238,9954,9954,0,31,3225000.0
3225,3225999,20.370551272377742,36.80574990416481,0.08042843680509182,2097.568907260895,253.2022247314453,1696.7307634353638,13194,3239,9955,9955,0,31,3226000.0
3226,3226999,20.376491342345464,36.82327343511973,0.08040517221342891,2097.9964530467987,253.27036428451538,1698.3361024856567,13194,3239,9955,9955,0,31,3227000.0
3227,3227999,20.384291368718653,36.84659909881334,0.0803900840477344,2098.7632353305817,253.33639192581177,1697.8898057937622,13198,3241,9957,9957,0,31,3228000.0
3228,3228999,20.39144327913845,36.86887906531973,0.08037215993759828,2099.830822467804,253.40556406974792,1695.7225694656372,13206,3245,9961,9961,0,31,3229000.0
3229,3229999,20.399189331910318,36.889768344045315,0.08035819527357668,2100.6463153362274,253.4732038974762,1695.4220552444458,13206,3245,9961,9961,0,31,3230000.0
3230,3230999,20.40918467484342,36.91924858190706,0.08034801905895972,2101.3554136753082,253.54213953018188,1695.6008577346802,13208,3246,9962,9962,0,31,3231000.0
3231,3231999,20.414405431816427,36.93141374949127,0.08035896356808991,2101.7629039287567,253.60959839820862,1697.197766304016,13208,3246,9962,9962,0,31,3232000.0
3232,3232999,20.416158047690917,36.93380249864636,0.08030189407511046,2102.2345254421234,253.67940044403076,1698.4098634719849,13226,3247,9979,9979,0,31,3233000.0
3233,3233999,20.415275002807466,36.93229591237919,0.0802763735193468,2102.7215943336487,253.74940299987793,1699.6388216018677,13231,3247,9984,9984,0,31,3234000.0
3234,3234999,20.414442260771995,36.93524201154998,0.0802312974330679,2103.6046130657196,253.82078862190247,1698.834195137024,13236,3248,9988,9988,0,31,3235000.0
3235,3235999,20.413721166363423,36.93422158233994,0.08021045725105136,2104.0802204608917,253.89126420021057,1699.9445314407349,13238,3249,9989,9989,0,31,3236000.0
3236,3236999,20.412679561154704,36.93252252483197,0.08019226366172116,2104.7742998600006,253.96025919914246,1700.1292848587036,13240,3250,9990,9990,0,31,3237000.0
3237,3237999,20.411637582081376,36.93062262443054,0.08017696024030108,2105.350386619568,254.030033826828,1700.6675004959106,13244,3252,9992,9992,0,31,3238000.0
3238,3238999,20.4100140588766,36.92731056552778,0.08017028110433955,2105.9834537506104,254.10128784179688,1700.8602418899536,13246,3253,9993,9993,0,31,3239000.0
3239,3239999,20.40880866314163,36.92461522873955,0.08015864964139374,2115.856922388077,254.1742832660675,1700.8051805496216,13247,3254,9993,9993,0,31,3240000.0
3240,3240999,20.408017676748006,36.922699264724955,0.08013666970668798,2116.3667707443237,254.24750471115112,1701.9932222366333,13247,3254,9993,9993,0,31,3241000.0
3241,3241999,20.407659791491593,36.921158603813126,0.08011847982780318,2117.1942830085754,254.32044506072998,1701.5523881912231,13247,3254,9993,9993,0,31,3242000.0
3242,3242999,20.407329731222763,36.91921998712858,0.08010182424449686,2117.6747827529907,254.39420080184937,1702.528447151184,13250,3256,9994,9994,0,31,3243000.0
3243,3243999,20.408623379659154,36.92157163872409,0.08007205088402425,2118.4975233078003,254.46728563308716,1702.0872240066528,13250,3256,9994,9994,0,31,3244000.0
3244,3244999,20.41019358670016,36.92338919256489,0.08006229938911302,2119.0990619659424,254.54042720794678,1702.6340761184692,13252,3257,9995,9995,0,31,3245000.0
3245,3245999,20.413133538858403,36.92996798105092,0.08004089071627907,2119.905275583267,254.6150689125061,1702.1286211013794,13254,3258,9996,9996,0,31,3246000.0
3246,3246999,20.41725810001087,36.94278111661417,0.080011336955776,2120.5253167152405,254.68803143501282,1702.679684638977,13254,3258,9996,9996,0,31,3247000.0
3247,3247999,20.422127686915942,36.95265840235627,0.07998591514613973,2121.126886367798,254.76014757156372,1703.1080827713013,13255,3259,9996,9996,0,31,3248000.0
3248,3248999,20.42766979871201,36.964084443911894,0.07999630201526553,2121.531328201294,254.83123302459717,1704.7363634109497,13255,3259,9996,9996,0,31,3249000.0
3249,3249999,20.432774859498988,36.9740997793027,0.07999822502981901,2122.4930262565613,254.90642476081848,1703.2641801834106,13261,3262,9999,9999,0,31,3250000.0
3250,3250999,20.43817429795378,36.98163964444102,0.08003093993349153,2122.9859528541565,254.97811675071716,1704.2876405715942,13262,3263,9999,9999,0,31,3251000.0
3251,3251999,20.44407143106494,36.98983424561227,0.08011750588842292,2124.190930366516,255.05138063430786,1702.4258546829224,13262,3263,9999,9999,0,31,3252000.0
3252,3252999,20.448014998468622,36.99609422221413,0.08010669839018503,2124.681708574295,255.11943864822388,1703.5497179031372,13262,3263,9999,9999,0,31,3253000.0
3253,3253999,20.448838825081477,36.996091869032185,0.0799714554108154,2125.504658460617,255.1932406425476,1703.2553453445435,13281,3264,10017,10017,0,31,3254000.0
3254,3254999,20.447449630755806,36.9934737861553,0.0799407661893825,2126.0711126327515,255.26344919204712,1703.7787370681763,13287,3266,10021,10021,0,31,3255000.0
3255,3255999,20.44593745158685,36.99496580456961,0.079916856957995,2126.7235872745514,255.333651304245,1703.8573808670044,13300,3269,10031,10031,0,31,3256000.0
3256,3256999,20.44430162682388,36.99197370573055,0.07991466184249363,2127.302072763443,255.40338563919067,1704.811520576477,13300,3269,10031,10031,0,31,3257000.0
3257,3257999,20.44283767362937,36.99090563904914,0.07990047449509396,2127.896276950836,255.47435879707336,1705.6014986038208,13300,3269,10031,10031,0,31,3258000.0
3258,3258999,20.441806439462262,36.98938132100066,0.07988675150683733,2128.498519182205,255.5429904460907,1706.2809190750122,13301,3269,10032,10032,0,31,3259000.0
3259,3259999,20.440455524864113,36.988570449567675,0.07986785524113593,2129.013741016388,255.6121597290039,1707.3397874832153,13301,3269,10032,10032,0,31,3260000.0
3260,3260999,20.439067296803184,36.98601297038202,0.07985500562046743,2129.514427423477,255.68250060081482,1708.3455324172974,13302,3270,10032,10032,0,31,3261000.0
3261,3261999,20.43778844731055,36.983363616404674,0.07984693887625283,2130.2216968536377,255.7535252571106,1708.5864000320435,13302,3270,10032,10032,0,31,3262000.0
3262,3262999,20.437109164757693,36.982017025564375,0.07982615400991955,2130.9997928142548,255.8249294757843,1708.010365486145,13305,3272,10033,10033,0,31,3263000.0
3263,3263999,20.43640548674218,36.981406404360435,0.07980747203968108,2131.630279779434,255.89759016036987,1708.6196641921997,13305,3272,10033,10033,0,31,3264000.0
3264,3264999,20.43663537877721,36.980684680687446,0.07979421101537154,2132.2929100990295,255.96787476539612,1709.0343217849731,13305,3272,10033,10033,0,31,3265000.0
3265,3265999,20.43696024548651,36.98016598168714,0.07978232444746425,2132.9954640865326,256.0388903617859,1709.1535997390747,13305,3272,10033,10033,0,31,3266000.0
3266,3266999,20.438390837084118,36.98113927810493,0.07976923296694072,2133.703522205353,256.11393761634827,1709.1904573440552,13307,3273,10034,10034,0,31,3267000.0
3267,3267999,20.441091268848307,36.98470549590397,0.07975017432237275,2134.2292461395264,256.185932636261,1710.2516298294067,13307,3273,10034,10034,0,31,3268000.0
3268,3268999,20.444244078418585,36.9882630998345,0.07974500041259669,2135.0804963111877,256.25895500183105,1708.944561958313,13326,3277,10049,10049,0,31,3269000.0
3269,3269999,20.447614110011045,36.99239113321765,0.07976660880306052,2135.9725341796875,256.33375430107117,1707.7361879348755,13332,3280,10052,10052,0,31,3270000.0
3270,3270999,20.45184475669956,36.99664586220495,0.07979421023304234,2136.5841488838196,256.41169142723083,1708.3029069900513,13333,3281,10052,10052,0,31,3271000.0
3271,3271999,20.455472509720977,36.99895392727787,0.07981765311588362,2137.284211397171,256.48572397232056,1708.359845161438,13349,3282,10067,10067,0,31,3272000.0
3272,3272999,20.4587628337233,37.00091383355109,0.07983743796881071,2137.7828373908997,256.55914783477783,1709.6668214797974,13349,3282,10067,10067,0,31,3273000.0
3273,3273999,20.461765690735795,37.00235184734466,0.07984017934767085,2138.6086671352386,256.6354019641876,1709.2932405471802,13349,3282,10067,10067,0,31,3274000.0
3274,3274999,20.465510625352398,37.00407764001183,0.07962785748975987,2139.111442089081,256.7075493335724,1710.6350145339966,13367,3282,10085,10085,0,31,3275000.0
3275,3275999,20.46758211839273,37.004260779199605,0.07945635643801385,2139.5644783973694,256.7788932323456,1711.8695344924927,13375,3283,10092,10092,0,31,3276000.0
3276,3276999,20.46542764984741,37.00126874076579,0.07945364565974411,2140.141236305237,256.8479382991791,1712.5871171951294,13376,3283,10093,10093,0,31,3277000.0
3277,3277999,20.463814656200658,36.99845122068632,0.07944252258737661,2140.5223128795624,256.915958404541,1714.2237062454224,13376,3283,10093,10093,0,31,3278000.0
3278,3278999,20.461770280582265,36.994770572100734,0.079440248266475,2141.106714248657,256.9838111400604,1714.7354173660278,13379,3284,10095,10095,0,31,3279000.0
3279,3279999,20.460636302919717,36.995951641162875,0.07940872670970534,2142.0126991271973,257.0555603504181,1713.9134187698364,13381,3285,10096,10096,0,31,3280000.0
3280,3280999,20.458739347387795,36.992940948519966,0.07940086669964941,2142.656603574753,257.12448716163635,1714.3158159255981,13383,3286,10097,10097,0,31,3281000.0
3281,3281999,20.457076802957143,36.9896811379265,0.07938863334392998,2143.2346289157867,257.1956670284271,1714.801999092102,13384,3287,10097,10097,0,31,3282000.0
3282,3282999,20.455446819704182,36.98661576416508,0.07937210254762861,2143.8247287273407,257.26677417755127,1715.2842683792114,13385,3288,10097,10097,0,31,3283000.0
3283,3283999,20.454330807110683,36.983782270491226,0.07935291857673532,2144.435950279236,257.33976793289185,1715.9289979934692,13385,3288,10097,10097,0,31,3284000.0
3284,3284999,20.453898670533253,36.98295369054245,0.07931895973473058,2145.2536265850067,257.4119601249695,1715.4252824783325,13387,3289,10098,10098,0,31,3285000.0
3285,3285999,20.453719186524108,36.98176996101714,0.07929252369294926,2145.764617204666,257.4832534790039,1716.494641304016,13387,3289,10098,10098,0,31,3286000.0
3286,3286999,20.454151578375168,36.98094311554198,0.0792708697159008,2146.480879306793,257.5543351173401,1716.350842475891,13389,3290,10099,10099,0,31,3287000.0
3287,3287999,20.454947963127896,36.98090319429544,0.07924171671947888,2147.1765127182007,257.6251039505005,1716.3756761550903,13406,3292,10114,10114,0,31,3288000.0
3288,3288999,20.456149527388018,36.98147239629508,0.07921035087526429,2147.6712415218353,257.6976571083069,1717.341633796692,13407,3293,10114,10114,0,31,3289000.0
3289,3289999,20.457336438548936,36.981654407834434,0.07918295058244817,2148.449934244156,257.77077889442444,1716.755696296692,13420,3295,10125,10125,0,31,3290000.0
3290,3290999,20.458480841799833,36.98111770023417,0.07916282574856714,2149.2358753681183,257.8435597419739,1716.1872987747192,13428,3298,10130,10130,0,31,3291000.0
3291,3291999,20.459510109749367,36.98036774625827,0.07915210440841025,2149.7309725284576,257.91708183288574,1717.3013429641724,13430,3299,10131,10131,0,31,3292000.0
3292,3292999,20.46121017101262,36.982990490350076,0.07912228910885055,2150.5546445846558,257.99212622642517,1717.0031251907349,13430,3299,10131,10131,0,31,3293000.0
3293,3293999,20.462745016974914,36.988925714582166,0.07907982753552578,2151.2482488155365,258.0642247200012,1717.0083513259888,13434,3301,10133,10133,0,31,3294000.0
3294,3294999,20.463446857581978,36.98754772189826,0.07906267275722867,2151.9500880241394,258.1376757621765,1717.065442085266,13436,3302,10134,10134,0,31,3295000.0
3295,3295999,20.463024809200494,36.98672666203231,0.079026164849759,2152.6426010131836,258.2112069129944,1717.1846132278442,13456,3303,10153,10153,0,31,3296000.0
3296,3296999,20.462860247760027,36.98640595651263,0.07900556731664177,2153.011284351349,258.28275990486145,1719.1722536087036,13465,3303,10162,10162,0,31,3297000.0
3297,3297999,20.462618926089398,36.98472037336808,0.07899792319232224,2153.2074117660522,258.3540060520172,1721.9269533157349,13466,3303,10163,10163,0,31,3298000.0
3298,3298999,20.462349687184155,36.983069180160086,0.07899211811912421,2153.7660596370697,258.42121481895447,1722.8399019241333,13469,3304,10165,10165,0,31,3299000.0
3299,3299999,20.462114894641594,36.98217793159952,0.07898591160204527,2154.5138018131256,258.49124026298523,1722.1457262039185,13479,3308,10171,10171,0,31,3300000.0
3300,3300999,20.461747700037588,36.98051461647245,0.07899808167020095,2155.0336163043976,258.56142926216125,1723.399495124817,13479,3308,10171,10171,0,31,3301000.0
3301,3301999,20.461789919643536,36.979841947861644,0.07899586292278749,2155.79914522171,258.63064408302307,1722.464680671692,13488,3312,10176,10176,0,31,3302000.0
3302,3302999,20.46184379604433,36.97838019871253,0.07900105400643109,2156.086002111435,258.69775891304016,1724.6302461624146,13490,3313,10177,10177,0,31,3303000.0
3303,3303999,20.462928191117022,36.98034041456059,0.07902251143792327,2156.652167081833,258.76641368865967,1725.4473695755005,13492,3314,10178,10178,0,31,3304000.0
3304,3304999,20.463852089771994,36.98213716870303,0.07902368030386597,2157.227020740509,258.83602643013,1726.0108613967896,13496,3316,10180,10180,0,31,3305000.0
3305,3305999,20.466096847667714,36.99263823477214,0.07902955846032433,2158.037638425827,258.90463733673096,1725.1267366409302,13502,3319,10183,10183,0,31,3306000.0
3306,3306999,20.469735023132188,37.00249535159348,0.0791377682904888,2158.5559010505676,258.97585272789,1726.3052530288696,13503,3319,10184,10184,0,31,3307000.0
3307,3307999,20.473013809570148,37.00929719568354,0.07924908079972304,2159.4786179065704,259.04710817337036,1725.367974281311,13505,3320,10185,10185,0,31,3308000.0
3308,3308999,20.476491757152235,37.01645265891205,0.07936194296900212,2159.964840888977,259.1143047809601,1726.4527139663696,13507,3321,10186,10186,0,31,3309000.0
3309,3309999,20.480060402305728,37.02290777526572,0.0794378190436682,2160.9482033252716,259.18423223495483,1724.898606300354,13512,3323,10189,10189,0,31,3310000.0
3310,3310999,20.483138223189403,37.027256730047554,0.07950711313546444,2161.6654148101807,259.2545597553253,1725.1862115859985,13512,3323,10189,10189,0,31,3311000.0
3311,3311999,20.487206861009724,37.034299250386475,0.07958246193594054,2162.0479316711426,259.3245391845703,1726.7387170791626,13514,3324,10190,10190,0,31,3312000.0
3312,3312999,20.490000903367278,37.03787911500015,0.07964092544562895,2162.658403158188,259.39249181747437,1727.3126077651978,13514,3324,10190,10190,0,31,3313000.0
3313,3313999,20.49196193772984,37.039172684626436,0.07969102312775211,2163.3659081459045,259.46007323265076,1727.4486093521118,13514,3324,10190,10190,0,31,3314000.0
3314,3314999,20.491935551850645,37.03966271548353,0.07967908296094983,2163.723031282425,259.5270080566406,1729.3662881851196,13542,3325,10217,10217,0,31,3315000.0
3315,3315999,20.490718393514175,37.038788554657636,0.07967767663897951,2163.9896512031555,259.5960178375244,1731.7708597183228,13550,3325,10225,10225,0,31,3316000.0
3316,3316999,20.489365272892975,37.037050479665815,0.07968531316874161,2164.182323694229,259.6649429798126,1734.566704750061,13552,3325,10227,10227,0,31,3317000.0
3317,3317999,20.488774182083628,37.03790674677655,0.0796721050055097,2164.653544664383,259.7329201698303,1735.6734018325806,13557,3327,10230,10230,0,31,3318000.0
3318,3318999,20.488925681798726,37.038199718533754,0.07967370761124992,2165.094040632248,259.8010287284851,1737.2525339126587,13559,3328,10231,10231,0,31,3319000.0
3319,3319999,20.488895878908917,37.0395035336538,0.07968919724271561,2165.579169988632,259.8683502674103,1738.6411752700806,13559,3328,10231,10231,0,31,3320000.0
3320,3320999,20.48900067079592,37.04071855236713,0.07970667095604789,2166.2982490062714,259.93827080726624,1738.4589395523071,13566,3331,10235,10235,0,31,3321000.0
3321,3321999,20.489769998086626,37.04264366765085,0.07973245966179998,2167.1663043498993,260.00585746765137,1737.7434396743774,13568,3332,10236,10236,0,31,3322000.0
3322,3322999,20.490293893441045,37.04285725860002,0.07976246754973904,2167.7380542755127,260.0779159069061,1738.386498451233,13572,3334,10238,10238,0,31,3323000.0
3323,3323999,20.49144001108294,37.044664639737,0.07982464140976464,2168.2616851329803,260.14546966552734,1739.2030115127563,13574,3335,10239,10239,0,31,3324000.0
3324,3324999,20.49262008306734,37.04650926963723,0.07989371330895101,2168.960186958313,260.21584153175354,1739.1014032363892,13581,3338,10243,10243,0,31,3325000.0
3325,3325999,20.49387908151233,37.048063317029126,0.07997336008852496,2169.26500415802,260.28550577163696,1741.3665323257446,13581,3338,10243,10243,0,31,3326000.0
3326,3326999,20.495860153023727,37.05655091263874,0.08002449761563124,2169.9196977615356,260.3521251678467,1741.1308374404907,13587,3341,10246,10246,0,31,3327000.0
3327,3327999,20.49736248425116,37.06074303594288,0.08012381017793624,2170.6745483875275,260.419912815094,1740.472809791565,13598,3345,10253,10253,0,31,3328000.0
3328,3328999,20.499515125258146,37.067050488856836,0.08021023682585382,2171.061757326126,260.4887537956238,1742.1072473526,13600,3346,10254,10254,0,31,3329000.0
3329,3329999,20.50153688165224,37.069448172174226,0.08026641458877781,2171.5490398406982,260.55407214164734,1743.2706384658813,13606,3347,10259,10259,0,31,3330000.0
3330,3330999,20.503779599484368,37.073957736333874,0.08036241878235773,2172.3387167453766,260.62724804878235,1742.817452430725,13610,3349,10261,10261,0,31,3331000.0
3331,3331999,20.5057934308266,37.07634720258686,0.08041195207426899,2172.9118473529816,260.6946506500244,1743.3782892227173,13614,3351,10263,10263,0,31,3332000.0
3332,3332999,20.507911732493067,37.08158895052756,0.08045152845079373,2173.8818788528442,260.7641553878784,1742.3205270767212,13616,3352,10264,10264,0,31,3333000.0
3333,3333999,20.50939636873667,37.0825997248076,0.08051792614974917,2174.595149040222,260.8337969779968,1742.119236946106,13619,3353,10266,10266,0,31,3334000.0
3334,3334999,20.510144504230155,37.0864804150692,0.08052279302871623,2175.281076669693,260.90098333358765,1742.373028755188,13641,3354,10287,10287,0,31,3335000.0
3335,3335999,20.509165013003255,37.08558419037019,0.08047903759076092,2175.649077653885,260.96898007392883,1744.2392625808716,13646,3354,10292,10292,0,31,3336000.0
3336,3336999,20.507333833130577,37.082582810602695,0.08047012563423717,2176.3403980731964,261.0361752510071,1744.569073677063,13647,3354,10293,10293,0,31,3337000.0
3337,3337999,20.505645181402688,37.079365918871034,0.08046054673138237,2176.7083761692047,261.10393738746643,1746.2293672561646,13653,3356,10297,10297,0,31,3338000.0
3338,3338999,20.50474596354917,37.07806582550497,0.08043364275496212,2177.1576442718506,261.1719591617584,1748.0022859573364,13654,3356,10298,10298,0,31,3339000.0
3339,3339999,20.503134773218463,37.07490758112544,0.08041964848950311,2177.800655603409,261.24147486686707,1748.3549242019653,13660,3359,10301,10301,0,31,3340000.0
3340,3340999,20.502046199257165,37.07378727523905,0.08039934353456957,2178.385900735855,261.3138680458069,1748.952763557434,13664,3361,10303,10303,0,31,3341000.0
3341,3341999,20.500898046287954,37.0714118634716,0.08038561524810084,2179.084630012512,261.382648229599,1749.0030488967896,13666,3362,10304,10304,0,31,3342000.0
3342,3342999,20.50005438461552,37.06924137978,0.08036855626209483,2179.373018026352,261.4510991573334,1751.1363649368286,13668,3363,10305,10305,0,31,3343000.0
3343,3343999,20.499964591414408,37.06933420307819,0.08034733058629895,2180.328087091446,261.5208144187927,1750.2855882644653,13670,3364,10306,10306,0,31,3344000.0
3344,3344999,20.499997274642286,37.06868387368284,0.08033385472200416,2180.8482246398926,261.5900077819824,1751.3686265945435,13670,3364,10306,10306,0,31,3345000.0
3345,3345999,20.501170272033946,37.07169522028839,0.08032743598259728,2181.530589580536,261.6584315299988,1751.634488105774,13673,3365,10308,10308,0,31,3346000.0
3346,3346999,20.50356444394737,37.0772666782998,0.08030726004484112,2182.08998298645,261.72920393943787,1752.1606798171997,13684,3368,10316,10316,0,31,3347000.0
3347,3347999,20.506072118210312,37.081908032707624,0.08029029216869255,2182.78475689888,261.797842502594,1752.094075202942,13688,3370,10318,10318,0,31,3348000.0
3348,3348999,20.508920685316678,37.087089871408764,0.08031092806524853,2183.6389117240906,261.8670847415924,1750.9899797439575,13692,3372,10320,10320,0,31,3349000.0
3349,3349999,20.51292807229124,37.09607408077325,0.08030897474670895,2184.7425491809845,261.94239830970764,1748.7190980911255,13698,3375,10323,10323,0,31,3350000.0
3350,3350999,20.51763147896654,37.10500224060861,0.08033512754488836,2185.3332953453064,262.01331639289856,1749.3373155593872,13700,3376,10324,10324,0,31,3351000.0
3351,3351999,20.52220040373802,37.12067196364941,0.08035750644740602,2185.816895008087,262.08339762687683,1750.395977973938,13704,3378,10326,10326,0,31,3352000.0
3352,3352999,20.525847079328464,37.127551267961515,0.08038381465361322,2186.4385476112366,262.15316224098206,1750.9031343460083,13706,3379,10327,10327,0,31,3353000.0
3353,3353999,20.529803333025214,37.13507014131819,0.08040637360183289,2187.010469198227,262.22702169418335,1751.9638872146606,13723,3380,10343,10343,0,31,3354000.0
3354,3354999,20.532359524208097,37.13735628708146,0.08043354550495263,2187.729665517807,262.29759430885315,1752.0350313186646,13725,3381,10344,10344,0,31,3355000.0
3355,3355999,20.53344048329236,37.13816288898701,0.08044198096473298,2188.116129398346,262.36527395248413,1753.826642036438,13741,3382,10359,10359,0,31,3356000.0
3356,3356999,20.532880456465648,37.13678818540445,0.08041564310548699,2188.685963153839,262.43167304992676,1754.4663972854614,13751,3383,10368,10368,0,31,3357000.0
3357,3357999,20.532688366317927,37.137845847300575,0.08038400503579224,2189.055412054062,262.49926114082336,1756.1668977737427,13756,3384,10372,10372,0,31,3358000.0
3358,3358999,20.532463757172028,37.136938909833276,0.08035617689822083,2189.5243258476257,262.5656063556671,1757.4551820755005,13761,3385,10376,10376,0,31,3359000.0
3359,3359999,20.531661935116734,37.13430564528683,0.0803313599689709,2190.109691143036,262.6324791908264,1758.0684175491333,13764,3386,10378,10378,0,31,3360000.0
3360,3360999,20.531001926744853,37.13192932434092,0.08030963330225294,2190.9934973716736,262.7035610675812,1757.0019273757935,13772,3390,10382,10382,0,31,3361000.0
3361,3361999,20.530794871978348,37.1304721766487,0.08028881760934758,2191.6440036296844,262.77409958839417,1756.8875856399536,13781,3394,10387,10387,0,31,3362000.0
3362,3362999,20.53010760786658,37.12837981337095,0.08027670947962728,2192.043028116226,262.8434910774231,1758.5003633499146,13783,3395,10388,10388,0,31,3363000.0
3363,3363999,20.52977437295046,37.12847069272862,0.08024900892466436,2192.6409573554993,262.91293144226074,1759.2186784744263,13783,3395,10388,10388,0,31,3364000.0
3364,3364999,20.52920451471366,37.12706112121082,0.08022945737211651,2193.347639799118,262.98070549964905,1759.406865119934,13786,3396,10390,10390,0,31,3365000.0
3365,3365999,20.529262090040756,37.12599556541881,0.08021202614429779,2194.508609056473,263.04989743232727,1756.8502321243286,13802,3400,10402,10402,0,31,3366000.0
3366,3366999,20.530463971027082,37.13268162363373,0.08017439469714938,2195.1349523067474,263.1202688217163,1757.442494392395,13802,3400,10402,10402,0,31,3367000.0
3367,3367999,20.53312253121366,37.14240729203769,0.08012392393988488,2195.443460702896,263.18926787376404,1759.5663805007935,13802,3400,10402,10402,0,31,3368000.0
3368,3368999,20.537220607909383,37.15098802771709,0.08009246596097286,2196.0661346912384,263.2629315853119,1760.2455339431763,13802,3400,10402,10402,0,31,3369000.0
3369,3369999,20.541547034295306,37.16285312278283,0.08008059741930917,2196.7676734924316,263.3324964046478,1759.8898134231567,13823,3403,10420,10420,0,31,3370000.0
3370,3370999,20.548530793937033,37.18436906342114,0.08004463497377268,2197.0837881565094,263.40125155448914,1762.1074953079224,13823,3403,10420,10420,0,31,3371000.0
3371,3371999,20.55783430648351,37.211172485521864,0.08006075549476821,2198.122901916504,263.4697439670563,1760.5547761917114,13825,3404,10421,10421,0,31,3372000.0
3372,3372999,20.566931422614196,37.237804875372554,0.08014037011642139,2198.884770154953,263.5385892391205,1760.1433839797974,13831,3407,10424,10424,0,31,3373000.0
3373,3373999,20.575568057530038,37.25972033908457,0.08022825192679306,2199.1895418167114,263.60509610176086,1762.285626411438,13831,3407,10424,10424,0,31,3374000.0
3374,3374999,20.584059093010925,37.27773497817931,0.08035105797745123,2199.8978266716003,263.6733558177948,1762.6256456375122,13831,3407,10424,10424,0,31,3375000.0
3375,3375999,20.591289681499894,37.29266515385566,0.08050418972452089,2200.638821363449,263.74591994285583,1762.662449836731,13831,3407,10424,10424,0,31,3376000.0
3376,3376999,20.594859834011597,37.30051922002929,0.08049510205893018,2201.1936044692993,263.81372690200806,1763.402844429016,13862,3409,10453,10453,0,31,3377000.0
3377,3377999,20.59474270222198,37.300818176263725,0.0804785387021435,2201.440136909485,263.8854501247406,1765.8514909744263,13880,3410,10470,10470,0,31,3378000.0
3378,3378999,20.594735725322316,37.30178758936147,0.08046250175844305,2201.801825284958,263.95517206192017,1767.7614259719849,13884,3410,10474,10474,0,31,3379000.0
3379,3379999,20.596162899134857,37.30636136211895,0.08044822104755789,2202.12872838974,264.0318465232849,1769.5409669876099,13889,3411,10478,10478,0,31,3380000.0
3380,3380999,20.59725106728846,37.313283545241774,0.08042450096749132,2202.58677816391,264.1020007133484,1770.5316896438599,13896,3414,10482,10482,0,31,3381000.0
3381,3381999,20.597627835104582,37.31309199931764,0.08044851283487964,2203.144769668579,264.17449736595154,1771.5400743484497,13900,3416,10484,10484,0,31,3382000.0
3382,3382999,20.59855365203619,37.314395164264916,0.0804962184753546,2203.6352019309998,264.249813079834,1772.7694673538208,13902,3417,10485,10485,0,31,3383000.0
3383,3383999,20.599614668711965,37.31505165739833,0.08051539492792381,2204.346176624298,264.3211030960083,1772.900357246399,13903,3417,10486,10486,0,31,3384000.0
3384,3384999,20.600378681218825,37.31547718334568,0.08053486368597018,2204.9366800785065,264.39328956604004,1773.5739793777466,13905,3418,10487,10487,0,31,3385000.0
3385,3385999,20.60058768564296,37.31499204308339,0.08056545930981973,2205.7748589515686,264.4683430194855,1772.9485750198364,13907,3419,10488,10488,0,31,3386000.0
3386,3386999,20.60163636781828,37.31543462204761,0.08061430151824966,2206.535220384598,264.5460424423218,1772.618489265442,13913,3422,10491,10491,0,31,3387000.0
3387,3387999,20.60204884385851,37.31431989094396,0.08064694308929599,2207.030276298523,264.6190559864044,1773.729458808899,13915,3423,10492,10492,0,31,3388000.0
3388,3388999,20.60336178665387,37.315799385108214,0.08066437209035981,2207.525592327118,264.6913788318634,1774.8449983596802,13917,3424,10493,10493,0,31,3389000.0
3389,3389999,20.604393383870537,37.3166068519147,0.08070667218359373,2208.3184418678284,264.76302576065063,1774.3824281692505,13919,3425,10494,10494,0,31,3390000.0
3390,3390999,20.605341867266784,37.31655275478741,0.08072743940065474,2208.9149096012115,264.8379228115082,1774.817868232727,13926,3427,10499,10499,0,31,3391000.0
3391,3391999,20.60681785285356,37.319758575243036,0.08076187187286776,2209.6278471946716,264.9117088317871,1774.8974351882935,13926,3427,10499,10499,0,31,3392000.0
3392,3392999,20.60818620491638,37.32037777800411,0.08078489426191315,2210.20859003067,264.98342061042786,1775.701512336731,13943,3428,10515,10515,0,31,3393000.0
3393,3393999,20.609477838446562,37.321139565087506,0.0807959010830952,2211.2039833068848,265.056765794754,1774.5740327835083,13943,3428,10515,10515,0,31,3394000.0
3394,3394999,20.610461911545247,37.32080006580684,0.08080570966717049,2211.877744436264,265.12814569473267,1774.57848072052,13947,3430,10517,10517,0,31,3395000.0
3395,3395999,20.611373806889347,37.31974293037692,0.08083503314725171,2212.5423307418823,265.20018339157104,1774.6561937332153,13951,3432,10519,10519,0,31,3396000.0
3396,3396999,20.61178628095221,37.32075964332401,0.08083972456469879,2213.068682909012,265.2723078727722,1775.8063249588013,13951,3432,10519,10519,0,31,3397000.0
3397,3397999,20.611340238818315,37.323398002496376,0.08082036008825266,2213.770222425461,265.3461663722992,1776.083249092102,13966,3432,10534,10534,0,31,3398000.0
3398,3398999,20.609467816020263,37.32303042170062,0.0808105185199679,2214.3468811511993,265.4172191619873,1776.8053560256958,13971,3433,10538,10538,0,31,3399000.0
3399,3399999,20.60699989415269,37.3194920941242,0.08081822876006495,2214.9287745952606,265.4891240596771,1777.5137071609497,14003,3434,10569,10569,0,31,3400000.0
3400,3400999,20.604718397443666,37.31688990061386,0.08081864795147475,2215.6228239536285,265.56043553352356,1777.641194343567,14008,3435,10573,10573,0,31,3401000.0
3401,3401999,20.602433258460174,37.3135395736718,0.08082215450258023,2225.5746245384216,265.63145542144775,1778.698124885559,14019,3437,10582,10582,0,31,3402000.0
3402,3402999,20.60036582801009,37.31161683993982,0.08081573235068196,2226.215849161148,265.70211005210876,1779.278889656067,14021,3438,10583,10583,0,31,3403000.0
3403,3403999,20.59820318038284,37.30802605274064,0.08081812334853566,2226.910978078842,265.7753129005432,1779.6210298538208,14021,3438,10583,10583,0,31,3404000.0
3404,3404999,20.596061589598452,37.30435954909167,0.08082161919801922,2227.305000305176,265.8473107814789,1781.2239198684692,14023,3439,10584,10584,0,31,3405000.0
3405,3405999,20.593809338458495,37.300382141365745,0.08082396713798456,2227.916759490967,265.92062497138977,1781.8246965408325,14023,3439,10584,10584,0,31,3406000.0
3406,3406999,20.592682039067853,37.29927365646955,0.0808078209889237,2228.71120929718,265.99339032173157,1781.3259172439575,14031,3441,10590,10590,0,31,3407000.0
3407,3407999,20.591584728991144,37.29680583690842,0.08079585957918056,2229.4660263061523,266.0657756328583,1781.1278810501099,14033,3442,10591,10591,0,31,3408000.0
3408,3408999,20.59042194228985,37.29445348457397,0.0807833159077388,2230.1029846668243,266.13974261283875,1781.7249422073364,14033,3442,10591,10591,0,31,3409000.0
3409,3409999,20.590261356277257,37.29532622834461,0.0807526918699758,2230.6214187145233,266.21296525001526,1782.808117866516,14033,3442,10591,10591,0,31,3410000.0
3410,3410999,20.58954428755966,37.29382657461073,0.0807329050501231,2231.3095223903656,266.284286737442,1782.9508256912231,14035,3443,10592,10592,0,31,3411000.0
3411,3411999,20.58989683655404,37.29392407532503,0.08070574645147766,2232.2418847084045,266.35804200172424,1781.8267793655396,14037,3444,10593,10593,0,31,3412000.0
3412,3412999,20.591168263319744,37.30011130253534,0.08065991776105408,2232.8408858776093,266.4344141483307,1782.194447517395,14055,3446,10609,10609,0,31,3413000.0
3413,3413999,20.59338767530851,37.30553927949954,0.08065465771090896,2233.5248272418976,266.50572872161865,1782.2215547561646,14058,3448,10610,10610,0,31,3414000.0
3414,3414999,20.597052257759852,37.31742126454316,0.08062236828917768,2234.2121810913086,266.5793619155884,1782.680172920227,14058,3448,10610,10610,0,31,3415000.0
3415,3415999,20.60074450418686,37.324751461507354,0.08063895157331147,2234.918889284134,266.651349067688,1782.745129585266,14075,3449,10626,10626,0,31,3416000.0
3416,3416999,20.604453134646178,37.33357406266834,0.08064773457180252,2235.644157886505,266.7248182296753,1782.7135515213013,14077,3450,10627,10627,0,31,3417000.0
3417,3417999,20.608246995535602,37.34101653969107,0.08068724357548929,2236.2887539863586,266.79721570014954,1783.2094240188599,14077,3450,10627,10627,0,31,3418000.0
3418,3418999,20.610077605360676,37.34389754068517,0.08065591561155472,2236.9735853672028,266.86778807640076,1783.64732837677,14088,3450,10638,10638,0,31,3419000.0
3419,3419999,20.608325150981297,37.34295217029631,0.08064239477706914,2237.3196437358856,266.9368669986725,1785.4552507400513,14099,3451,10648,10648,0,31,3420000.0
3420,3420999,20.606408005391728,37.342206090976525,0.08062928378276213,2237.793678045273,267.005863904953,1786.635724067688,14099,3451,10648,10648,0,31,3421000.0
3421,3421999,20.60493101689737,37.34119854431928,0.08061256754331059,2238.370220899582,267.07544326782227,1787.2636156082153,14103,3452,10651,10651,0,31,3422000.0
3422,3422999,20.602992116227703,37.33840955001592,0.08060817350444416,2238.9800760746,267.1472313404083,1787.8869905471802,14104,3452,10652,10652,0,31,3423000.0
3423,3423999,20.601113667605464,37.33543898340304,0.08060279535410975,2239.732275247574,267.21691823005676,1787.6147661209106,14108,3454,10654,10654,0,31,3424000.0
3424,3424999,20.59924362492272,37.33230891466451,0.0806006188533176,2240.4993867874146,267.29016971588135,1787.4461336135864,14110,3455,10655,10655,0,31,3425000.0
3425,3425999,20.597319449301065,37.329297415738516,0.08059830331423279,2241.3880007267,267.3582170009613,1786.5769701004028,14110,3455,10655,10655,0,31,3426000.0
3426,3426999,20.59587597048996,37.32755732930042,0.08058505589661913,2241.8571960926056,267.4279065132141,1787.4905214309692,14112,3457,10655,10655,0,31,3427000.0
3427,3427999,20.59447421801132,37.324827799024035,0.08058073752577344,2242.3749873638153,267.5016622543335,1788.6429262161255,14112,3457,10655,10655,0,31,3428000.0
3428,3428999,20.593533883188854,37.326732300796444,0.08055466105099351,2242.927393913269,267.57454800605774,1789.5459184646606,14112,3457,10655,10655,0,31,3429000.0
3429,3429999,20.59289853276013,37.325325988614075,0.08054281328381097,2243.6428582668304,267.64675092697144,1789.6099214553833,14112,3457,10655,10655,0,31,3430000.0
3430,3430999,20.59210582858419,37.32347461991333,0.08053030855611265,2244.4149289131165,267.7205204963684,1789.32652759552,14114,3458,10656,10656,0,31,3431000.0
3431,3431999,20.5922152929936,37.32333872084508,0.08051277294364068,2245.0351979732513,267.79267621040344,1790.022686958313,14114,3458,10656,10656,0,31,3432000.0
3432,3432999,20.59329883772054,37.32686246877593,0.08048227257700868,2245.741416454315,267.86626648902893,1790.0328874588013,14118,3459,10659,10659,0,31,3433000.0
3433,3433999,20.594668746928786,37.329718614406936,0.08045998990608061,2246.4568507671356,267.93941354751587,1790.034291267395,14120,3460,10660,10660,0,31,3434000.0
3434,3434999,20.596242585752538,37.33104953085701,0.08044789778065242,2247.140711545944,268.0120677947998,1789.9939165115356,14122,3462,10660,10660,0,31,3435000.0
3435,3435999,20.598072451389083,37.331979255685724,0.08043938196598177,2247.7193796634674,268.08645582199097,1790.519055366516,14126,3464,10662,10662,0,31,3436000.0
3436,3436999,20.60046125521178,37.33394761102398,0.08043106804789368,2248.2220542430878,268.16023325920105,1791.6090440750122,14128,3465,10663,10663,0,31,3437000.0
3437,3437999,20.60277625133052,37.33813865386175,0.08042529438523727,2248.8269531726837,268.2346498966217,1792.2110567092896,14130,3466,10664,10664,0,31,3438000.0
3438,3438999,20.604449445709523,37.33844066666791,0.08043593222395673,2249.3249361515045,268.3081805706024,1793.2175493240356,14132,3467,10665,10665,0,31,3439000.0
3439,3439999,20.605060707622865,37.33700163636983,0.08043555239004674,2250.2423992156982,268.38100361824036,1792.3037996292114,14132,3467,10665,10665,0,31,3440000.0
3440,3440999,20.603752731989296,37.33445737234079,0.08042025064798397,2250.402863740921,268.44942355155945,1795.3213319778442,14156,3467,10689,10689,0,31,3441000.0
3441,3441999,20.601670390910346,37.330879756310246,0.08042869152621068,2250.785405397415,268.5176079273224,1797.0333604812622,14166,3468,10698,10698,0,31,3442000.0
3442,3442999,20.599541764799884,37.3273358799998,0.0804380291424881,2251.158496618271,268.5844957828522,1798.9034547805786,14167,3468,10699,10699,0,31,3443000.0
3443,3443999,20.597428385308742,37.323868961013765,0.08044083617702136,2251.6232686042786,268.65266585350037,1800.1885271072388,14171,3469,10702,10702,0,31,3444000.0
3444,3444999,20.595523888070154,37.32131515261673,0.0804397952248439,2252.3900084495544,268.72099709510803,1800.4842653274536,14171,3469,10702,10702,0,31,3445000.0
3445,3445999,20.593734820786338,37.31946200052006,0.08043427620702304,2253.1503689289093,268.7903380393982,1800.3677644729614,14175,3471,10704,10704,0,31,3446000.0
3446,3446999,20.59176065758583,37.3163970102269,0.08043713015900278,2253.8103811740875,268.85962891578674,1800.3990297317505,14181,3474,10707,10707,0,31,3447000.0
3447,3447999,20.59000648020377,37.315770581114656,0.08042399955701163,2254.101321220398,268.92635202407837,1802.3910036087036,14183,3475,10708,10708,0,31,3448000.0
3448,3448999,20.58868069470268,37.317597177306595,0.08040172960065362,2254.7897384166718,268.9950156211853,1802.1594514846802,14189,3478,10711,10711,0,31,3449000.0
3449,3449999,20.587303304451222,37.31636471883042,0.08039020699668165,2254.987242937088,269.0624167919159,1804.8612642288208,14189,3478,10711,10711,0,31,3450000.0
3450,3450999,20.58622617128942,37.31968491127492,0.08035652581288444,2255.3967282772064,269.1303987503052,1806.4979829788208,14206,3479,10727,10727,0,31,3451000.0
3451,3451999,20.58491749436012,37.31708543429271,0.08035424682484693,2256.2086975574493,269.19972467422485,1805.8055543899536,14210,3481,10729,10729,0,31,3452000.0
3452,3452999,20.58380562300376,37.31489324630597,0.08034823331782126,2256.9127838611603,269.27010345458984,1806.1894121170044,14212,3482,10730,10730,0,31,3453000.0
3453,3453999,20.582869782526515,37.31271303544883,0.08034346922800228,2258.008639574051,269.33879351615906,1804.416958808899,14212,3482,10730,10730,0,31,3454000.0
3454,3454999,20.58160484974284,37.3097955656421,0.08034604029021397,2258.732033967972,269.4072890281677,1804.5258531570435,14212,3482,10730,10730,0,31,3455000.0
3455,3455999,20.58023053599778,37.30664705856409,0.08034734208163408,2259.340667963028,269.4747214317322,1805.1182985305786,14212,3482,10730,10730,0,31,3456000.0
3456,3456999,20.578986853580545,37.30394811055949,0.0803458234223221,2259.8149218559265,269.545658826828,1806.1481370925903,14216,3484,10732,10732,0,31,3457000.0
3457,3457999,20.577999430348527,37.301034084319845,0.08034301556408374,2260.2198276519775,269.6147313117981,1807.7378206253052,14216,3484,10732,10732,0,31,3458000.0
3458,3458999,20.57668439563912,37.298200025684764,0.08033731798339083,2260.8879733085632,269.68336296081543,1808.1345872879028,14227,3485,10742,10742,0,31,3459000.0
3459,3459999,20.57487146081944,37.29618541596014,0.08032385567826084,2261.0348081588745,269.75173330307007,1811.1840257644653,14251,3485,10766,10766,0,31,3460000.0
3460,3460999,20.57305780480918,37.29691139411308,0.08031650585605887,2261.396807193756,269.8197457790375,1813.0725679397583,14254,3485,10769,10769,0,31,3461000.0
3461,3461999,20.570908558329837,37.29389030336456,0.08033158199692247,2261.783214330673,269.8877694606781,1814.8184022903442,14256,3485,10771,10771,0,31,3462000.0
3462,3462999,20.568586426550183,37.29020405475879,0.08034310884360396,2262.5156795978546,269.9556725025177,1814.4856691360474,14263,3488,10775,10775,0,31,3463000.0
3463,3463999,20.566757665587744,37.28913171494928,0.08033989320290313,2262.720705509186,270.02497458457947,1817.2317171096802,14264,3488,10776,10776,0,31,3464000.0
3464,3464999,20.564645117800875,37.28643877868111,0.08034337655563395,2263.469062566757,270.0936005115509,1816.6853914260864,14272,3492,10780,10780,0,31,3465000.0
3465,3465999,20.56265839334923,37.28382473946676,0.0803444072802667,2264.283564567566,270.16218996047974,1816.3314180374146,14276,3494,10782,10782,0,31,3466000.0
3466,3466999,20.560990287760703,37.28124039561016,0.08033942423780849,2264.736501455307,270.23122215270996,1817.6569185256958,14278,3495,10783,10783,0,31,3467000.0
3467,3467999,20.559540221272744,37.27857032756576,0.08033677697620678,2264.9270515441895,270.29831767082214,1820.3423585891724,14278,3495,10783,10783,0,31,3468000.0
3468,3468999,20.558023961679165,37.276047887260184,0.08032695916270105,2265.3153121471405,270.3673596382141,1821.9591188430786,14280,3496,10784,10784,0,31,3469000.0
3469,3469999,20.557222115982025,37.27846197933219,0.0802941105995475,2265.828590631485,270.4358687400818,1823.0789003372192,14280,3496,10784,10784,0,31,3470000.0
3470,3470999,20.556567652827614,37.278334514115336,0.08027287792439919,2266.7211434841156,270.5048313140869,1822.2321138381958,14282,3497,10785,10785,0,31,3471000.0
3471,3471999,20.555739158795415,37.276869492400444,0.08025512097765253,2267.4052822589874,270.5762026309967,1821.9960680007935,14288,3500,10788,10788,0,31,3472000.0
3472,3472999,20.555042726970292,37.274803908807726,0.08024674338648452,2268.302092075348,270.6466414928436,1821.1590852737427,14292,3502,10790,10790,0,31,3473000.0
3473,3473999,20.554455528085203,37.2732484505142,0.08023031322418528,2268.965601682663,270.71561217308044,1821.426739692688,14294,3503,10791,10791,0,31,3474000.0
3474,3474999,20.554280639578923,37.27235890966923,0.08020985041430839,2269.4384047985077,270.7841989994049,1822.4779863357544,14298,3505,10793,10793,0,31,3475000.0
3475,3475999,20.55456571433992,37.27230470178355,0.08018305994110186,2269.9477684497833,270.8517355918884,1823.5896654129028,14298,3505,10793,10793,0,31,3476000.0
3476,3476999,20.55465321077147,37.27130310281217,0.08016299693053852,2270.74520778656,270.9230332374573,1823.1045198440552,14300,3506,10794,10794,0,31,3477000.0
3477,3477999,20.554770559014234,37.27034742183405,0.08014430159877595,2271.126522541046,270.9898452758789,1824.6873216629028,14302,3507,10795,10795,0,31,3478000.0
3478,3478999,20.554256989080134,37.26833387053518,0.0801305053703002,2271.9234647750854,271.0602443218231,1823.9016618728638,14306,3509,10797,10797,0,31,3479000.0
3479,3479999,20.55314473200557,37.26613540170885,0.08010311263383108,2272.2798144817352,271.1293022632599,1825.8944215774536,14334,3510,10824,10824,0,31,3480000.0
3480,3480999,20.550868433098493,37.26275625985737,0.08009142244337553,2272.442725419998,271.19628643989563,1828.760724067688,14337,3510,10827,10827,0,31,3481000.0
3481,3481999,20.548864663857408,37.25983401228456,0.0800877990054325,2272.8172705173492,271.2654583454132,1830.482274055481,14342,3511,10831,10831,0,31,3482000.0
3482,3482999,20.54752243449196,37.25812857486884,0.0800758040827112,2273.273299217224,271.3319411277771,1831.602879524231,14347,3513,10834,10834,0,31,3483000.0
3483,3483999,20.545857256690407,37.25729218408519,0.08005708317259541,2273.9801807403564,271.40063738822937,1831.7820482254028,14353,3515,10838,10838,0,31,3484000.0
3484,3484999,20.544717464181925,37.256244947412796,0.08004172990478164,2274.436434984207,271.4691917896271,1833.210087776184,14355,3516,10839,10839,0,31,3485000.0
3485,3485999,20.543819391592567,37.25420691574557,0.080028398558051,2275.090348005295,271.5404829978943,1833.1810121536255,14363,3519,10844,10844,0,31,3486000.0
3486,3486999,20.543884305190154,37.25464337768023,0.08000306070833485,2275.6605565547943,271.60867285728455,1833.622197151184,14371,3522,10849,10849,0,31,3487000.0
3487,3487999,20.544607305927155,37.25575624000863,0.0799837881810348,2276.178691625595,271.6763849258423,1834.4744691848755,14373,3523,10850,10850,0,31,3488000.0
3488,3488999,20.546194710079455,37.259420858655176,0.07997067935016011,2276.7993047237396,271.74616503715515,1834.7191286087036,14377,3525,10852,10852,0,31,3489000.0
3489,3489999,20.54897386753848,37.26647650003069,0.07994335156782606,2277.641049861908,271.81476402282715,1834.167950630188,14387,3528,10859,10859,0,31,3490000.0
3490,3490999,20.552494237262408,37.273924727005316,0.07992157803248867,2278.136606693268,271.8871886730194,1835.4748735427856,14387,3528,10859,10859,0,31,3491000.0
3491,3491999,20.556956847336195,37.2826591957673,0.07995556273952531,2278.814553499222,271.9574341773987,1835.5394945144653,14391,3530,10861,10861,0,31,3492000.0
3492,3492999,20.562021432189937,37.29147019932835,0.08003543157614756,2279.2192528247833,272.02760338783264,1837.2011003494263,14395,3531,10864,10864,0,31,3493000.0
3493,3493999,20.5671220597019,37.30000210020161,0.08009939222525075,2279.5963525772095,272.09802412986755,1838.976414680481,14397,3532,10865,10865,0,31,3494000.0
3494,3494999,20.57365432067293,37.313442423077085,0.080214807517893,2280.2179877758026,272.16702103614807,1839.167088508606,14401,3534,10867,10867,0,31,3495000.0
3495,3495999,20.580737801516715,37.32696185410211,0.08040813576556294,2281.3718979358673,272.23823833465576,1836.7519044876099,14409,3538,10871,10871,0,31,3496000.0
3496,3496999,20.586834988043794,37.33816296450208,0.08062868275175294,2281.953586101532,272.3094003200531,1837.4284257888794,14412,3539,10873,10873,0,31,3497000.0
3497,3497999,20.59162816376232,37.34734521627191,0.08077917196917794,2282.5131452083588,272.37928771972656,1838.4310655593872,14414,3540,10874,10874,0,31,3498000.0
3498,3498999,20.597879464029162,37.3573615018755,0.08094311990557534,2283.213745355606,272.4475951194763,1838.8571062088013,14414,3540,10874,10874,0,31,3499000.0
3499,3499999,20.603099673767183,37.36708480094801,0.0810449729518703,2283.8278992176056,272.5167453289032,1839.5467653274536,14414,3540,10874,10874,0,31,3500000.0
3500,3500999,20.602597714930063,37.365726743900915,0.08100781091546905,2284.2023565769196,272.585001707077,1841.5558061599731,14437,3540,10897,10897,0,31,3501000.0
3501,3501999,20.601603560433823,37.36434018292089,0.08098340444228969,2284.478182554245,272.652795791626,1843.8191347122192,14440,3540,10900,10900,0,31,3502000.0
3502,3502999,20.60117770269517,37.363706173147754,0.08096999008596117,2284.8344554901123,272.71947026252747,1845.5137453079224,14449,3542,10907,10907,0,31,3503000.0
3503,3503999,20.60075211442934,37.362738038151434,0.08095301218670092,2285.3507883548737,272.7856333255768,1846.7227067947388,14453,3543,10910,10910,0,31,3504000.0
3504,3504999,20.599781246631913,37.361246614225784,0.08093850572817518,2286.177826166153,272.8538384437561,1845.9161882400513,14480,3547,10933,10933,0,31,3505000.0
3505,3505999,20.599132335933202,37.3594834317541,0.08092602653958181,2286.735600709915,272.921480178833,1846.546887397766,14488,3550,10938,10938,0,31,3506000.0
3506,3506999,20.598636030758,37.360920801788104,0.08089546922548196,2287.2366116046906,272.9904773235321,1847.6465120315552,14490,3551,10939,10939,0,31,3507000.0
3507,3507999,20.598481935849605,37.36085608154182,0.08087652778621013,2288.1037781238556,273.05981516838074,1846.7647523880005,14494,3553,10941,10941,0,31,3508000.0
3508,3508999,20.598176382265883,37.3601145976615,0.08086966992079125,2288.4072427749634,273.12749314308167,1848.9177141189575,14494,3553,10941,10941,0,31,3509000.0
3509,3509999,20.600365487264494,37.367913925711704,0.08084211185890455,2289.0238738059998,273.19692492485046,1849.5130968093872,14504,3555,10949,10949,0,31,3510000.0
3510,3510999,20.6040574417855,37.37974191693935,0.08082619166771421,2289.6420238018036,273.2669246196747,1850.26305103302,14504,3555,10949,10949,0,31,3511000.0
3511,3511999,20.610054285859814,37.40021746571371,0.08086197330142209,2290.6190533638,273.33585929870605,1848.6094331741333,14536,3559,10977,10977,0,31,3512000.0
3512,3512999,20.615001405509517,37.412883765987765,0.08092341572043671,2291.225430250168,273.40531730651855,1848.7481203079224,14542,3562,10980,10980,0,31,3513000.0
3513,3513999,20.62084734194487,37.42875403127083,0.08099130510458674,2292.2377712726593,273.47649359703064,1846.9181642532349,14561,3567,10994,10994,0,31,3514000.0
3514,3514999,20.626310587971414,37.4485239435188,0.08103843520276077,2292.8658452033997,273.5486249923706,1847.644856452942,14561,3567,10994,10994,0,31,3515000.0
3515,3515999,20.63098198416264,37.4579261979827,0.08110958640595567,2293.7850737571716,273.6189239025116,1846.0880708694458,14569,3571,10998,10998,0,31,3516000.0
3516,3516999,20.636215340590702,37.46919166863835,0.08120495180481246,2294.1055579185486,273.6896336078644,1848.2755403518677,14569,3571,10998,10998,0,31,3517000.0
3517,3517999,20.64123742819657,37.479479806196444,0.08128373208530892,2294.5183086395264,273.7572281360626,1849.8948183059692,14569,3571,10998,10998,0,31,3518000.0
3518,3518999,20.64569474921135,37.486672568941444,0.08134799540951376,2295.050374507904,273.8282859325409,1851.0411195755005,14569,3571,10998,10998,0,31,3519000.0
3519,3519999,20.648516973751832,37.49021381645294,0.08139189844434025,2296.069080591202,273.9005525112152,1849.462010383606,14573,3573,11000,11000,0,31,3520000.0
3520,3520999,20.648371711654974,37.489585009745475,0.08138160444340437,2296.62438082695,273.9697403907776,1850.2540941238403,14593,3575,11018,11018,0,31,3521000.0
3521,3521999,20.647176753785683,37.488563563117864,0.08138071392114232,2297.1244616508484,274.0445668697357,1851.6044435501099,14596,3575,11021,11021,0,31,3522000.0
3522,3522999,20.646403411803846,37.488987791084185,0.0813593301708917,2297.630526781082,274.11432790756226,1852.6767091751099,14604,3576,11028,11028,0,31,3523000.0
3523,3523999,20.646357580660393,37.49181093226156,0.08133864573251948,2298.219845533371,274.18316173553467,1853.4078035354614,14604,3576,11028,11028,0,31,3524000.0
3524,3524999,20.64546102238124,37.49003326543981,0.0813433107250986,2298.7937400341034,274.25490522384644,1853.9042482376099,14610,3578,11032,11032,0,31,3525000.0
3525,3525999,20.644959063768205,37.489225928000266,0.08134449401926624,2299.458195924759,274.33001804351807,1853.9474382400513,14616,3581,11035,11035,0,31,3526000.0
3526,3526999,20.64397284926397,37.487067301982684,0.08134594267249928,2300.049808740616,274.4035475254059,1854.555256843567,14641,3582,11059,11059,0,31,3527000.0
3527,3527999,20.643419515755113,37.48578578921905,0.08135111000940931,2300.655347108841,274.4752142429352,1855.0791368484497,14643,3583,11060,11060,0,31,3528000.0
3528,3528999,20.643819205968132,37.487632193704854,0.0813458406636488,2301.05646777153,274.54836106300354,1856.5886507034302,14644,3584,11060,11060,0,31,3529000.0
3529,3529999,20.646555769213165,37.49700367022563,0.08131800432924474,2301.665036678314,274.6196298599243,1857.2131624221802,14644,3584,11060,11060,0,31,3530000.0
3530,3530999,20.649715388102013,37.50494199444474,0.08133821674493458,2302.565140247345,274.69173669815063,1856.2418031692505,14646,3585,11061,11061,0,31,3531000.0
3531,3531999,20.65488508807566,37.52025694161672,0.08139696425169074,2303.2732310295105,274.7638201713562,1856.3764925003052,14646,3585,11061,11061,0,31,3532000.0
3532,3532999,20.661790102375303,37.53751042965757,0.0814708140943764,2303.8698801994324,274.83912229537964,1856.7936143875122,14649,3587,11062,11062,0,31,3533000.0
3533,3533999,20.669831944591923,37.560087426083555,0.0816166974975907,2304.582624435425,274.9160969257355,1857.0897798538208,14649,3587,11062,11062,0,31,3534000.0
3534,3534999,20.67969822172887,37.589740847365015,0.08182610015804526,2305.2053229808807,274.9915509223938,1857.684567451477,14649,3587,11062,11062,0,31,3535000.0
3535,3535999,20.691547458703656,37.62891854706736,0.08206034564578257,2306.193895816803,275.06629252433777,1856.6013689041138,14666,3588,11078,11078,0,31,3536000.0
3536,3536999,20.70338108837145,37.66455034687682,0.0823117572472003,2306.7289896011353,275.1396930217743,1857.658444404602,14666,3588,11078,11078,0,31,3537000.0
3537,3537999,20.715987546583115,37.696378203559526,0.08264032739757143,2307.3304390907288,275.21243476867676,1858.2422151565552,14667,3589,11078,11078,0,31,3538000.0
3538,3538999,20.729324644702626,37.72789026003685,0.08304988210091668,2308.157384157181,275.2859899997711,1857.9352464675903,14667,3589,11078,11078,0,31,3539000.0
3539,3539999,20.73654517007918,37.739777432052634,0.0831888341081376,2308.75665807724,275.3616316318512,1858.609127998352,14680,3590,11090,11090,0,31,3540000.0
3540,3540999,20.735983828906004,37.740005868105804,0.0831450338701939,2309.1051943302155,275.431113243103,1860.439663887024,14691,3591,11100,11100,0,31,3541000.0
3541,3541999,20.735810058735552,37.743885577114426,0.08311209049719681,2309.4781243801117,275.4997639656067,1862.1565217971802,14691,3591,11100,11100,0,31,3542000.0
3542,3542999,20.736427716474115,37.74678418938861,0.08307866392006202,2310.056761741638,275.568265914917,1862.8732652664185,14695,3591,11104,11104,0,31,3543000.0
3543,3543999,20.737026035091926,37.74882529708317,0.08304829986349793,2310.5330905914307,275.63805651664734,1864.2711763381958,14698,3591,11107,11107,0,31,3544000.0
3544,3544999,20.737933059480714,37.751890004884075,0.0830212562756667,2311.396066904068,275.7083158493042,1863.4606294631958,14702,3593,11109,11109,0,31,3545000.0
3545,3545999,20.73800135754931,37.75102760356864,0.08301006698340896,2312.271719932556,275.77935671806335,1862.4283647537231,14706,3595,11111,11111,0,31,3546000.0
3546,3546999,20.73871173737447,37.752658433808904,0.08299081753281257,2312.870429754257,275.848525762558,1862.9643297195435,14708,3596,11112,11112,0,31,3547000.0
3547,3547999,20.73963252689527,37.75402654844457,0.0829666055154783,2313.4836699962616,275.9203288555145,1863.0918855667114,14711,3598,11113,11113,0,31,3548000.0
3548,3548999,20.741603439524113,37.757129033639096,0.08296856967795052,2313.948213815689,275.9932734966278,1864.2176713943481,14714,3600,11114,11114,0,31,3549000.0
3549,3549999,20.74403320116269,37.75991117264473,0.08297711121300655,2314.78467464447,276.0648307800293,1863.4498491287231,14716,3601,11115,11115,0,31,3550000.0
3550,3550999,20.747070221524787,37.767477876647916,0.08297447465600405,2315.3029732704163,276.13583612442017,1864.5680513381958,14716,3601,11115,11115,0,31,3551000.0
3551,3551999,20.751440624267264,37.776358398310585,0.08301104845398266,2316.0376336574554,276.21425580978394,1864.6027345657349,14718,3602,11116,11116,0,31,3552000.0
3552,3552999,20.756058272524385,37.78432175545315,0.083072899284238,2316.931809902191,276.28714752197266,1863.725567817688,14720,3603,11117,11117,0,31,3553000.0
3553,3553999,20.761059361004527,37.79406397236324,0.08313837980965144,2317.3396694660187,276.36014699935913,1865.312237739563,14720,3603,11117,11117,0,31,3554000.0
3554,3554999,20.767201582531722,37.81072643875886,0.08320470626258725,2318.2651810646057,276.4335343837738,1864.3281602859497,14720,3603,11117,11117,0,31,3555000.0
3555,3555999,20.77490883654107,37.82768732973057,0.08333629626713868,2318.837324142456,276.5053231716156,1864.6673860549927,14758,3606,11152,11152,0,31,3556000.0
3556,3556999,20.78219203573402,37.84714345393562,0.08347189918148912,2319.1907341480255,276.5783715248108,1866.349247932434,14762,3608,11154,11154,0,31,3557000.0
3557,3557999,20.788523078440182,37.860483236089905,0.08363776583730864,2319.504006385803,276.65552401542664,1868.5969514846802,14762,3608,11154,11154,0,31,3558000.0
3558,3558999,20.79811162403181,37.884516577630855,0.08390131958309843,2320.0151402950287,276.7303354740143,1869.7483110427856,14763,3608,11155,11155,0,31,3559000.0
3559,3559999,20.805696383141104,37.89835170587074,0.08404895372781007,2320.811792612076,276.80169343948364,1869.3721895217896,14781,3609,11172,11172,0,31,3560000.0
3560,3560999,20.805656884515802,37.8993416842385,0.08401001008244147,2321.2872111797333,276.8724069595337,1870.9890794754028,14796,3609,11187,11187,0,31,3561000.0
3561,3561999,20.804465413189902,37.89973943200798,0.083988698571836,2321.8873019218445,276.9415056705475,1871.3523454666138,14805,3611,11194,11194,0,31,3562000.0
3562,3562999,20.803857922585514,37.89993173142939,0.08396986891123315,2322.4894981384277,277.0160758495331,1872.0167055130005,14808,3612,11196,11196,0,31,3563000.0
3563,3563999,20.803791127088655,37.90701545840333,0.08392305583267645,2322.9817378520966,277.0864655971527,1873.162808418274,14809,3612,11197,11197,0,31,3564000.0
3564,3564999,20.802833261463892,37.905583128555485,0.08390655951910886,2323.863662004471,277.1584496498108,1872.1565980911255,14841,3615,11226,11226,0,31,3565000.0
3565,3565999,20.80242532669306,37.90435118900286,0.08388417914140056,2324.6190497875214,277.2317612171173,1872.0723237991333,14844,3616,11228,11228,0,31,3566000.0
3566,3566999,20.801534989627022,37.90400539270794,0.08385812038651941,2335.0412266254425,277.3043763637543,1873.6960649490356,14844,3616,11228,11228,0,31,3567000.0
3567,3567999,20.801102799769012,37.902154788848634,0.08384355311031211,2335.6613652706146,277.3755347728729,1874.1044206619263,14845,3617,11228,11228,0,31,3568000.0
3568,3568999,20.800683629759035,37.90039255047189,0.0838271873979991,2336.1533505916595,277.44859790802,1875.2746782302856,14845,3617,11228,11228,0,31,3569000.0
3569,3569999,20.801178575016856,37.90261687213558,0.08380120362218124,2336.7409160137177,277.51857256889343,1875.7487840652466,14846,3618,11228,11228,0,31,3570000.0
3570,3570999,20.801520867076754,37.90182128340922,0.0837837463537544,2337.346218585968,277.5906791687012,1876.3725023269653,14846,3618,11228,11228,0,31,3571000.0
3571,3571999,20.80176382535029,37.90101086284404,0.08377067510484637,2337.9792909622192,277.6633551120758,1876.945683479309,14846,3618,11228,11228,0,31,3572000.0
3572,3572999,20.803425007843394,37.90489924117801,0.08375467102213818,2338.5992364883423,277.73505210876465,1877.278203010559,14848,3619,11229,11229,0,31,3573000.0
3573,3573999,20.80567625276796,37.91015576500556,0.08374240065973715,2339.3939402103424,277.8081226348877,1876.8471574783325,14850,3620,11230,11230,0,31,3574000.0
3574,3574999,20.808190955744315,37.91373438723436,0.08374311268699974,2340.101071357727,277.8820390701294,1877.0564165115356,14850,3620,11230,11230,0,31,3575000.0
3575,3575999,20.81108033926304,37.91628037592604,0.08376203660411263,2340.63116645813,277.9544117450714,1878.2087755203247,14850,3620,11230,11230,0,31,3576000.0
3576,3576999,20.814643439270334,37.92417423036206,0.08379688234215743,2341.081874847412,278.02607798576355,1879.300908088684,14869,3623,11246,11246,0,31,3577000.0
3577,3577999,20.818357297934092,37.9291104398687,0.0838774237480836,2341.6999418735504,278.098646402359,1880.1806077957153,14869,3623,11246,11246,0,31,3578000.0
3578,3578999,20.821300546057337,37.93233857847882,0.08391903228767272,2342.079954147339,278.17133140563965,1881.8272371292114,14871,3624,11247,11247,0,31,3579000.0
3579,3579999,20.825236412690497,37.937101009792585,0.08401351173367988,2343.0445017814636,278.2496745586395,1880.8502016067505,14872,3624,11248,11248,0,31,3580000.0
3580,3580999,20.82757610810866,37.94181715316764,0.0840740067990029,2343.435087442398,278.3215546607971,1882.3005800247192,14874,3625,11249,11249,0,31,3581000.0
3581,3581999,20.82703139476317,37.93978681370127,0.08405356832930166,2343.9914922714233,278.39050006866455,1883.2532167434692,14918,3626,11292,11292,0,31,3582000.0
3582,3582999,20.825191135572204,37.93712385241317,0.0840532403366514,2344.57271027565,278.45682287216187,1884.1046953201294,14926,3626,11300,11300,0,31,3583000.0
3583,3583999,20.823571550950142,37.9351273694584,0.08405528913706328,2344.843814611435,278.523056268692,1886.2860918045044,14930,3627,11303,11303,0,31,3584000.0
3584,3584999,20.822058814594556,37.9323355030897,0.08405103628987165,2345.2149727344513,278.5909764766693,1888.0622072219849,14934,3628,11306,11306,0,31,3585000.0
3585,3585999,20.820935432333002,37.931657483108154,0.08403633060073257,2345.771113395691,278.6587815284729,1888.7592287063599,14941,3630,11311,11311,0,31,3586000.0
3586,3586999,20.819999503018117,37.92982235365288,0.08403112134467683,2346.40563082695,278.72848439216614,1889.0671663284302,14966,3633,11333,11333,0,31,3587000.0
3587,3587999,20.818612519090458,37.927504172480596,0.08402772016385107,2347.1832687854767,278.7991554737091,1888.7116746902466,14970,3635,11335,11335,0,31,3588000.0
3588,3588999,20.81786589641663,37.9269686776919,0.08401483376226926,2347.5833106040955,278.8679630756378,1890.198697090149,14972,3636,11336,11336,0,31,3589000.0
3589,3589999,20.817303877950565,37.9253509970553,0.08400531113948662,2348.1449797153473,278.93726229667664,1891.3128938674927,14972,3636,11336,11336,0,31,3590000.0
3590,3590999,20.817349806612665,37.92884287737082,0.08398437059637753,2348.3485991954803,279.0033893585205,1893.970425605774,14972,3636,11336,11336,0,31,3591000.0
3591,3591999,20.817932987201075,37.92921708361611,0.08397785229973198,2349.2245733737946,279.0727529525757,1893.284649848938,14974,3637,11337,11337,0,31,3592000.0
3592,3592999,20.81861669132044,37.929327477668345,0.08398743232817207,2350.0335676670074,279.14597630500793,1892.8261156082153,14978,3639,11339,11339,0,31,3593000.0
3593,3593999,20.819858787609466,37.93011525915491,0.08400974416143125,2350.9478101730347,279.21487832069397,1891.6683626174927,14982,3641,11341,11341,0,31,3594000.0
3594,3594999,20.820595846571663,37.93285276763448,0.08401526774699208,2351.5578587055206,279.2833640575409,1892.0431261062622,14984,3642,11342,11342,0,31,3595000.0
3595,3595999,20.822468694308547,37.93962707865901,0.08402467424705518,2352.242897748947,279.3511610031128,1892.363896369934,14984,3642,11342,11342,0,31,3596000.0
3596,3596999,20.823965537702136,37.94318161357658,0.0840491990460197,2352.741730928421,279.41903948783875,1893.472897529602,14984,3642,11342,11342,0,31,3597000.0
3597,3597999,20.82489384919604,37.94395177785042,0.084066068631382,2353.2187530994415,279.48779296875,1894.7957277297974,14986,3643,11343,11343,0,31,3598000.0
3598,3598999,20.826129780025983,37.94516120572298,0.08409467082903843,2353.898625612259,279.55626821517944,1895.2932786941528,14990,3644,11346,11346,0,31,3599000.0
3599,3599999,20.828712469094757,37.94807941061404,0.08411636148262436,2354.972711801529,279.62705540657043,1893.6708421707153,14996,3646,11350,11350,0,31,3600000.0
3600,3600999,20.827745432345516,37.94651812836725,0.08410189561206438,2355.347382545471,279.7018675804138,1895.4530763626099,15002,3647,11355,11355,0,31,3601000.0
3601,3601999,20.826252927886433,37.945324596760315,0.08409205191474933,2356.1448788642883,279.76517510414124,1895.088604927063,15003,3647,11356,11356,0,31,3602000.0
3602,3602999,20.824977490410525,37.942566111341684,0.08408708206502058,2356.664313554764,279.8297860622406,1895.946270942688,15006,3648,11358,11358,0,31,3603000.0
3603,3603999,20.82367794908176,37.94080041012065,0.08407493631391505,2357.24947142601,279.8925709724426,1896.5233812332153,15009,3649,11360,11360,0,31,3604000.0
3604,3604999,20.82269023780348,37.93902772678769,0.08406489615930268,2358.04994392395,279.9572594165802,1896.014874458313,15015,3651,11364,11364,0,31,3605000.0
3605,3605999,20.821613416929388,37.9377633614454,0.08405349864734701,2358.744460105896,280.01986026763916,1896.1317644119263,15029,3652,11377,11377,0,31,3606000.0
3606,3606999,20.820669663365845,37.93744724081387,0.08403597649769101,2359.4141573905945,280.0863575935364,1896.4744310379028,15032,3653,11379,11379,0,31,3607000.0
3607,3607999,20.820390224673694,37.937383223237326,0.08402150682435316,2359.885068178177,280.14923644065857,1897.9556550979614,15032,3653,11379,11379,0,31,3608000.0
3608,3608999,20.82086061602621,37.93833423212711,0.08400619799810793,2360.4265303611755,280.21164631843567,1898.5032091140747,15037,3656,11381,11381,0,31,3609000.0
3609,3609999,20.821932222392675,37.94068328812873,0.08399758450932082,2361.0946373939514,280.2764890193939,1898.7753038406372,15039,3657,11382,11382,0,31,3610000.0
3610,3610999,20.8243884181801,37.94530385362645,0.08399138981498011,2361.696286678314,280.34135365486145,1899.378674507141,15044,3658,11386,11386,0,31,3611000.0
3611,3611999,20.82765286231694,37.95564292873742,0.08398098112892138,2362.406406879425,280.40481996536255,1899.450177192688,15044,3658,11386,11386,0,31,3612000.0
3612,3612999,20.83172478430866,37.965021355791016,0.08402536484107803,2362.97252368927,280.4690971374512,1900.2504091262817,15047,3659,11388,11388,0,31,3613000.0
3613,3613999,20.835593723224207,37.97480114768347,0.08401549533795794,2363.4686720371246,280.5319495201111,1901.3788042068481,15049,3659,11390,11390,0,31,3614000.0
3614,3614999,20.840743631379883,37.99364123989712,0.08405492696351402,2364.5005147457123,280.5965585708618,1899.4829378128052,15053,3661,11392,11392,0,31,3615000.0
3615,3615999,20.84563729911103,38.00386922894584,0.08413926165448449,2364.910376548767,280.6599543094635,1901.089940071106,15053,3661,11392,11392,0,31,3616000.0
3616,3616999,20.850696190344586,38.01687013713698,0.08418385730893407,2365.4145169258118,280.7283139228821,1902.0176134109497,15054,3662,11392,11392,0,31,3617000.0
3617,3617999,20.855342058898884,38.02560405876301,0.0842311096931112,2365.996616601944,280.79156398773193,1902.7005891799927,15054,3662,11392,11392,0,31,3618000.0
3618,3618999,20.859798883725503,38.03136545616385,0.08423909250291384,2366.8036715984344,280.8569324016571,1902.2455339431763,15054,3662,11392,11392,0,31,3619000.0
3619,3619999,20.864026763932287,38.03849825466184,0.08425636535996417,2367.2007365226746,280.9215612411499,1903.8335161209106,15054,3662,11392,11392,0,31,3620000.0
3620,3620999,20.865173212651467,38.03806574749017,0.0841769244465882,2367.689962387085,280.98834776878357,1904.8238344192505,15057,3663,11394,11394,0,31,3621000.0
3621,3621999,20.86465876281685,38.037630349419,0.08414678867801628,2368.397076368332,281.05370807647705,1904.9330644607544,15057,3663,11394,11394,0,31,3622000.0
3622,3622999,20.86444290880264,38.03804697347818,0.08410773530739601,2369.0657584667206,281.1185886859894,1905.439061164856,15120,3665,11455,11455,0,31,3623000.0
3623,3623999,20.86408282859224,38.03714613452509,0.0840844583932312,2369.980709552765,281.1850416660309,1904.5449419021606,15122,3666,11456,11456,0,31,3624000.0
3624,3624999,20.863476093118454,38.035574315013854,0.08406142517376869,2370.6549999713898,281.25017619132996,1904.5767793655396,15126,3668,11458,11458,0,31,3625000.0
3625,3625999,20.862675392671427,38.03386418491957,0.08406237415442042,2371.1547017097473,281.31635212898254,1905.697834968567,15126,3668,11458,11458,0,31,3626000.0
3626,3626999,20.86213429128813,38.03248845453586,0.08405050402938097,2371.6403369903564,281.38027453422546,1906.7266359329224,15132,3669,11463,11463,0,31,3627000.0
3627,3627999,20.861674266430278,38.03146688227944,0.08406504779355006,2372.127106189728,281.44506430625916,1907.7733507156372,15134,3670,11464,11464,0,31,3628000.0
3628,3628999,20.862107890009614,38.03259353049698,0.08410579850550148,2373.007714986801,281.51088190078735,1906.827763557434,15135,3671,11464,11464,0,31,3629000.0
3629,3629999,20.862911473315556,38.03756477181904,0.08411495711028527,2373.6770939826965,281.5796778202057,1907.1460847854614,15136,3672,11464,11464,0,31,3630000.0
3630,3630999,20.86398041344842,38.03935921694977,0.08415750433590086,2374.174441576004,281.64848470687866,1908.4442796707153,15136,3672,11464,11464,0,31,3631000.0
3631,3631999,20.865616080862576,38.0414559388898,0.08418398291200369,2374.5949025154114,281.71769070625305,1910.047791481018,15137,3672,11465,11465,0,31,3632000.0
3632,3632999,20.867072621244894,38.043126256003454,0.08419460188707284,2375.4663174152374,281.7829337120056,1909.3269357681274,15143,3673,11470,11470,0,31,3633000.0
3633,3633999,20.868770962633217,38.04513408414795,0.08425147729138183,2376.2738287448883,281.84980726242065,1908.7793817520142,15145,3674,11471,11471,0,31,3634000.0
3634,3634999,20.870631596782104,38.05012693863108,0.08435039280633572,2376.7762322425842,281.9164264202118,1909.8843622207642,15145,3674,11471,11471,0,31,3635000.0
3635,3635999,20.87261475845555,38.051466911002024,0.08440088105271026,2377.187347173691,281.98314356803894,1911.4829034805298,15145,3674,11471,11471,0,31,3636000.0
3636,3636999,20.874370949828908,38.05304628934853,0.08447342609840447,2377.779174566269,282.04913091659546,1911.8856363296509,15146,3675,11471,11471,0,31,3637000.0
3637,3637999,20.875403670703534,38.054508376102525,0.08451885328891262,2378.3704414367676,282.11622428894043,1912.499794960022,15163,3676,11487,11487,0,31,3638000.0
3638,3638999,20.87690730142763,38.05679725868684,0.08456169296971772,2378.9874370098114,282.1819987297058,1913.1367959976196,15163,3676,11487,11487,0,31,3639000.0
3639,3639999,20.877746013205286,38.06160005966156,0.08457246041384159,2379.6982946395874,282.2513439655304,1913.1655435562134,15163,3676,11487,11487,0,31,3640000.0
3640,3640999,20.877395540577492,38.05956442010638,0.08454454600720862,2380.184955596924,282.3219382762909,1914.2713327407837,15168,3677,11491,11491,0,31,3641000.0
3641,3641999,20.876563481813367,38.05760250810112,0.084502624637537,2380.6651809215546,282.3864755630493,1915.4601068496704,15168,3677,11491,11491,0,31,3642000.0
3642,3642999,20.875762674221612,38.05549016590984,0.08446619938870492,2381.0337147712708,282.45011258125305,1917.0765466690063,15170,3678,11492,11492,0,31,3643000.0
3643,3643999,20.875179466061347,38.053062085184756,0.08443499513696684,2381.612696170807,282.51388216018677,1917.650948524475,15172,3679,11493,11493,0,31,3644000.0
3644,3644999,20.87412145123893,38.050693683293474,0.08441157263679078,2382.495899438858,282.5805778503418,1916.8082818984985,15174,3680,11494,11494,0,31,3645000.0
3645,3645999,20.873248122740016,38.04881285717423,0.08438346085241843,2383.2882075309753,282.64646887779236,1916.4498300552368,15176,3681,11495,11495,0,31,3646000.0
3646,3646999,20.871718917372323,38.045817839972855,0.0843703541423464,2383.8647060394287,282.7115731239319,1916.9114999771118,15184,3683,11501,11501,0,31,3647000.0
3647,3647999,20.87034833299212,38.04468621200485,0.08434664019401028,2384.733077764511,282.77702140808105,1915.747712135315,15200,3687,11513,11513,0,31,3648000.0
3648,3648999,20.86896282352883,38.04174206112887,0.08433716865974139,2385.2318251132965,282.84326338768005,1916.8932733535767,15200,3687,11513,11513,0,31,3649000.0
3649,3649999,20.867771488449165,38.03951868881347,0.08432820686332876,2385.8340759277344,282.9091248512268,1917.3765726089478,15201,3688,11513,11513,0,31,3650000.0
3650,3650999,20.866117089629988,38.03625273200115,0.08432561957684848,2386.4521038532257,282.97534465789795,1918.0049600601196,15201,3688,11513,11513,0,31,3651000.0
3651,3651999,20.86513205655464,38.03374838721031,0.08433102630536671,2386.960948705673,283.04051399230957,1919.0976495742798,15201,3688,11513,11513,0,31,3652000.0
3652,3652999,20.864293632306314,38.03193519609728,0.08434067057741879,2387.69983959198,283.10791087150574,1919.2533731460571,15201,3688,11513,11513,0,31,3653000.0
3653,3653999,20.864335099687732,38.03192431785424,0.08438214667473365,2388.8947236537933,283.1745779514313,1916.667664527893,15207,3691,11516,11516,0,31,3654000.0
3654,3654999,20.864108687060284,38.030629646773534,0.08441263927763465,2389.315605163574,283.2419741153717,1918.2599267959595,15207,3691,11516,11516,0,31,3655000.0
3655,3655999,20.864660557284736,38.030930950672094,0.08442797706447036,2390.1576669216156,283.31558632850647,1917.4119577407837,15213,3694,11519,11519,0,31,3656000.0
3656,3656999,20.865276182172746,38.032497213249115,0.08444604897139163,2390.4489455223083,283.3824779987335,1919.5279092788696,15228,3695,11533,11533,0,31,3657000.0
3657,3657999,20.865449181828275,38.03274916173917,0.08445351689076697,2390.819142818451,283.4490387439728,1921.2605829238892,15230,3696,11534,11534,0,31,3658000.0
3658,3658999,20.865643615065874,38.033589191902585,0.08447006602155327,2391.557929754257,283.51387882232666,1921.231110572815,15231,3696,11535,11535,0,31,3659000.0
3659,3659999,20.864944679960395,38.031591158854646,0.08448896711986109,2392.2650003433228,283.5836935043335,1921.4315881729126,15231,3696,11535,11535,0,31,3660000.0
3660,3660999,20.864694183329856,38.03093318199175,0.0844476303774615,2392.643715620041,283.6489908695221,1923.1818704605103,15237,3697,11540,11540,0,31,3661000.0
3661,3661999,20.864124512436796,38.02951454602917,0.08441616607061142,2393.3504128456116,283.7156524658203,1923.2794733047485,15239,3698,11541,11541,0,31,3662000.0
3662,3662999,20.86349103860676,38.028118180355314,0.08440055801903457,2394.121497154236,283.7800934314728,1923.1822671890259,15239,3698,11541,11541,0,31,3663000.0
3663,3663999,20.862268862523578,38.0251725716842,0.08439956884381561,2394.705775499344,283.84929060935974,1923.6114206314087,15243,3700,11543,11543,0,31,3664000.0
3664,3664999,20.86120436887436,38.02255093763206,0.08439085331893648,2395.1912367343903,283.9154415130615,1924.7257013320923,15245,3701,11544,11544,0,31,3665000.0
3665,3665999,20.859696006389985,38.01971408726046,0.08439636337746514,2395.929945230484,283.9838945865631,1924.783486366272,15245,3701,11544,11544,0,31,3666000.0
3666,3666999,20.858318086257505,38.0169157979301,0.08439327164729726,2396.6246013641357,284.0494747161865,1924.7845010757446,15249,3703,11546,11546,0,31,3667000.0
3667,3667999,20.856941158238932,38.014357396034626,0.08439519656381489,2397.3947587013245,284.1173906326294,1924.371605873108,15261,3705,11556,11556,0,31,3668000.0
3668,3668999,20.855867910913293,38.017257685481106,0.08436843770869562,2398.0904841423035,284.18482732772827,1924.3474206924438,15265,3707,11558,11558,0,31,3669000.0
3669,3669999,20.85464442472294,38.014638430071585,0.08436698597634495,2398.483278989792,284.2508964538574,1925.8151865005493,15266,3708,11558,11558,0,31,3670000.0
3670,3670999,20.853406567359233,38.011883649526084,0.08437309406952886,2399.301104068756,284.3182339668274,1925.5252923965454,15266,3708,11558,11558,0,31,3671000.0
3671,3671999,20.85207155362017,38.0090826036926,0.0843732037197199,2399.892593383789,284.38415694236755,1926.094895362854,15268,3709,11559,11559,0,31,3672000.0
3672,3672999,20.851390352940154,38.009171410263406,0.0843652890826384,2400.687014102936,284.454217672348,1925.5303888320923,15271,3711,11560,11560,0,31,3673000.0
3673,3673999,20.85086694534368,38.00702433753736,0.08435830918196541,2401.40780878067,284.5203790664673,1925.6216135025024,15271,3711,11560,11560,0,31,3674000.0
3674,3674999,20.850430139877723,38.00465027119021,0.08435205259082135,2402.019026041031,284.5861568450928,1926.1856317520142,15271,3711,11560,11560,0,31,3675000.0
3675,3675999,20.849814248270153,38.00245356950138,0.0843557738951145,2402.8028984069824,284.6558392047882,1925.8729486465454,15273,3712,11561,11561,0,31,3676000.0
3676,3676999,20.849339779947922,38.00336565396141,0.08434395197573963,2403.310317993164,284.7258038520813,1926.9279870986938,15273,3712,11561,11561,0,31,3677000.0
3677,3677999,20.848306393178113,38.0002857153262,0.08433143815127453,2403.708127975464,284.7906355857849,1928.5881280899048,15275,3712,11563,11563,0,31,3678000.0
3678,3678999,20.846823337280895,37.99748926370999,0.08430843721607995,2404.2827694416046,284.8570017814636,1929.1754999160767,15279,3714,11565,11565,0,31,3679000.0
3679,3679999,20.845178020394968,37.99445488692339,0.08429215516404887,2404.9092075824738,284.92811036109924,1929.8458642959595,15279,3714,11565,11565,0,31,3680000.0
3680,3680999,20.84363720306268,37.991486857703926,0.08427784627421064,2405.684605360031,284.99412536621094,1929.6448755264282,15283,3716,11567,11567,0,31,3681000.0
3681,3681999,20.842135877463907,37.98835475533006,0.08426642957976305,2406.290351629257,285.0605227947235,1930.2498331069946,15285,3717,11568,11568,0,31,3682000.0
3682,3682999,20.840743952049504,37.98672613270894,0.08424903853721499,2407.4150671958923,285.1284341812134,1927.8921899795532,15289,3719,11570,11570,0,31,3683000.0
3683,3683999,20.839109250775476,37.983319193706926,0.0842437433160832,2408.3021097183228,285.1956491470337,1926.9936227798462,15293,3721,11572,11572,0,31,3684000.0
3684,3684999,20.838038928061124,37.98099755442651,0.08423405397072947,2408.725438117981,285.26080417633057,1928.5874490737915,15293,3721,11572,11572,0,31,3685000.0
3685,3685999,20.836917700281028,37.97853561505175,0.0842235047065133,2409.4560124874115,285.3284845352173,1928.4706888198853,15295,3722,11573,11573,0,31,3686000.0
3686,3686999,20.83603427952105,37.977175044928046,0.08420646213904504,2409.981828212738,285.3945701122284,1929.5464487075806,15295,3722,11573,11573,0,31,3687000.0
3687,3687999,20.83535053641087,37.9751711721315,0.08419330271024639,2410.8045358657837,285.4618468284607,1929.0420389175415,15297,3723,11574,11574,0,31,3688000.0
3688,3688999,20.835330348372153,37.97456138251593,0.08416058417986505,2411.7585985660553,285.5312304496765,1928.0758218765259,15297,3723,11574,11574,0,31,3689000.0
3689,3689999,20.835672335345077,37.97641422943557,0.08412923839448971,2412.3748304843903,285.5989887714386,1928.6341791152954,15297,3723,11574,11574,0,31,3690000.0
3690,3690999,20.835893497353364,37.97616184226571,0.08409997628490995,2413.0780515670776,285.66761302948,1928.6157236099243,15299,3724,11575,11575,0,31,3691000.0
3691,3691999,20.836332902497382,37.97643619845201,0.0840750154717883,2413.700246810913,285.73545694351196,1929.057801246643,15301,3725,11576,11576,0,31,3692000.0
3692,3692999,20.83731654411367,37.976365127368425,0.0840601402921144,2414.108547925949,285.79986548423767,1930.7185907363892,15301,3725,11576,11576,0,31,3693000.0
3693,3693999,20.838545716043814,37.97913009082446,0.08402396869144879,2414.7018399238586,285.86505699157715,1931.3015069961548,15303,3726,11577,11577,0,31,3694000.0
3694,3694999,20.839195640505107,37.9785211643939,0.0840104244180162,2415.2184779644012,285.9298343658447,1932.3858575820923,15303,3726,11577,11577,0,31,3695000.0
3695,3695999,20.839793560613764,37.97737774900049,0.08400729147359864,2415.927499294281,285.995228767395,1932.477593421936,15306,3727,11579,11579,0,31,3696000.0
3696,3696999,20.83999645417013,37.976260174556245,0.08400371460627298,2416.632014989853,286.0636372566223,1932.4809885025024,15308,3728,11580,11580,0,31,3697000.0
3697,3697999,20.839179574372363,37.97430495361428,0.08398789165590304,2417.1161727905273,286.1282193660736,1933.6247720718384,15313,3729,11584,11584,0,31,3698000.0
3698,3698999,20.837197701603817,37.97057318600293,0.08398321958815058,2417.5595569610596,286.19315671920776,1935.1095209121704,15313,3729,11584,11584,0,31,3699000.0
3699,3699999,20.835601463658605,37.96799422095155,0.08397783872443598,2418.240557193756,286.25779485702515,1935.392632484436,15313,3729,11584,11584,0,31,3700000.0
3700,3700999,20.833916740825924,37.96462828450385,0.08397694011441392,2418.736555337906,286.32220339775085,1936.4945154190063,15313,3729,11584,11584,0,31,3701000.0
3701,3701999,20.832239850446772,37.96244230563774,0.08396576511205123,2419.4280893802643,286.38832926750183,1936.5425271987915,15315,3730,11585,11585,0,31,3702000.0
3702,3702999,20.830720332992303,37.95908953127008,0.08396114333911753,2420.425688266754,286.45581793785095,1935.0779886245728,15324,3732,11592,11592,0,31,3703000.0
3703,3703999,20.82920797041786,37.95586286500246,0.0839556294987398,2421.1306800842285,286.5219874382019,1935.1966791152954,15324,3732,11592,11592,0,31,3704000.0
3704,3704999,20.828346448394083,37.9544971341831,0.08394272779375755,2421.4377579689026,286.59281611442566,1937.3210077285767,15324,3732,11592,11592,0,31,3705000.0
3705,3705999,20.82802558021033,37.9566397153698,0.08390915996646797,2422.0413315296173,286.65987730026245,1937.9294290542603,15324,3732,11592,11592,0,31,3706000.0
3706,3706999,20.827526574097007,37.955577333057086,0.08389142858297893,2422.889360189438,286.7265934944153,1937.2605676651,15326,3733,11593,11593,0,31,3707000.0
3707,3707999,20.82810257073579,37.9566907201915,0.0838610591690161,2423.4927082061768,286.7932107448578,1937.8133935928345,15328,3734,11594,11594,0,31,3708000.0
3708,3708999,20.828905044224463,37.958383115177774,0.08382872949262232,2424.322995662689,286.8587443828583,1937.4002237319946,15328,3734,11594,11594,0,31,3709000.0
3709,3709999,20.83028540853207,37.96525913496654,0.08378018220430372,2425.110003232956,286.93003129959106,1936.7864999771118,15334,3737,11597,11597,0,31,3710000.0
3710,3710999,20.83117064189131,37.96608496284978,0.08376378816788599,2425.6799190044403,286.99723291397095,1937.2058572769165,15343,3740,11603,11603,0,31,3711000.0
3711,3711999,20.832507561331955,37.9679528846964,0.08373922842083126,2426.3836693763733,287.06538367271423,1937.4385919570923,15343,3740,11603,11603,0,31,3712000.0
3712,3712999,20.833540929512786,37.96821439599276,0.08372168190200513,2427.084171295166,287.1310794353485,1937.525803565979,15363,3741,11622,11622,0,31,3713000.0
3713,3713999,20.83540850609082,37.97195848531894,0.08368961721984958,2427.495597600937,287.19644236564636,1939.1009531021118,15363,3741,11622,11622,0,31,3714000.0
3714,3714999,20.837025366781706,37.97344282707416,0.08366081831934191,2428.2007620334625,287.26563692092896,1939.2644357681274,15363,3741,11622,11622,0,31,3715000.0
3715,3715999,20.838234836935985,37.97388990710423,0.08364375973242644,2428.9263973236084,287.33353662490845,1939.2652292251587,15365,3742,11623,11623,0,31,3716000.0
3716,3716999,20.83909787596617,37.97379211016017,0.08362424600769425,2429.74876332283,287.4026770591736,1938.7909631729126,15365,3742,11623,11623,0,31,3717000.0
3717,3717999,20.838963697506166,37.97219390741105,0.08360904614297227,2430.2507412433624,287.46990442276,1939.8537225723267,15366,3742,11624,11624,0,31,3718000.0
3718,3718999,20.837931160094623,37.97147939509708,0.08359284485128993,2430.820487499237,287.53354835510254,1940.7599115371704,15370,3742,11628,11628,0,31,3719000.0
3719,3719999,20.83643333373974,37.96886049653876,0.08358515947782252,2431.416635274887,287.59945917129517,1941.204628944397,15372,3743,11629,11629,0,31,3720000.0
3720,3720999,20.834740508344733,37.96573946343212,0.08358714818949009,2432.011716365814,287.6663999557495,1941.7938776016235,15374,3744,11630,11630,0,31,3721000.0
3721,3721999,20.83344027646452,37.963054532110206,0.0835846381953047,2432.519591808319,287.73079657554626,1942.8902750015259,15374,3744,11630,11630,0,31,3722000.0
3722,3722999,20.831878257966615,37.959985470503696,0.08358055112938767,2433.2225692272186,287.79632329940796,1942.8990411758423,15376,3745,11631,11631,0,31,3723000.0
3723,3723999,20.830829638485753,37.95785280836493,0.08356837735898803,2433.72571849823,287.86056327819824,1943.7926797866821,15378,3746,11632,11632,0,31,3724000.0
3724,3724999,20.82949373098419,37.955104595917156,0.08355990732181717,2434.5251030921936,287.9312765598297,1943.2750024795532,15382,3748,11634,11634,0,31,3725000.0
3725,3725999,20.828288026349245,37.95296426654956,0.0835471816779092,2435.3505074977875,287.9981384277344,1942.7867593765259,15382,3748,11634,11634,0,31,3726000.0
3726,3726999,20.827732381704227,37.95194321531097,0.08352750887878058,2435.9612908363342,288.0655574798584,1943.1702890396118,15383,3749,11634,11634,0,31,3727000.0
3727,3727999,20.826887633551046,37.94975168432854,0.08350978895321481,2436.661776304245,288.1356363296509,1943.2008790969849,15385,3750,11635,11635,0,31,3728000.0
3728,3728999,20.826173389906806,37.94755784261796,0.08349674852966815,2437.773430585861,288.2029857635498,1941.2588243484497,15385,3750,11635,11635,0,31,3729000.0
3729,3729999,20.82598827544829,37.946466854702436,0.08347952292255234,2438.2637939453125,288.2696533203125,1942.319432258606,15387,3751,11636,11636,0,31,3730000.0
3730,3730999,20.825522824907498,37.94430579630749,0.08346662533141591,2438.8582923412323,288.3375835418701,1942.877652168274,15405,3752,11653,11653,0,31,3731000.0
3731,3731999,20.825238592761043,37.94321199235029,0.0834501476762266,2439.2952189445496,288.4123373031616,1944.4503145217896,15405,3752,11653,11653,0,31,3732000.0
3732,3732999,20.82468526884047,37.94105464999268,0.08343840765749733,2440.0223615169525,288.4813871383667,1944.4845781326294,15405,3752,11653,11653,0,31,3733000.0
3733,3733999,20.824741741324175,37.94212305643312,0.08341642586065912,2440.5281455516815,288.5508089065552,1945.5372667312622,15405,3752,11653,11653,0,31,3734000.0
3734,3734999,20.824277621865207,37.94002731817523,0.0834071219500746,2441.144823551178,288.6181936264038,1946.0629243850708,15405,3752,11653,11653,0,31,3735000.0
3735,3735999,20.82373285925028,37.93759643746518,0.08340289175216964,2441.7198493480682,288.6852104663849,1946.4992189407349,15425,3755,11670,11670,0,31,3736000.0
3736,3736999,20.822863920478458,37.93653477206035,0.08338428334158376,2442.512773990631,288.7516257762909,1946.0781908035278,15432,3756,11676,11676,0,31,3737000.0
3737,3737999,20.823682151198696,37.93521151845424,0.0833113780357746,2443.088638782501,288.818017244339,1946.8749895095825,15433,3756,11677,11677,0,31,3738000.0
3738,3738999,20.823342957674523,37.933489541176904,0.08327407776708107,2443.7650125026703,288.8830318450928,1946.988766670227,15449,3758,11691,11691,0,31,3739000.0
3739,3739999,20.82276780977169,37.93070169749872,0.08325011946115624,2444.5500910282135,288.94766211509705,1946.4789323806763,15459,3760,11699,11699,0,31,3740000.0
3740,3740999,20.822210632845064,37.92869184964563,0.08323120667979567,2445.1760382652283,289.0144588947296,1947.0703401565552,15459,3760,11699,11699,0,31,3741000.0
3741,3741999,20.821839876712378,37.92879608973698,0.08320828968939697,2445.9921617507935,289.0805540084839,1946.641713142395,15461,3761,11700,11700,0,31,3742000.0
3742,3742999,20.820901838094123,37.9268186073172,0.08318511032163922,2446.4742155075073,289.14733362197876,1947.6323747634888,15462,3762,11700,11700,0,31,3743000.0
3743,3743999,20.81956102039319,37.92521878303309,0.08317311848282438,2446.8710227012634,289.2110161781311,1949.237141609192,15462,3762,11700,11700,0,31,3744000.0
3744,3744999,20.8190907468163,37.924508582265524,0.08314968181135873,2447.6369795799255,289.2745804786682,1949.1024370193481,15462,3762,11700,11700,0,31,3745000.0
3745,3745999,20.818646496817088,37.92827766867576,0.0831158072192697,2448.1446254253387,289.34091448783875,1950.0435762405396,15463,3763,11700,11700,0,31,3746000.0
3746,3746999,20.81931295294114,37.92890276705084,0.08307860438254655,2449.0644879341125,289.4072756767273,1948.7384996414185,15467,3765,11702,11702,0,31,3747000.0
3747,3747999,20.82011417611424,37.93064478631646,0.08305135589582346,2459.984737634659,289.474125623703,1949.8346071243286,15467,3765,11702,11702,0,31,3748000.0
3748,3748999,20.821039601019496,37.93138322002495,0.08302881071667867,2461.015076637268,289.54137778282166,1948.389973640442,15467,3765,11702,11702,0,31,3749000.0
3749,3749999,20.822905977209665,37.935664396448516,0.08299303074822084,2461.7360639572144,289.61068987846375,1948.2622117996216,15475,3766,11709,11709,0,31,3750000.0
3750,3750999,20.825358708800174,37.94314234826118,0.08295410069029152,2462.3309149742126,289.67794942855835,1948.680630683899,15478,3768,11710,11710,0,31,3751000.0
3751,3751999,20.827924043947757,37.94967801781334,0.08292826832370048,2463.1542015075684,289.7493329048157,1948.2058305740356,15487,3770,11717,11717,0,31,3752000.0
3752,3752999,20.82986859226945,37.95355431539038,0.0829027648784304,2463.7816050052643,289.81750297546387,1948.7847185134888,15487,3770,11717,11717,0,31,3753000.0
3753,3753999,20.832693023486534,37.961065383460706,0.08287294160977488,2464.491714954376,289.8841257095337,1948.6023149490356,15490,3772,11718,11718,0,31,3754000.0
3754,3754999,20.83541683213067,37.963304531038624,0.08286341844962875,2464.974714279175,289.95080733299255,1950.0480165481567,15490,3772,11718,11718,0,31,3755000.0
3755,3755999,20.837717839609088,37.96764762891177,0.08285367528111331,2465.6987175941467,290.0205223560333,1950.0463609695435,15492,3773,11719,11719,0,31,3756000.0
3756,3756999,20.8390719662051,37.967266259576206,0.08284763847160981,2466.425767660141,290.0898153781891,1949.9684648513794,15500,3774,11726,11726,0,31,3757000.0
3757,3757999,20.83862483247226,37.96487771918059,0.0828248285307952,2466.8165192604065,290.1566801071167,1951.663166999817,15507,3774,11733,11733,0,31,3758000.0
3758,3758999,20.837416370286835,37.963005364878924,0.08279825518415118,2467.396525621414,290.2229845523834,1952.122639656067,15510,3775,11735,11735,0,31,3759000.0
3759,3759999,20.835921512811865,37.96085478659478,0.08276540062395044,2467.7736070156097,290.28889989852905,1953.7994813919067,15510,3775,11735,11735,0,31,3760000.0
3760,3760999,20.83504025694221,37.96003926691943,0.08270845780854985,2469.113008737564,290.3597791194916,1950.6519899368286,15516,3778,11738,11738,0,31,3761000.0
3761,3761999,20.83477893410532,37.96259934869298,0.08264685021691431,2469.5135617256165,290.4257159233093,1952.2982454299927,15516,3778,11738,11738,0,31,3762000.0
3762,3762999,20.834167990719106,37.960933624792105,0.08261859818831285,2470.119479894638,290.4923040866852,1952.8376359939575,15518,3779,11739,11739,0,31,3763000.0
3763,3763999,20.83383065488006,37.961127057678574,0.08258814135248815,2470.634350538254,290.5610499382019,1954.005368232727,15518,3779,11739,11739,0,31,3764000.0
3764,3764999,20.833211673959596,37.959751041855256,0.0825650081561603,2471.5320661067963,290.62861728668213,1952.986927986145,15520,3780,11740,11740,0,31,3765000.0
3765,3765999,20.832468689376412,37.95815173287412,0.08254968042530841,2472.1678206920624,290.69912791252136,1953.546971321106,15520,3780,11740,11740,0,31,3766000.0
3766,3766999,20.83242519603063,37.95791719435915,0.08252124738455746,2472.777952671051,290.768150806427,1953.9823427200317,15521,3781,11740,11740,0,31,3767000.0
3767,3767999,20.832410217888764,37.9573091323929,0.08250635853735522,2473.5690257549286,290.8368194103241,1953.2883958816528,15526,3784,11742,11742,0,31,3768000.0
3768,3768999,20.833494817086706,37.95869272456836,0.08249123373450584,2474.067019224167,290.9069757461548,1954.4092149734497,15528,3785,11743,11743,0,31,3769000.0
3769,3769999,20.83637667966949,37.96632938167746,0.08245340785839772,2474.670454978943,290.97478771209717,1954.998791694641,15530,3786,11744,11744,0,31,3770000.0
3770,3770999,20.839533642026122,37.9742207122013,0.08243773712099789,2475.511009454727,291.0460891723633,1954.647084236145,15530,3786,11744,11744,0,31,3771000.0
3771,3771999,20.843989517718594,37.9870932469218,0.08244201314096511,2476.102178812027,291.118084192276,1955.0726976394653,15534,3788,11746,11746,0,31,3772000.0
3772,3772999,20.8476386564532,37.99385571156341,0.08251622171717621,2476.70995426178,291.18825912475586,1955.7327699661255,15534,3788,11746,11746,0,31,3773000.0
3773,3773999,20.852895063120464,38.00639218754316,0.08253580680307893,2477.3207972049713,291.2562026977539,1956.3105669021606,15534,3788,11746,11746,0,31,3774000.0
3774,3774999,20.857841022549827,38.01808912163016,0.0825665070642474,2477.9270837306976,291.3270061016083,1956.9296922683716,15534,3788,11746,11746,0,31,3775000.0
3775,3775999,20.862289654845867,38.02446473855045,0.08257663515896652,2478.6907348632812,291.3966248035431,1956.6443910598755,15537,3790,11747,11747,0,31,3776000.0
3776,3776999,20.86691597829502,38.03109930789526,0.08262727419913374,2479.4149518013,291.46949529647827,1956.7093019485474,15537,3790,11747,11747,0,31,3777000.0
3777,3777999,20.87028241223592,38.03392051949038,0.08264319455870839,2480.342367887497,291.54179978370667,1955.7492876052856,15539,3791,11748,11748,0,31,3778000.0
3778,3778999,20.870596172750385,38.033075357505844,0.08264300700653571,2480.6197123527527,291.6108305454254,1958.0092210769653,15549,3791,11758,11758,0,31,3779000.0
3779,3779999,20.869154177547706,38.034631398584054,0.08261252439327593,2481.106847047806,291.67739820480347,1959.2196626663208,15549,3791,11758,11758,0,31,3780000.0
3780,3780999,20.86805944698107,38.03370758230362,0.08259336118406613,2481.5947217941284,291.7435586452484,1960.4056367874146,15550,3791,11759,11759,0,31,3781000.0
3781,3781999,20.867053902184413,38.03220143001168,0.0825742333744468,2482.1886274814606,291.81401443481445,1960.9901628494263,15552,3792,11760,11760,0,31,3782000.0
3782,3782999,20.86606022481744,38.03097804086139,0.08255644261391792,2482.4896409511566,291.8802661895752,1963.1230058670044,15552,3792,11760,11760,0,31,3783000.0
3783,3783999,20.86512274947451,38.02877948917692,0.08253964987303208,2483.2757341861725,291.9474422931671,1962.6069917678833,15556,3794,11762,11762,0,31,3784000.0
3784,3784999,20.86409431130107,38.02790294658601,0.08252229540842049,2483.9482986927032,292.01486444473267,1962.616337776184,15560,3796,11764,11764,0,31,3785000.0
3785,3785999,20.863318404518534,38.026553600762796,0.08250779037368527,2484.6409797668457,292.08158016204834,1962.772343635559,15566,3797,11769,11769,0,31,3786000.0
3786,3786999,20.86241204804654,38.024753938797545,0.082493224810962,2484.9592385292053,292.15163946151733,1964.895230293274,15566,3797,11769,11769,0,31,3787000.0
3787,3787999,20.862576036668965,38.02722328823886,0.08247387691678365,2485.465968847275,292.2185664176941,1965.9035844802856,15568,3798,11770,11770,0,31,3788000.0
3788,3788999,20.864792321439776,38.03456124934568,0.0824199070728211,2486.5019907951355,292.2874836921692,1964.4449663162231,15568,3798,11770,11770,0,31,3789000.0
3789,3789999,20.869425489378365,38.049087531844556,0.0823755550014782,2486.916344642639,292.35319566726685,1966.0463304519653,15568,3798,11770,11770,0,31,3790000.0
3790,3790999,20.874522458391297,38.06801733305493,0.08237235243808805,2487.633446455002,292.41945695877075,1966.0265626907349,15568,3798,11770,11770,0,31,3791000.0
3791,3791999,20.88101937735082,38.086879387504204,0.08237813773241065,2488.3698828220367,292.4859712123871,1965.7187929153442,15574,3801,11773,11773,0,31,3792000.0
3792,3792999,20.888305068151833,38.10352816040121,0.08241568296258939,2489.322927236557,292.5526056289673,1964.3748140335083,15578,3803,11775,11775,0,31,3793000.0
3793,3793999,20.896511209817852,38.12368250926695,0.08247146039763675,2489.8065207004547,292.62153363227844,1965.5552415847778,15584,3804,11780,11780,0,31,3794000.0
3794,3794999,20.904824376635194,38.14221776445216,0.0825779375386877,2490.5020220279694,292.6897964477539,1965.5158205032349,15588,3806,11782,11782,0,31,3795000.0
3795,3795999,20.913599380527664,38.16121739035335,0.08267409286797034,2491.469455718994,292.76242208480835,1964.2730913162231,15594,3809,11785,11785,0,31,3796000.0
3796,3796999,20.921604673106497,38.1760135991027,0.082787093498913,2491.7669587135315,292.83155965805054,1966.4166231155396,15596,3810,11786,11786,0,31,3797000.0
3797,3797999,20.930200513426012,38.19171500112938,0.08292750950151873,2492.1704206466675,292.8982856273651,1968.0176210403442,15598,3811,11787,11787,0,31,3798000.0
3798,3798999,20.935195081757417,38.199037851849056,0.08301770735992375,2492.8474781513214,292.96666169166565,1968.0003099441528,15602,3813,11789,11789,0,31,3799000.0
3799,3799999,20.936106746244125,38.20066752627694,0.08292634778591934,2493.324143409729,293.031286239624,1969.2541246414185,15611,3813,11798,11798,0,31,3800000.0
3800,3800999,20.935981012250522,38.20016675686352,0.08283104324729285,2493.895563364029,293.0961003303528,1969.8066835403442,15613,3814,11799,11799,0,31,3801000.0
3801,3801999,20.936095768944234,38.20009466295025,0.08276157574008491,2494.3694984912872,293.1632995605469,1970.9227418899536,15615,3815,11800,11800,0,31,3802000.0
3802,3802999,20.93722090363412,38.203032407857684,0.08269476642677431,2495.239543199539,293.2302782535553,1970.0626497268677,15619,3817,11802,11802,0,31,3803000.0
3803,3803999,20.937358029589788,38.20247629076766,0.0826476469692814,2495.7402579784393,293.29740142822266,1971.1204271316528,15621,3818,11803,11803,0,31,3804000.0
3804,3804999,20.937285201150672,38.20148108961264,0.08259988014198238,2496.3492980003357,293.36637783050537,1971.6764421463013,15623,3819,11804,11804,0,31,3805000.0
3805,3805999,20.937334943710322,38.20159435789633,0.08255276176392456,2497.152990579605,293.43463134765625,1971.230839729309,15628,3820,11808,11808,0,31,3806000.0
3806,3806999,20.937975812573633,38.2013376465546,0.0825115696990365,2497.769338130951,293.5016417503357,1971.8064546585083,15628,3820,11808,11808,0,31,3807000.0
3807,3807999,20.93863347489183,38.20591224764756,0.08247113863270283,2498.430676460266,293.5762414932251,1972.3426713943481,15630,3821,11809,11809,0,31,3808000.0
3808,3808999,20.93977535769472,38.206854475582276,0.08246115723932645,2499.1296937465668,293.6446154117584,1972.198811531067,15641,3823,11818,11818,0,31,3809000.0
3809,3809999,20.940769960879045,38.20811725139923,0.08244058767532725,2499.9562814235687,293.71386337280273,1971.8452882766724,15642,3824,11818,11818,0,31,3810000.0
3810,3810999,20.94384750686993,38.216855018359986,0.08240136093065276,2500.5484941005707,293.78476786613464,1972.6442461013794,15642,3824,11818,11818,0,31,3811000.0
3811,3811999,20.947091097666338,38.22181857531151,0.08239270156789791,2501.404856443405,293.85694193840027,1972.1896409988403,15642,3824,11818,11818,0,31,3812000.0
3812,3812999,20.9504411096959,38.225355231479924,0.08240059819593493,2502.07980799675,293.9277687072754,1972.638440132141,15644,3825,11819,11819,0,31,3813000.0
3813,3813999,20.95501041937166,38.23197368835929,0.08241539827292277,2502.8029778003693,293.9985911846161,1972.7485628128052,15644,3825,11819,11819,0,31,3814000.0
3814,3814999,20.959987898618337,38.2421680281756,0.0824490032207047,2503.3285562992096,294.0736677646637,1973.713002204895,15646,3826,11820,11820,0,31,3815000.0
3815,3815999,20.965092049422882,38.251424781966136,0.08248989463118628,2504.037271261215,294.1483871936798,1973.6627626419067,15650,3828,11822,11822,0,31,3816000.0
3816,3816999,20.969233444478864,38.256838807195685,0.08256353619663515,2504.7498831748962,294.21959161758423,1973.729489326477,15652,3829,11823,11823,0,31,3817000.0
3817,3817999,20.973538568027664,38.26314415099345,0.08261928663316165,2505.6391274929047,294.29087495803833,1972.5816926956177,15662,3832,11830,11830,0,31,3818000.0
3818,3818999,20.977269174042544,38.266678775776946,0.08268681560547919,2506.447436094284,294.3632802963257,1972.1439943313599,15666,3834,11832,11832,0,31,3819000.0
3819,3819999,20.979072615236323,38.26692462094381,0.08268553090564434,2506.7393114566803,294.4317991733551,1974.352261543274,15671,3834,11837,11837,0,31,3820000.0
3820,3820999,20.978827098044253,38.26567530917917,0.08265061279709851,2507.3787598609924,294.5041151046753,1974.9967317581177,15675,3834,11841,11841,0,31,3821000.0
3821,3821999,20.97866801997712,38.26420431657008,0.08260593425725304,2507.958352327347,294.5689127445221,1975.4040880203247,15679,3836,11843,11843,0,31,3822000.0
3822,3822999,20.97845740674971,38.26335386665221,0.08256838573643821,2508.441483736038,294.6362965106964,1976.3685579299927,15683,3838,11845,11845,0,31,3823000.0
3823,3823999,20.977540347410606,38.261147184785294,0.08253844753518658,2509.2136754989624,294.7024428844452,1976.1797380447388,15685,3839,11846,11846,0,31,3824000.0
3824,3824999,20.97620840467619,38.25839825903881,0.08252410855273884,2509.8334169387817,294.769109249115,1976.8121690750122,15685,3839,11846,11846,0,31,3825000.0
3825,3825999,20.974697558440642,38.25520992654568,0.08251181321231582,2510.326738357544,294.8355448246002,1977.8908891677856,15687,3840,11847,11847,0,31,3826000.0
3826,3826999,20.973678951464056,38.25273721577871,0.08248839948609621,2510.732791662216,294.90234446525574,1979.599202156067,15687,3840,11847,11847,0,31,3827000.0
3827,3827999,20.97282101047343,38.25098031872559,0.08246112776425885,2511.4362499713898,294.96903371810913,1979.8068132400513,15687,3840,11847,11847,0,31,3828000.0
3828,3828999,20.97167550767109,38.24829710496363,0.08244137408583496,2512.3628253936768,295.0376777648926,1978.7965898513794,15689,3841,11848,11848,0,31,3829000.0
3829,3829999,20.97087339855818,38.246862103601735,0.08241826640480865,2513.097542285919,295.1060333251953,1978.8106355667114,15691,3842,11849,11849,0,31,3830000.0
3830,3830999,20.969985476380444,38.245189098129984,0.08239384037352138,2513.7026314735413,295.173455953598,1979.184666633606,15702,3845,11857,11857,0,31,3831000.0
3831,3831999,20.969440048867312,38.24397351603293,0.08237380093915869,2514.5108544826508,295.2412483692169,1978.951642036438,15702,3845,11857,11857,0,31,3832000.0
3832,3832999,20.968955804919474,38.24276531802596,0.08234840168558577,2515.2593290805817,295.31125020980835,1978.9189882278442,15702,3845,11857,11857,0,31,3833000.0
3833,3833999,20.968560827675415,38.24084279327513,0.08232723635543682,2515.967485189438,295.3801381587982,1978.9571886062622,15711,3847,11864,11864,0,31,3834000.0
3834,3834999,20.96840506778415,38.23961248810513,0.08229977594025595,2516.569495201111,295.44922733306885,1979.3536500930786,15719,3849,11870,11870,0,31,3835000.0
3835,3835999,20.968760139764658,38.23872677695643,0.08226673678493479,2517.0672268867493,295.5158939361572,1980.4829149246216,15719,3849,11870,11870,0,31,3836000.0
3836,3836999,20.9691516077589,38.238065945368184,0.08224724357434732,2517.7823038101196,295.58279728889465,1980.4143953323364,15720,3850,11870,11870,0,31,3837000.0
3837,3837999,20.969515483883647,38.23743557002736,0.08222385810393484,2518.586582660675,295.65303015708923,1980.1688508987427,15722,3851,11871,11871,0,31,3838000.0
3838,3838999,20.969789690424328,38.236414198910204,0.08219510704538413,2519.305210828781,295.7223150730133,1980.198338508606,15724,3852,11872,11872,0,31,3839000.0
3839,3839999,20.97051272941023,38.2355654657759,0.08217156673589865,2519.7981588840485,295.79299235343933,1981.1266984939575,15743,3855,11888,11888,0,31,3840000.0
3840,3840999,20.970227361352457,38.23347179071587,0.08215930506480151,2520.40567612648,295.8619394302368,1981.801106452942,15743,3855,11888,11888,0,31,3841000.0
3841,3841999,20.969523191614027,38.23146957969549,0.08213515127473281,2521.304698228836,295.93012952804565,1980.9283800125122,15754,3856,11898,11898,0,31,3842000.0
3842,3842999,20.968826808103515,38.230669755386266,0.08209541740933013,2521.982268810272,295.9988822937012,1981.0909929275513,15758,3857,11901,11901,0,31,3843000.0
3843,3843999,20.967702235825747,38.22859129786378,0.08207170026075739,2522.4569413661957,296.06649827957153,1982.1965532302856,15763,3859,11904,11904,0,31,3844000.0
3844,3844999,20.96651165021383,38.22608886006968,0.08205560825378111,2523.042051076889,296.13333559036255,1982.7484636306763,15770,3861,11909,11909,0,31,3845000.0
3845,3845999,20.96487572430077,38.22278998200059,0.08204748776226412,2523.342504262924,296.20009565353394,1984.886715888977,15770,3861,11909,11909,0,31,3846000.0
3846,3846999,20.963709219978487,38.22035998219557,0.08203689759394683,2524.1503756046295,296.2670044898987,1984.402112007141,15772,3862,11910,11910,0,31,3847000.0
3847,3847999,20.962240213771498,38.21756937183096,0.08203101878214492,2524.648756504059,296.33412194252014,1985.467869758606,15774,3863,11911,11911,0,31,3848000.0
3848,3848999,20.960786344637537,38.21443376590073,0.08203012745991678,2525.059956550598,296.4027473926544,1987.0422563552856,15774,3863,11911,11911,0,31,3849000.0
3849,3849999,20.959545868165254,38.21167122925853,0.08202670282183444,2525.9118101596832,296.4699273109436,1986.4578676223755,15774,3863,11911,11911,0,31,3850000.0
3850,3850999,20.958588780167403,38.2094917064628,0.08201916832334699,2526.652175426483,296.5393362045288,1986.4278230667114,15774,3863,11911,11911,0,31,3851000.0
3851,3851999,20.957897731442106,38.207731492379615,0.08200768871521158,2527.079058408737,296.61006784439087,1987.9981660842896,15774,3863,11911,11911,0,31,3852000.0
3852,3852999,20.957188095669366,38.207375205262984,0.08199837171960933,2527.6847925186157,296.6773769855499,1988.4464311599731,15776,3864,11912,11912,0,31,3853000.0
3853,3853999,20.95677514275446,38.20629046577626,0.0819849533246283,2528.277151107788,296.7442195415497,1988.9861345291138,15809,3866,11943,11943,0,31,3854000.0
3854,3854999,20.95656655215097,38.210678656230606,0.0819618939273169,2529.276873111725,296.8152482509613,1987.776005744934,15812,3868,11944,11944,0,31,3855000.0
3855,3855999,20.95582238974763,38.208331793222186,0.08195581334110214,2529.9554476737976,296.8832337856293,1988.0920610427856,15814,3869,11945,11945,0,31,3856000.0
3856,3856999,20.95554838728717,38.20669332044026,0.08195629280491668,2530.587904691696,296.9556682109833,1988.6755952835083,15814,3869,11945,11945,0,31,3857000.0
3857,3857999,20.95527423696948,38.20571327866716,0.08194695500604832,2531.204781770706,297.0229983329773,1989.295781135559,15816,3870,11946,11946,0,31,3858000.0
3858,3858999,20.95563083332822,38.20560623823778,0.08193642184344374,2532.0492284297943,297.09109687805176,1988.8035554885864,15818,3871,11947,11947,0,31,3859000.0
3859,3859999,20.95555123858578,38.20409841750752,0.0819267527791161,2533.349393606186,297.1609196662903,1985.6484880447388,15826,3875,11951,11951,0,31,3860000.0
3860,3860999,20.955590558675446,38.202798676916885,0.08191850420902913,2533.76211643219,297.23275327682495,1987.251675605774,15826,3875,11951,11951,0,31,3861000.0
3861,3861999,20.955196916971484,38.20079315877128,0.08191396343568225,2534.4602868556976,297.3027994632721,1987.307110786438,15843,3877,11966,11966,0,31,3862000.0
3862,3862999,20.954710107896474,38.200200664063665,0.08189329906678244,2534.840998649597,297.3694713115692,1989.229214668274,15850,3877,11973,11973,0,31,3863000.0
3863,3863999,20.95363243682649,38.19760511029203,0.0818838449252417,2535.314455509186,297.43595337867737,1990.5238237380981,15870,3878,11992,11992,0,31,3864000.0
3864,3864999,20.95236217327166,38.19527989938571,0.0818847259234805,2535.8153529167175,297.50517773628235,1991.7331972122192,15871,3878,11993,11993,0,31,3865000.0
3865,3865999,20.951394475955833,38.194284572556896,0.08187392383702252,2536.519645690918,297.57507705688477,1991.8446550369263,15873,3879,11994,11994,0,31,3866000.0
3866,3866999,20.95018354206083,38.19202702470452,0.08186629951358304,2537.4469981193542,297.6456456184387,1990.8592729568481,15875,3880,11995,11995,0,31,3867000.0
3867,3867999,20.948805773550554,38.19001214999668,0.08186361772198913,2538.343260526657,297.7144455909729,1989.899182319641,15880,3882,11998,11998,0,31,3868000.0
3868,3868999,20.94713619055966,38.18655726872975,0.0818634198484054,2538.7405993938446,297.78427171707153,1991.6355867385864,15880,3882,11998,11998,0,31,3869000.0
3869,3869999,20.946403777989968,38.18654219353239,0.08185099535194051,2539.5632147789,297.85183572769165,1991.1937837600708,15882,3883,11999,11999,0,31,3870000.0
3870,3870999,20.946093260438982,38.18564609254263,0.08184051255052283,2539.9632964134216,297.91807103157043,1992.7967195510864,15882,3883,11999,11999,0,31,3871000.0
3871,3871999,20.94613193022926,38.18647478303665,0.08181891671243924,2540.6126642227173,297.99081087112427,1993.3686265945435,15882,3883,11999,11999,0,31,3872000.0
3872,3872999,20.946304375750955,38.18636443934509,0.08180500060439655,2541.451614379883,298.05833864212036,1992.8449144363403,15884,3884,12000,12000,0,31,3873000.0
3873,3873999,20.946373159385566,38.185603105687115,0.0817907419092031,2542.3529143333435,298.12772250175476,1991.8470888137817,15903,3887,12016,12016,0,31,3874000.0
3874,3874999,20.94711540872335,38.18599039234155,0.08177275364047354,2542.9459989070892,298.19804072380066,1992.3907289505005,15911,3889,12022,12022,0,31,3875000.0
3875,3875999,20.947525468458664,38.18540893027733,0.08175612850238911,2543.446669101715,298.2687072753906,1993.4744997024536,15913,3890,12023,12023,0,31,3876000.0
3876,3876999,20.947667155327668,38.18444373961065,0.08174392585656276,2544.0728073120117,298.33683490753174,1994.036732673645,15913,3890,12023,12023,0,31,3877000.0
3877,3877999,20.947988788039172,38.18348932232487,0.0817318128341944,2544.4051740169525,298.40928077697754,1996.147213935852,15913,3890,12023,12023,0,31,3878000.0
3878,3878999,20.94847272864276,38.18278221204028,0.08171757250039746,2545.357606649399,298.47822308540344,1995.1574296951294,15913,3890,12023,12023,0,31,3879000.0
3879,3879999,20.948835801490084,38.1821881912131,0.08170380599389326,2546.491030931473,298.54665303230286,1993.301594734192,15913,3890,12023,12023,0,31,3880000.0
3880,3880999,20.949053012760967,38.18068331420932,0.08169383658860951,2547.2721428871155,298.61851382255554,1993.2173128128052,15913,3890,12023,12023,0,31,3881000.0
3881,3881999,20.948542622483824,38.17804042255478,0.08167344820293676,2547.8445796966553,298.686651468277,1994.0516023635864,15926,3891,12035,12035,0,31,3882000.0
3882,3882999,20.948522304207575,38.175753644429754,0.08162632832976235,2548.5330336093903,298.75398778915405,1994.373501777649,15989,3892,12097,12097,0,31,3883000.0
3883,3883999,20.94752408805666,38.17351641355147,0.08159921517726243,2549.03781914711,298.82375407218933,1995.5782136917114,15992,3893,12099,12099,0,31,3884000.0
3884,3884999,20.946617825361304,38.17133735194946,0.08157432534876663,2549.540961742401,298.8902542591095,1996.827961921692,15992,3893,12099,12099,0,31,3885000.0
3885,3885999,20.945901135750994,38.169516103453425,0.08154881467923347,2550.253352880478,298.96033930778503,1997.0138750076294,15993,3893,12100,12100,0,31,3886000.0
3886,3886999,20.945176938004433,38.16827702738178,0.08152579556465689,2551.134763240814,299.0287733078003,1996.4079484939575,15995,3894,12101,12101,0,31,3887000.0
3887,3887999,20.944313418349353,38.16583971437726,0.08151229521879977,2551.7261123657227,299.09880471229553,1997.1104707717896,15997,3895,12102,12102,0,31,3888000.0
3888,3888999,20.94350579450327,38.16359322387381,0.08149153105735163,2552.3506314754486,299.16645073890686,1997.6912126541138,15997,3895,12102,12102,0,31,3889000.0
3889,3889999,20.94321597292606,38.162450167824524,0.08146977040285008,2553.046331882477,299.2335524559021,1997.7071962356567,16006,3897,12109,12109,0,31,3890000.0
3890,3890999,20.943012264124654,38.16229204539856,0.08143597063979136,2553.4546761512756,299.30548882484436,1999.1909074783325,16007,3898,12109,12109,0,31,3891000.0
3891,3891999,20.943110144426207,38.16224040273227,0.0814121614490666,2554.263829946518,299.3748755455017,1998.4261293411255,16027,3902,12125,12125,0,31,3892000.0
3892,3892999,20.943704281400755,38.16252513955586,0.08140136118716457,2554.7818343639374,299.44735956192017,1999.605923652649,16027,3902,12125,12125,0,31,3893000.0
3893,3893999,20.94452577086385,38.16593801863549,0.08136663168010105,2555.298604249954,299.5157482624054,2000.7251405715942,16027,3902,12125,12125,0,31,3894000.0
3894,3894999,20.945490260003325,38.16595648720273,0.08136328256310976,2556.0023906230927,299.5835163593292,2000.759129524231,16029,3903,12126,12126,0,31,3895000.0
3895,3895999,20.94683718887817,38.166954498486916,0.08136488351113169,2556.613724708557,299.6541609764099,2001.3934907913208,16036,3904,12132,12132,0,31,3896000.0
3896,3896999,20.948711270767973,38.169895188963146,0.0813563080486912,2557.240570306778,299.72531509399414,2001.9427995681763,16038,3905,12133,12133,0,31,3897000.0
3897,3897999,20.950417282337053,38.17235743814601,0.08135914488595497,2558.181901216507,299.7957408428192,2000.6582384109497,16042,3907,12135,12135,0,31,3898000.0
3898,3898999,20.95212924281294,38.17510952557299,0.08135897305006201,2558.4938790798187,299.8669083118439,2002.769413948059,16042,3907,12135,12135,0,31,3899000.0
3899,3899999,20.953934909568844,38.17865289429865,0.08135711695274761,2559.2518348693848,299.93774938583374,2002.4021577835083,16047,3910,12137,12137,0,31,3900000.0
3900,3900999,20.955828297983135,38.17924102583499,0.08135647252492695,2559.9290668964386,300.0082974433899,2002.3778734207153,16052,3913,12139,12139,0,31,3901000.0
3901,3901999,20.95661947374857,38.17804642010058,0.08134338567608246,2560.55654835701,300.0810799598694,2002.7668199539185,16054,3914,12140,12140,0,31,3902000.0
3902,3902999,20.956090919107268,38.179498702625715,0.08130333939792522,2561.0078015327454,300.1488661766052,2004.3682298660278,16074,3915,12159,12159,0,31,3903000.0
3903,3903999,20.954704540214408,38.176845876530805,0.08127680035502205,2561.5795726776123,300.2168755531311,2004.674885749817,16083,3918,12165,12165,0,31,3904000.0
3904,3904999,20.953620985008214,38.17443594189311,0.0812475998082125,2561.983947992325,300.2859284877777,2006.3404664993286,16083,3918,12165,12165,0,31,3905000.0
3905,3905999,20.952697587186265,38.1733491924277,0.08121703896290511,2562.4843883514404,300.35294818878174,2007.474446296692,16083,3918,12165,12165,0,31,3906000.0
3906,3906999,20.95145704169967,38.171047044626,0.08119289991470113,2563.4494059085846,300.42083501815796,2006.1187181472778,16094,3921,12173,12173,0,31,3907000.0
3907,3907999,20.950214418094564,38.16862467254462,0.08117901315899023,2563.9355416297913,300.48879742622375,2007.1951036453247,16096,3922,12174,12174,0,31,3908000.0
3908,3908999,20.949108098840448,38.168881853464256,0.08115307042412845,2564.4412508010864,300.55699038505554,2008.2823610305786,16096,3922,12174,12174,0,31,3909000.0
3909,3909999,20.947951024297225,38.16629722220037,0.08113341474251379,2565.183396100998,300.6288299560547,2008.3271684646606,16098,3923,12175,12175,0,31,3910000.0
3910,3910999,20.947605894426452,38.16534543744458,0.08110378591502865,2565.7011139392853,300.6973297595978,2009.3405046463013,16100,3924,12176,12176,0,31,3911000.0
3911,3911999,20.947225945421472,38.16400620349559,0.08107514116656267,2566.480983734131,300.7663598060608,2009.1572008132935,16102,3925,12177,12177,0,31,3912000.0
3912,3912999,20.946802362236305,38.16227438361216,0.08105527433807569,2566.952296257019,300.83548617362976,2010.4842042922974,16103,3926,12177,12177,0,31,3913000.0
3913,3913999,20.947728507901196,38.16950668735994,0.08099565632110994,2567.653481245041,300.90476274490356,2010.5167818069458,16104,3927,12177,12177,0,31,3914000.0
3914,3914999,20.9482592216581,38.169319833374885,0.08096410033487611,2568.3740479946136,300.9751660823822,2010.6188173294067,16104,3927,12177,12177,0,31,3915000.0
3915,3915999,20.948961285245723,38.168899324717216,0.08094007490944088,2569.035978078842,301.04640889167786,2011.0365495681763,16106,3928,12178,12178,0,31,3916000.0
3916,3916999,20.950014935869667,38.169079056092464,0.08091975273273821,2569.8269050121307,301.11642718315125,2010.8106660842896,16108,3929,12179,12179,0,31,3917000.0
3917,3917999,20.951030037806884,38.169642299639975,0.08088991357638398,2570.33865070343,301.18682646751404,2011.9125871658325,16108,3929,12179,12179,0,31,3918000.0
3918,3918999,20.952490839066915,38.17073425417611,0.080867258290507,2570.997371673584,301.26361298561096,2012.4602556228638,16108,3929,12179,12179,0,31,3919000.0
3919,3919999,20.953955556803212,38.17167552720086,0.08084875979893735,2571.863033056259,301.3357081413269,2011.9694566726685,16108,3929,12179,12179,0,31,3920000.0
3920,3920999,20.95515090320481,38.17195188377755,0.08082469060435993,2572.372570514679,301.4056887626648,2013.026623725891,16108,3929,12179,12179,0,31,3921000.0
3921,3921999,20.957332175270334,38.17608806665272,0.08080688244154544,2572.8552141189575,301.47771763801575,2014.0151643753052,16126,3931,12195,12195,0,31,3922000.0
3922,3922999,20.958541196852373,38.17645459450047,0.08079104969912343,2573.3296098709106,301.54837441444397,2015.0817232131958,16141,3933,12208,12208,0,31,3923000.0
3923,3923999,20.95874554638785,38.17542184369364,0.08076564414660514,2573.7878732681274,301.6161301136017,2016.4437227249146,16159,3934,12225,12225,0,31,3924000.0
3924,3924999,20.958069307624147,38.17324290136472,0.08071782832155183,2574.1928248405457,301.6885974407196,2018.1459703445435,16162,3934,12228,12228,0,31,3925000.0
3925,3925999,20.957180014348058,38.17138098536725,0.0806862365722103,2574.6720185279846,301.75944352149963,2019.1508836746216,16181,3936,12245,12245,0,31,3926000.0
3926,3926999,20.95653373519842,38.17020971148899,0.08065671496960747,2575.1250030994415,301.82733964920044,2020.4636888504028,16185,3938,12247,12247,0,31,3927000.0
3927,3927999,20.95559121524366,38.168313544347455,0.08063542241046817,2575.5132303237915,301.89532375335693,2022.2793169021606,16186,3938,12248,12248,0,31,3928000.0
3928,3928999,20.954387151454963,38.16650166376663,0.08062780140716297,2576.1015758514404,301.96278738975525,2022.9570665359497,16188,3939,12249,12249,0,31,3929000.0
3929,3929999,20.953454611170482,38.16403431381122,0.08061588260088604,2576.525493621826,302.0303030014038,2024.6437578201294,16188,3939,12249,12249,0,31,3930000.0
3930,3930999,20.95258413316603,38.161681572001214,0.08060561348244522,2577.5159504413605,302.0986852645874,2023.301510810852,16197,3941,12256,12256,0,31,3931000.0
3931,3931999,20.951569347244554,38.15890393503601,0.08059788185253691,2578.0324885845184,302.16656827926636,2024.2408418655396,16199,3942,12257,12257,0,31,3932000.0
3932,3932999,20.950786891196415,38.15676887677753,0.08058410417604522,2589.4938504695892,302.23424005508423,2025.0888032913208,16204,3944,12260,12260,0,31,3933000.0
3933,3933999,20.950574393836234,38.15947113074089,0.08055993331433531,2590.1019043922424,302.30500650405884,2025.2892961502075,16210,3947,12263,12263,0,31,3934000.0
3934,3934999,20.95014568215546,38.15780664036665,0.08054443113046872,2591.0310900211334,302.3753399848938,2024.2099962234497,16215,3949,12266,12266,0,31,3935000.0
3935,3935999,20.950157960644525,38.15741010471231,0.0805275668630353,2591.9341011047363,302.44667077064514,2023.092411994934,16226,3953,12273,12273,0,31,3936000.0
3936,3936999,20.95092880110932,38.157547772821495,0.08050419784657525,2592.7932255268097,302.5171401500702,2022.8231477737427,16226,3953,12273,12273,0,31,3937000.0
3937,3937999,20.952119754010745,38.15854834482066,0.08049573663546139,2593.5964369773865,302.58779215812683,2022.174168586731,16235,3955,12280,12280,0,31,3938000.0
3938,3938999,20.952878038848826,38.15838041583251,0.08048772545000371,2594.0815658569336,302.65912413597107,2023.7071352005005,16235,3955,12280,12280,0,31,3939000.0
3939,3939999,20.95449420623173,38.159647415501055,0.0804824387020856,2594.6841974258423,302.72827410697937,2024.2663621902466,16237,3956,12281,12281,0,31,3940000.0
3940,3940999,20.95625132217981,38.16096127513622,0.08047765614459601,2595.6017479896545,302.79867911338806,2023.4280138015747,16237,3956,12281,12281,0,31,3941000.0
3941,3941999,20.958378339251546,38.16234676174416,0.08046664327405306,2596.3955161571503,302.86852645874023,2023.1310777664185,16240,3957,12283,12283,0,31,3942000.0
3942,3942999,20.9592653490822,38.16189611036684,0.08046126607861126,2596.8090229034424,302.9379689693451,2024.7302751541138,16240,3957,12283,12283,0,31,3943000.0
3943,3943999,20.9602894510191,38.16151225727995,0.08045779535388764,2597.317144870758,303.0060544013977,2025.7814455032349,16242,3958,12284,12284,0,31,3944000.0
3944,3944999,20.960119235371497,38.159752351573076,0.08045165148105393,2598.330399990082,303.0748634338379,2024.5495805740356,16253,3959,12294,12294,0,31,3945000.0
3945,3945999,20.95925522642336,38.15939513402322,0.08043254398355904,2599.0133080482483,303.14676809310913,2024.941906929016,16319,3960,12359,12359,0,31,3946000.0
3946,3946999,20.958377847708025,38.158921264268116,0.08043373866382264,2599.8391580581665,303.2187943458557,2024.729329109192,16319,3960,12359,12359,0,31,3947000.0
3947,3947999,20.958273491977252,38.16127589738059,0.08041606005770974,2600.338665485382,303.28803420066833,2025.9240999221802,16322,3961,12361,12361,0,31,3948000.0
3948,3948999,20.959010315018443,38.164295281801145,0.08043094182823585,2600.902736186981,303.3590259552002,2026.5375185012817,16340,3964,12376,12376,0,31,3949000.0
3949,3949999,20.960038040815988,38.169313488504415,0.08043958537172713,2601.5943326950073,303.42770648002625,2026.6217317581177,16349,3966,12383,12383,0,31,3950000.0
3950,3950999,20.960362917872672,38.17071416235923,0.08045713715839753,2602.1252353191376,303.49797797203064,2027.7464876174927,16349,3966,12383,12383,0,31,3951000.0
3951,3951999,20.961055971923887,38.17337451341824,0.08046712994333327,2602.7346210479736,303.5665729045868,2028.4353609085083,16349,3966,12383,12383,0,31,3952000.0
3952,3952999,20.962184336808225,38.175652010613,0.08049278778465563,2603.3782665729523,303.6375620365143,2028.9438524246216,16351,3967,12384,12384,0,31,3953000.0
3953,3953999,20.963602553608492,38.18038084325266,0.0805125782531344,2603.9071514606476,303.7054033279419,2030.0259447097778,16351,3967,12384,12384,0,31,3954000.0
3954,3954999,20.965012618584293,38.183451072092524,0.08053098059749286,2604.70689201355,303.7741792201996,2029.5603456497192,16352,3968,12384,12384,0,31,3955000.0
3955,3955999,20.96709902186922,38.187985328556785,0.08054560058940718,2605.2037525177,303.84258460998535,2030.6904802322388,16354,3969,12385,12385,0,31,3956000.0
3956,3956999,20.96845927263784,38.19040519867378,0.08059409111673432,2605.832929611206,303.9159815311432,2031.047245979309,16358,3971,12387,12387,0,31,3957000.0
3957,3957999,20.97021851238923,38.192376147420646,0.08062117855631379,2606.2310037612915,303.9840371608734,2032.65269947052,16365,3972,12393,12393,0,31,3958000.0
3958,3958999,20.972371051848995,38.195626739956126,0.08063502292204316,2607.025767803192,304.05471444129944,2032.1541948318481,16369,3974,12395,12395,0,31,3959000.0
3959,3959999,20.97476520298852,38.198387367781706,0.08067073523135149,2607.687662601471,304.12558674812317,2032.6405229568481,16369,3974,12395,12395,0,31,3960000.0
3960,3960999,20.977795542052714,38.20254730231269,0.08071330040275926,2608.1041543483734,304.1947455406189,2034.2360200881958,16369,3974,12395,12395,0,31,3961000.0
3961,3961999,20.98263348943303,38.22018737263484,0.08073838884144724,2608.8115406036377,304.26444387435913,2034.2431154251099,16371,3975,12396,12396,0,31,3962000.0
3962,3962999,20.98653523451384,38.22740989145112,0.08080092791514581,2609.3255546092987,304.33311223983765,2035.3056840896606,16378,3976,12402,12402,0,31,3963000.0
3963,3963999,20.990799596554762,38.2361812281779,0.080830773330972,2609.832133293152,304.4016795158386,2036.215542793274,16394,3977,12417,12417,0,31,3964000.0
3964,3964999,20.994028198182463,38.24042316420164,0.0808700522234308,2610.5240349769592,304.47675132751465,2036.679699897766,16396,3978,12418,12418,0,31,3965000.0
3965,3965999,20.99479797621908,38.24379070067334,0.08086951950180343,2610.8963799476624,304.54828929901123,2038.4906663894653,16410,3979,12431,12431,0,31,3966000.0
3966,3966999,20.993681687834435,38.24411499321048,0.08085170181668477,2611.3468194007874,304.6149275302887,2039.6936082839966,16416,3981,12435,12435,0,31,3967000.0
3967,3967999,20.99301915311345,38.2444247084664,0.08084304271973508,2612.149770975113,304.688845872879,2039.246190071106,16421,3983,12438,12438,0,31,3968000.0
3968,3968999,20.992981110597913,38.245949058392256,0.08083598832623817,2612.810830593109,304.7552800178528,2039.340786933899,16425,3985,12440,12440,0,31,3969000.0
3969,3969999,20.99309702080605,38.24615026145241,0.08084751076502372,2613.224937438965,304.82474422454834,2040.9673204421997,16428,3986,12442,12442,0,31,3970000.0
3970,3970999,20.993710358032246,38.24699454132815,0.08086200592564641,2614.332272529602,304.8955821990967,2038.7064027786255,16434,3989,12445,12445,0,31,3971000.0
3971,3971999,20.994334721218106,38.24762329074855,0.0808853530871867,2614.922125816345,304.9661657810211,2039.1725358963013,16438,3991,12447,12447,0,31,3972000.0
3972,3972999,20.995976959520874,38.25076273188775,0.08091725978821052,2615.337813615799,305.03479743003845,2040.8131380081177,16438,3991,12447,12447,0,31,3973000.0
3973,3973999,20.998076398266367,38.2547667180752,0.08092670516416733,2616.1579773426056,305.10768127441406,2040.384388923645,16442,3993,12449,12449,0,31,3974000.0
3974,3974999,21.000490502827653,38.25878284666106,0.08095154081375289,2616.8099019527435,305.17946672439575,2041.0045900344849,16442,3993,12449,12449,0,31,3975000.0
3975,3975999,21.00458810840268,38.26667186204808,0.08103922142505393,2617.6499807834625,305.25134778022766,2040.5075426101685,16446,3995,12451,12451,0,31,3976000.0
3976,3976999,21.00973509806125,38.282610554333424,0.08110651475844532,2618.2615127563477,305.31870794296265,2041.055546760559,16448,3996,12452,12452,0,31,3977000.0
3977,3977999,21.01554848156122,38.29278535457052,0.0811941360852092,2618.7840020656586,305.38590455055237,2042.2171068191528,16448,3996,12452,12452,0,31,3978000.0
3978,3978999,21.021436419408925,38.30319137508029,0.08133806754599404,2619.5266115665436,305.4606943130493,2042.503300666809,16450,3997,12453,12453,0,31,3979000.0
3979,3979999,21.027265392977938,38.314878275257875,0.08145881043882397,2620.262408018112,305.5283930301666,2042.5734376907349,16450,3997,12453,12453,0,31,3980000.0
3980,3980999,21.035140261955377,38.333095204620705,0.08160334621668586,2620.884188890457,305.5953414440155,2043.18150806427,16450,3997,12453,12453,0,31,3981000.0
3981,3981999,21.04154610786411,38.34582132698507,0.08174906470210419,2621.8901455402374,305.6641116142273,2041.3158464431763,16468,4002,12466,12466,0,31,3982000.0
3982,3982999,21.048563254498195,38.35890579228923,0.0819102388495847,2622.3979964256287,305.7310457229614,2042.5115938186646,16468,4002,12466,12466,0,31,3983000.0
3983,3983999,21.054772096281454,38.36786024145968,0.08207085797910685,2623.0550713539124,305.80266642570496,2043.104329109192,16468,4002,12466,12466,0,31,3984000.0
3984,3984999,21.06165049083283,38.37976616522786,0.082217072542905,2623.8550045490265,305.8749315738678,2042.7830934524536,16471,4004,12467,12467,0,31,3985000.0
3985,3985999,21.06705260549265,38.38953974572892,0.08232034058442139,2624.6515872478485,305.9436113834381,2042.7023286819458,16478,4005,12473,12473,0,31,3986000.0
3986,3986999,21.06611153204672,38.38867415155972,0.08229845261631774,2625.226985692978,306.0152382850647,2043.3682985305786,16488,4007,12481,12481,0,31,3987000.0
3987,3987999,21.065011950761974,38.38690265942113,0.08228983485814934,2625.6272599697113,306.0852642059326,2045.0688676834106,16489,4007,12482,12482,0,31,3988000.0
3988,3988999,21.06447377564857,38.385771880490104,0.08227313726461194,2626.429155111313,306.15680408477783,2044.7632265090942,16558,4010,12548,12548,0,31,3989000.0
3989,3989999,21.06397149568291,38.38592497252183,0.08225248304985455,2627.1200366020203,306.2239713668823,2045.1318635940552,16562,4011,12551,12551,0,31,3990000.0
3990,3990999,21.06308947531259,38.3839116856547,0.0822404730421088,2627.734861135483,306.2928047180176,2045.823124885559,16562,4011,12551,12551,0,31,3991000.0
3991,3991999,21.062256110102417,38.38179065296408,0.08222898109686294,2628.1295335292816,306.359445810318,2047.469006538391,16562,4011,12551,12551,0,31,3992000.0
3992,3992999,21.06162267341678,38.38040270084523,0.08222229942675274,2628.7326130867004,306.42715072631836,2048.033658027649,16569,4012,12557,12557,0,31,3993000.0
3993,3993999,21.06138050885909,38.37956211054201,0.08220418384614137,2629.448696374893,306.496985912323,2048.080563545227,16572,4013,12559,12559,0,31,3994000.0
3994,3994999,21.061040184226325,38.37831121149745,0.08219349103062157,2629.854335308075,306.56593799591064,2049.601475715637,16575,4014,12561,12561,0,31,3995000.0
3995,3995999,21.0608522237756,38.37737093329835,0.08217691150274808,2630.448889732361,306.6342532634735,2050.097783088684,16580,4016,12564,12564,0,31,3996000.0
3996,3996999,21.061266374828712,38.377488965391095,0.0821615017878945,2631.0235295295715,306.7025442123413,2050.947346687317,16587,4017,12570,12570,0,31,3997000.0
3997,3997999,21.062077004241843,38.377462877807815,0.08214757454580002,2631.540828704834,306.7709650993347,2052.066746711731,16587,4017,12570,12570,0,31,3998000.0
3998,3998999,21.063888608923353,38.37977347338727,0.08213513070595946,2632.163652420044,306.84013843536377,2052.644841194153,16587,4017,12570,12570,0,31,3999000.0
3999,3999999,21.065167367261477,38.3807374688697,0.0821250954813254,2633.092886209488,306.9096510410309,2051.18630695343,16629,4022,12607,12607,0,31,4000000.0
4000,4000999,21.06670015321492,38.38203143734866,0.08212927529094849,2633.4738602638245,306.98361897468567,2053.142575263977,16629,4022,12607,12607,0,31,4001000.0
4001,4001999,21.068242947544512,38.382800896684294,0.08213855100256451,2633.963820695877,307.05313420295715,2054.1882219314575,16634,4024,12610,12610,0,31,4002000.0
4002,4002999,21.06920696726497,38.38235653181733,0.082146360804363,2634.1704075336456,307.1234414577484,2056.865635871887,16634,4024,12610,12610,0,31,4003000.0
4003,4003999,21.070459533409412,38.38258866828046,0.08216479380574615,2634.89732837677,307.19346261024475,2056.9547777175903,16634,4024,12610,12610,0,31,4004000.0
4004,4004999,21.071509348481037,38.38247624492883,0.0821725313207764,2635.4010891914368,307.2659056186676,2058.389012336731,16634,4024,12610,12610,0,31,4005000.0
4005,4005999,21.072608924485984,38.38204475702174,0.08220219874222101,2635.897547721863,307.33628273010254,2059.460835456848,16636,4025,12611,12611,0,31,4006000.0
4006,4006999,21.072636790861484,38.38036726905751,0.08222943734942512,2636.708596944809,307.4042913913727,2058.980984687805,16643,4026,12617,12617,0,31,4007000.0
4007,4007999,21.07110720137795,38.37729760023743,0.08223182955911579,2637.27055311203,307.47471261024475,2059.9801454544067,16651,4026,12625,12625,0,31,4008000.0
4008,4008999,21.069662960666513,38.375340403380285,0.08222976647133262,2637.6681835651398,307.5425977706909,2061.6527376174927,16654,4026,12628,12628,0,31,4009000.0
4009,4009999,21.068388976479056,38.37574279763644,0.0822181050597478,2638.467443227768,307.6099534034729,2061.1635942459106,16686,4029,12657,12657,0,31,4010000.0
4010,4010999,21.066842655371413,38.37296465861949,0.08222358364511395,2639.3017299175262,307.6770808696747,2060.7721452713013,16687,4029,12658,12658,0,31,4011000.0
4011,4011999,21.065256084507133,38.37006289438511,0.0822257649303918,2639.990713596344,307.7443642616272,2060.8186616897583,16697,4032,12665,12665,0,31,4012000.0
4012,4012999,21.063852336148983,38.367331145547205,0.082222298903884,2640.617136478424,307.8143434524536,2061.3610887527466,16699,4033,12666,12666,0,31,4013000.0
4013,4013999,21.0623216436038,38.364645922300014,0.08222115472424885,2640.9490337371826,307.8817734718323,2063.3564500808716,16699,4033,12666,12666,0,31,4014000.0
4014,4014999,21.06110796157183,38.362866347763465,0.08221472730471457,2641.983769416809,307.9496908187866,2062.1696825027466,16706,4035,12671,12671,0,31,4015000.0
4015,4015999,21.059665461575012,38.360102465535974,0.08221522858402297,2642.696472644806,308.0178191661835,2062.3855562210083,16710,4036,12674,12674,0,31,4016000.0
4016,4016999,21.058549338749856,38.35941806539432,0.08220176717515004,2643.5660169124603,308.08821964263916,2061.341000556946,16714,4038,12676,12676,0,31,4017000.0
4017,4017999,21.05743504889175,38.35712294195829,0.08219626249304202,2644.146230697632,308.1583888530731,2062.361439704895,16714,4038,12676,12676,0,31,4018000.0
4018,4018999,21.056404303089543,38.3548614910039,0.08218973745738911,2644.8923313617706,308.23024559020996,2062.370144844055,16716,4039,12677,12677,0,31,4019000.0
4019,4019999,21.05638750393323,38.36033887540144,0.08214450858025169,2645.4038610458374,308.29885482788086,2063.527096748352,16716,4039,12677,12677,0,31,4020000.0
4020,4020999,21.055959753976918,38.359784214536425,0.08213476378699713,2646.2196457386017,308.36992621421814,2063.0219011306763,16718,4040,12678,12678,0,31,4021000.0
4021,4021999,21.056451216321218,38.36160329867265,0.08210987129322311,2646.634106874466,308.43831038475037,2064.6147661209106,16718,4040,12678,12678,0,31,4022000.0
4022,4022999,21.05671014723135,38.36043933200028,0.08210475904012915,2647.155558824539,308.51011991500854,2065.622227668762,16721,4041,12680,12680,0,31,4023000.0
4023,4023999,21.057174337655358,38.361436304107926,0.08209024890869177,2648.213936805725,308.5809733867645,2064.0336198806763,16724,4042,12682,12682,0,31,4024000.0
4024,4024999,21.057613106206265,38.36051742131859,0.08208092998250271,2648.7103967666626,308.6478555202484,2065.1133699417114,16742,4043,12699,12699,0,31,4025000.0
4025,4025999,21.056948228679712,38.35867897692863,0.08206875503951228,2649.511596441269,308.71544337272644,2064.7982149124146,16744,4044,12700,12700,0,31,4026000.0
4026,4026999,21.05537731050407,38.35626259025228,0.08206789215341692,2650.2236754894257,308.7831332683563,2065.07213306427,16759,4045,12714,12714,0,31,4027000.0
4027,4027999,21.05415948039841,38.355464058557864,0.08205350649588516,2650.689943790436,308.8508257865906,2066.218892097473,16775,4047,12728,12728,0,31,4028000.0
4028,4028999,21.052649674025755,38.35248185391656,0.0820572893776933,2651.1512157917023,308.91807079315186,2067.802128791809,16776,4047,12729,12729,0,31,4029000.0
4029,4029999,21.051058517529942,38.349950585646745,0.08205520365244745,2651.448249101639,308.98545265197754,2070.0216569900513,16777,4047,12730,12730,0,31,4030000.0
4030,4030999,21.049714035238694,38.3484995619194,0.08204516252009952,2652.3370566368103,309.05433082580566,2069.021580696106,16781,4049,12732,12732,0,31,4031000.0
4031,4031999,21.048098381875672,38.34532286088698,0.08204144845288563,2652.7340126037598,309.1243395805359,2070.7236070632935,16781,4049,12732,12732,0,31,4032000.0
4032,4032999,21.046782060777684,38.34362686439806,0.08203400544085826,2653.029884815216,309.19215083122253,2072.975598335266,16782,4049,12733,12733,0,31,4033000.0
4033,4033999,21.04587266274859,38.34736702418031,0.0819955574609964,2653.7439897060394,309.26132369041443,2072.9913148880005,16791,4051,12740,12740,0,31,4034000.0
4034,4034999,21.044756054193645,38.34567670068334,0.08198861921366218,2654.4507145881653,309.33157563209534,2073.2507219314575,16792,4051,12741,12741,0,31,4035000.0
4035,4035999,21.043961753725956,38.34441034792524,0.08196835166313687,2655.449971675873,309.4030861854553,2071.7432527542114,16800,4053,12747,12747,0,31,4036000.0
4036,4036999,21.043391452771836,38.34535110354048,0.08194235156620933,2656.243792772293,309.47446298599243,2071.3313493728638,16800,4053,12747,12747,0,31,4037000.0
4037,4037999,21.042816390086976,38.34375878004694,0.08192999176544391,2656.665016412735,309.54276514053345,2072.976384162903,16800,4053,12747,12747,0,31,4038000.0
4038,4038999,21.042444347978268,38.34306399250069,0.08191600656628306,2657.249739408493,309.6117796897888,2073.7976503372192,16800,4053,12747,12747,0,31,4039000.0
4039,4039999,21.04255271725849,38.344582577372705,0.08188110093883627,2657.753385782242,309.681756734848,2074.9206743240356,16800,4053,12747,12747,0,31,4040000.0
4040,4040999,21.04226768172708,38.343227971816084,0.08186695138482791,2658.266006708145,309.7497525215149,2076.1234407424927,16800,4053,12747,12747,0,31,4041000.0
4041,4041999,21.043126695816298,38.34329513137225,0.08184219810555315,2658.9749698638916,309.8185091018677,2076.1363649368286,16802,4054,12748,12748,0,31,4042000.0
4042,4042999,21.043243889861888,38.34228010009,0.08182872588625267,2659.592812538147,309.88731503486633,2076.546544075012,16804,4055,12749,12749,0,31,4043000.0
4043,4043999,21.043898258904637,38.34195412308486,0.08181684499571285,2660.210346698761,309.9560308456421,2077.20836353302,16804,4055,12749,12749,0,31,4044000.0
4044,4044999,21.044694667862803,38.34163925926555,0.08180253690608852,2661.2080779075623,310.0259518623352,2075.616047859192,16817,4059,12758,12758,0,31,4045000.0
4045,4045999,21.044933451497215,38.3404279393258,0.08179119242182509,2661.7944984436035,310.09669828414917,2076.5587587356567,16819,4060,12759,12759,0,31,4046000.0
4046,4046999,21.044368590248876,38.33926024530982,0.08177680059993053,2662.599381685257,310.16489267349243,2076.1962099075317,16832,4061,12771,12771,0,31,4047000.0
4047,4047999,21.042541425974633,38.33820213107073,0.08177298251207632,2663.2771470546722,310.23274517059326,2076.380024909973,16836,4062,12774,12774,0,31,4048000.0
4048,4048999,21.040847382983824,38.335456298790675,0.08177089893049361,2663.9755878448486,310.30043292045593,2076.4993867874146,16836,4062,12774,12774,0,31,4049000.0
4049,4049999,21.03933856613772,38.3333014021185,0.08176574093126843,2664.425373315811,310.3657727241516,2077.9867372512817,16836,4062,12774,12774,0,31,4050000.0
4050,4050999,21.037928197104105,38.330451520372215,0.0817630270433527,2664.943546295166,310.43593883514404,2079.1185960769653,16837,4062,12775,12775,0,31,4051000.0
4051,4051999,21.036748911635133,38.32791474162623,0.08175964543055425,2665.546821832657,310.50415301322937,2079.6923723220825,16839,4063,12776,12776,0,31,4052000.0
4052,4052999,21.036037955098525,38.326429077677425,0.08175198417765073,2666.263844013214,310.5743741989136,2079.7385301589966,16839,4063,12776,12776,0,31,4053000.0
4053,4053999,21.03555867910734,38.32510397227896,0.08174206679684537,2666.769276857376,310.64443612098694,2080.8231706619263,16839,4063,12776,12776,0,31,4054000.0
4054,4054999,21.035248118833895,38.32405428059576,0.08173279891997942,2667.564151287079,310.71374440193176,2080.122899055481,16870,4067,12803,12803,0,31,4055000.0
4055,4055999,21.035400642979845,38.324003984331846,0.08171899560821794,2668.0566942691803,310.78108835220337,2081.309163093567,16878,4068,12810,12810,0,31,4056000.0
4056,4056999,21.036060945536377,38.32548155531751,0.0816913075595962,2668.7623550891876,310.8545262813568,2081.547543525696,16878,4068,12810,12810,0,31,4057000.0
4057,4057999,21.036864682005255,38.327080224726224,0.08167088087251984,2669.458371400833,310.92529034614563,2081.4131746292114,16896,4072,12824,12824,0,31,4058000.0
4058,4058999,21.0378269451722,38.32944196646692,0.08165614692437162,2670.0745713710785,310.99482917785645,2081.9661378860474,16898,4073,12825,12825,0,31,4059000.0
4059,4059999,21.038976074687863,38.33102065533093,0.0816581839663646,2670.7604422569275,311.06425738334656,2081.8650789260864,16904,4076,12828,12828,0,31,4060000.0
4060,4060999,21.040131810373342,38.33207724568448,0.08165248421697635,2671.1406874656677,311.13674807548523,2083.760838508606,16905,4077,12828,12828,0,31,4061000.0
4061,4061999,21.041773233047266,38.33423042240596,0.08166736091680371,2671.641124486923,311.20744609832764,2084.846386909485,16907,4078,12829,12829,0,31,4062000.0
4062,4062999,21.04368409851159,38.336328270363126,0.08169069037599364,2672.3447544574738,311.2773036956787,2084.8986711502075,16909,4079,12830,12830,0,31,4063000.0
4063,4063999,21.04570685142328,38.33799426680117,0.08169485818760847,2673.1576356887817,311.3481409549713,2084.438542366028,16916,4080,12836,12836,0,31,4064000.0
4064,4064999,21.047227528491604,38.33882170006386,0.08170804147643629,2673.7706801891327,311.4228935241699,2085.1999254226685,16916,4080,12836,12836,0,31,4065000.0
4065,4065999,21.04932556882117,38.3403158468033,0.08170035957912192,2674.2767491340637,311.49207615852356,2086.2435960769653,16918,4081,12837,12837,0,31,4066000.0
4066,4066999,21.050613449734264,38.339982135113644,0.081712896936043,2675.4795265197754,311.56391072273254,2083.657063484192,16926,4084,12842,12842,0,31,4067000.0
4067,4067999,21.051921836103507,38.34257635330236,0.08170085280554629,2676.1545662879944,311.6341714859009,2083.884305000305,16954,4087,12867,12867,0,31,4068000.0
4068,4068999,21.050685580012267,38.33999132753274,0.08167560046464606,2676.418177843094,311.7022650241852,2086.310170173645,16963,4087,12876,12876,0,31,4069000.0
4069,4069999,21.049229201983287,38.337762062686274,0.08167348959040865,2676.6965453624725,311.7685513496399,2088.563458442688,16963,4087,12876,12876,0,31,4070000.0
4070,4070999,21.04814830528696,38.33797747062929,0.0816565833139673,2677.0685529708862,311.8369801044464,2090.490361213684,16963,4087,12876,12876,0,31,4071000.0
4071,4071999,21.04678225511053,38.33513807745368,0.08165330519947311,2677.630933523178,311.90348958969116,2091.6167421340942,16964,4087,12877,12877,0,31,4072000.0
4072,4072999,21.04547339358307,38.33285246845804,0.08164582969710554,2678.5163357257843,311.97422981262207,2090.8233919143677,16968,4089,12879,12879,0,31,4073000.0
4073,4073999,21.04419593040297,38.3309524565117,0.08165088967020406,2679.0180492401123,312.04289650917053,2091.6390352249146,16972,4091,12881,12881,0,31,4074000.0
4074,4074999,21.042644045252587,38.32795887953872,0.08164975080311687,2679.996377468109,312.11158323287964,2090.056294441223,16997,4096,12901,12901,0,31,4075000.0
4075,4075999,21.041298446858026,38.32577880906485,0.08164797983432615,2680.5332531929016,312.1812298297882,2090.809597969055,17001,4098,12903,12903,0,31,4076000.0
4076,4076999,21.039643003075476,38.32259105977255,0.0816542726493632,2681.156934261322,312.24957942962646,2091.2654161453247,17003,4099,12904,12904,0,31,4077000.0
4077,4077999,21.03843411734766,38.32026843176267,0.08165326287941455,2681.886778354645,312.32243299484253,2091.1395769119263,17006,4100,12906,12906,0,31,4078000.0
4078,4078999,21.037087016215416,38.31770935711697,0.08164994207889409,2682.3842318058014,312.39184403419495,2092.5173387527466,17008,4101,12907,12907,0,31,4079000.0
4079,4079999,21.03587105298276,38.315424834366304,0.08164240725345573,2682.904040336609,312.4600405693054,2093.6475038528442,17008,4101,12907,12907,0,31,4080000.0
4080,4080999,21.035087129699313,38.31375431204432,0.08163093496738905,2683.4189343452454,312.5297667980194,2094.9142122268677,17008,4101,12907,12907,0,31,4081000.0
4081,4081999,21.034049647158902,38.31127304359458,0.08162244382667516,2684.4167630672455,312.60676431655884,2093.854214668274,17008,4101,12907,12907,0,31,4082000.0
4082,4082999,21.033469771106272,38.31298819858051,0.08159581088213752,2685.204835653305,312.676274061203,2093.646466255188,17010,4102,12908,12908,0,31,4083000.0
4083,4083999,21.03314732392214,38.311841985531416,0.0815815850625976,2685.59885931015,312.7453007698059,2095.2262392044067,17012,4103,12909,12909,0,31,4084000.0
4084,4084999,21.032685517974762,38.31022538949979,0.08157212925736079,2686.2231290340424,312.81602597236633,2095.761700630188,17014,4104,12910,12910,0,31,4085000.0
4085,4085999,21.031817957717525,38.30797767160187,0.0815705584038483,2687.14257979393,312.88637256622314,2094.790410041809,17023,4106,12917,12917,0,31,4086000.0
4086,4086999,21.031186755054026,38.30575269790201,0.08156529405037138,2687.8908252716064,312.9606146812439,2094.6420106887817,17030,4108,12922,12922,0,31,4087000.0
4087,4087999,21.030608128115574,38.30351527083981,0.08155767385086798,2688.5001792907715,313.033406496048,2095.176236152649,17032,4109,12923,12923,0,31,4088000.0
4088,4088999,21.029619995420706,38.301066382574824,0.08155250316930773,2689.3254969120026,313.10493898391724,2094.933995246887,17034,4110,12924,12924,0,31,4089000.0
4089,4089999,21.028250802083697,38.29827497353905,0.08152859188202854,2689.6063022613525,313.1708242893219,2097.280011177063,17050,4110,12940,12940,0,31,4090000.0
4090,4090999,21.026754740563643,38.29528997361082,0.08150860237330071,2690.0691459178925,313.2378737926483,2098.481427192688,17053,4111,12942,12942,0,31,4091000.0
4091,4091999,21.024879805845774,38.2922245444316,0.08150486798092449,2690.823613166809,313.3056240081787,2098.0176668167114,17060,4114,12946,12946,0,31,4092000.0
4092,4092999,21.0234629037946,38.289505834074575,0.0814944321542509,2691.5308125019073,313.3749897480011,2097.9473237991333,17069,4116,12953,12953,0,31,4093000.0
4093,4093999,21.0223406195764,38.287477325233354,0.08146968407066413,2692.0265781879425,313.44233417510986,2099.1914567947388,17070,4116,12954,12954,0,31,4094000.0
4094,4094999,21.02100063741052,38.285185955153636,0.08145708715406674,2692.5165977478027,313.51343727111816,2100.0908632278442,17074,4118,12956,12956,0,31,4095000.0
4095,4095999,21.019589113825603,38.28234282541385,0.08144434239942966,2692.912132501602,313.58149790763855,2101.7459993362427,17074,4118,12956,12956,0,31,4096000.0
4096,4096999,21.018397639070205,38.27990852448025,0.08143166955720338,2693.6054706573486,313.64952635765076,2101.905941963196,17089,4119,12970,12970,0,31,4097000.0
4097,4097999,21.017306444400855,38.278268481103524,0.08141620139880112,2694.185448408127,313.71895718574524,2102.418438911438,17093,4121,12972,12972,0,31,4098000.0
4098,4098999,21.016411089254735,38.27670478542639,0.08140156338426507,2694.77605676651,313.78737711906433,2103.046368598938,17096,4122,12974,12974,0,31,4099000.0
4099,4099999,21.01535219414087,38.27502532137907,0.08138778336616648,2695.470206975937,313.8575270175934,2103.1151247024536,17102,4124,12978,12978,0,31,4100000.0
4100,4100999,21.01469307667753,38.273559055638415,0.08137203746319643,2695.9783792495728,313.92740273475647,2104.3876848220825,17102,4124,12978,12978,0,31,4101000.0
4101,4101999,21.01470816452341,38.27690904672063,0.08137305403623618,2696.57941865921,313.99602699279785,2104.9684648513794,17104,4125,12979,12979,0,31,4102000.0
4102,4102999,21.014518282368496,38.27558239379908,0.08135530910071365,2697.0874807834625,314.06552147865295,2106.0778551101685,17104,4125,12979,12979,0,31,4103000.0
4103,4103999,21.014733033193693,38.27502907798314,0.08133680600439153,2697.787024497986,314.13683676719666,2106.4163789749146,17106,4126,12980,12980,0,31,4104000.0
4104,4104999,21.014844798280613,38.27461022638779,0.08132099626334321,2698.2841029167175,314.20625400543213,2107.654004096985,17106,4126,12980,12980,0,31,4105000.0
4105,4105999,21.01510664417662,38.274139997187106,0.08129504173967428,2698.980499267578,314.2762050628662,2107.7499055862427,17109,4128,12981,12981,0,31,4106000.0
4106,4106999,21.015588724078718,38.273748910912296,0.08127650815799925,2699.5872015953064,314.34501218795776,2108.420033454895,17109,4128,12981,12981,0,31,4107000.0
4107,4107999,21.01588076353976,38.27310664891403,0.08126763409439197,2700.196178674698,314.4140610694885,2108.9985780715942,17109,4128,12981,12981,0,31,4108000.0
4108,4108999,21.01667002405196,38.27263004119388,0.08126045424114692,2700.8897621631622,314.48516035079956,2109.1528367996216,17111,4129,12982,12982,0,31,4109000.0
4109,4109999,21.016902356416406,38.27116611120591,0.08125225131037506,2701.702168226242,314.5589904785156,2108.679669380188,17114,4131,12983,12983,0,31,4110000.0
4110,4110999,21.016459348988477,38.26946539257488,0.08125249368156151,2702.601688146591,314.6291694641113,2107.7379121780396,17139,4134,13005,13005,0,31,4111000.0
4111,4111999,21.015220944929936,38.26716357708631,0.0812450387322532,2702.9618847370148,314.6951644420624,2109.4690828323364,17146,4136,13010,13010,0,31,4112000.0
4112,4112999,21.01448468964829,38.265360991041234,0.08126615948171168,2703.5502660274506,314.7629277706146,2110.3361711502075,17147,4136,13011,13011,0,31,4113000.0
4113,4113999,21.01461760710944,38.26532789755434,0.08128291349799788,2704.1447060108185,314.83041429519653,2110.9205293655396,17156,4138,13018,13018,0,31,4114000.0
4114,4114999,21.0144825438773,38.26494402010279,0.08130996731383233,2704.622014760971,314.89794635772705,2112.001805305481,17161,4140,13021,13021,0,31,4115000.0
4115,4115999,21.014161195067572,38.26361808945442,0.08134569771607203,2705.5705168247223,314.9723868370056,2111.369252204895,17161,4140,13021,13021,0,31,4116000.0
4116,4116999,21.014135609885056,38.262742953538925,0.08137469542229137,2706.54950094223,315.0408568382263,2109.9521532058716,17167,4143,13024,13024,0,31,4117000.0
4117,4117999,21.013930142591153,38.26250293568548,0.08140231065333559,2707.1021525859833,315.1136176586151,2111.0148210525513,17167,4143,13024,13024,0,31,4118000.0
4118,4118999,21.013955521989544,38.26566848185782,0.08139695454343965,2707.620190858841,315.18260765075684,2112.132710456848,17167,4143,13024,13024,0,31,4119000.0
4119,4119999,21.014249975103876,38.26568410864008,0.08141239893170704,2719.6118817329407,315.25014877319336,2113.204960823059,17171,4144,13027,13027,0,31,4120000.0
4120,4120999,21.014664381065526,38.26579478606155,0.08142749867519128,2720.248879432678,315.3176965713501,2113.833622932434,17171,4144,13027,13027,0,31,4121000.0
4121,4121999,21.015694049081116,38.26697255786185,0.08142081855557359,2720.9698934555054,315.38771772384644,2114.141583442688,17171,4144,13027,13027,0,31,4122000.0
4122,4122999,21.01712374598407,38.268245229816486,0.08143181845598857,2721.68461561203,315.4559636116028,2114.165867805481,17173,4145,13028,13028,0,31,4123000.0
4123,4123999,21.01875099613585,38.270169340889595,0.08143330370421986,2722.092621088028,315.52611327171326,2115.7589235305786,17173,4145,13028,13028,0,31,4124000.0
4124,4124999,21.02075958772612,38.27461360075322,0.08142647443531226,2722.605199575424,315.5959641933441,2116.813374519348,17173,4145,13028,13028,0,31,4125000.0
4125,4125999,21.02269146335669,38.27675928380316,0.08142194710050077,2723.3724887371063,315.67253851890564,2116.4186449050903,17184,4148,13036,13036,0,31,4126000.0
4126,4126999,21.025346387580612,38.28017659497358,0.0814365667488921,2723.8636898994446,315.737890958786,2117.7798280715942,17184,4148,13036,13036,0,31,4127000.0
4127,4127999,21.02759049976626,38.28243052595896,0.08144647663519411,2724.759066581726,315.80921840667725,2116.746563911438,17204,4151,13053,13053,0,31,4128000.0
4128,4128999,21.030983352641492,38.290766865556506,0.08147534510040488,2725.3484270572662,315.8785936832428,2117.8207750320435,17204,4151,13053,13053,0,31,4129000.0
4129,4129999,21.033603085090288,38.293436804843765,0.08148368418234564,2725.9606597423553,315.95601177215576,2118.4119386672974,17210,4152,13058,13058,0,31,4130000.0
4130,4130999,21.035546744767057,38.29446397120774,0.08150837405970557,2726.5741810798645,316.0290138721466,2118.8073015213013,17215,4155,13060,13060,0,31,4131000.0
4131,4131999,21.036234229162936,38.29631105913017,0.08149002872234834,2727.068856716156,316.10013031959534,2120.402989387512,17234,4155,13079,13079,0,31,4132000.0
4132,4132999,21.03554072283575,38.29620835833701,0.0814730759332658,2727.7318139076233,316.17142939567566,2120.5344285964966,17246,4159,13087,13087,0,31,4133000.0
4133,4133999,21.034638088019737,38.29507414769933,0.0814542151632579,2728.131477832794,316.2407224178314,2122.2410860061646,17246,4159,13087,13087,0,31,4134000.0
4134,4134999,21.033794503981426,38.29418191225408,0.08143612420737634,2729.074940919876,316.3127098083496,2121.592610359192,17247,4159,13088,13088,0,31,4135000.0
4135,4135999,21.03327647202385,38.294155815128335,0.08141181496737215,2729.6904072761536,316.3831923007965,2122.1866273880005,17252,4161,13091,13091,0,31,4136000.0
4136,4136999,21.032449589237768,38.292221819586544,0.08139994270558515,2730.291111469269,316.4549193382263,2122.7029161453247,17258,4164,13094,13094,0,31,4137000.0
4137,4137999,21.031590016758827,38.28997535700427,0.0813898503007523,2730.7138662338257,316.52576208114624,2124.362545967102,17258,4164,13094,13094,0,31,4138000.0
4138,4138999,21.030710685066175,38.28786453202644,0.08137807455975277,2731.1358025074005,316.59743571281433,2125.993000984192,17258,4164,13094,13094,0,31,4139000.0
4139,4139999,21.02994346421153,38.28639364146988,0.08136479290668375,2731.6453053951263,316.66850686073303,2127.2752046585083,17258,4164,13094,13094,0,31,4140000.0
4140,4140999,21.029151467187447,38.28430227169716,0.08135567325536419,2732.490534543991,316.7411034107208,2126.7825136184692,17265,4165,13100,13100,0,31,4141000.0
4141,4141999,21.028625014758294,38.28377154462746,0.08134844331629898,2733.038741350174,316.81224846839905,2127.8837633132935,17266,4165,13101,13101,0,31,4142000.0
4142,4142999,21.028711882158177,38.28364490852679,0.08133143162916301,2734.1920313835144,316.8849685192108,2125.8196306228638,17270,4167,13103,13103,0,31,4143000.0
4143,4143999,21.029494541080954,38.28952728640265,0.08130861398110145,2734.6974823474884,316.9595136642456,2126.825177192688,17286,4169,13117,13117,0,31,4144000.0
4144,4144999,21.03081723672818,38.29204156199703,0.08130257576012678,2735.1026377677917,317.03034591674805,2128.4457445144653,17290,4171,13119,13119,0,31,4145000.0
4145,4145999,21.033116198846738,38.30056267023176,0.08128436052591714,2735.617679834366,317.10577940940857,2129.679623603821,17292,4172,13120,13120,0,31,4146000.0
4146,4146999,21.036365841226935,38.31126018443614,0.08127137138120066,2736.163364171982,317.17738151550293,2130.577664375305,17294,4173,13121,13121,0,31,4147000.0
4147,4147999,21.042668918152582,38.32812653773363,0.08127463551390113,2736.8046448230743,317.24859833717346,2131.209095954895,17294,4173,13121,13121,0,31,4148000.0
4148,4148999,21.048642578902147,38.344075062535886,0.08130937049235953,2737.540999174118,317.3207092285156,2131.3560457229614,17296,4174,13122,13122,0,31,4149000.0
4149,4149999,21.054122828568065,38.355148144581584,0.08132315454487038,2737.8563961982727,317.39514422416687,2133.601300239563,17296,4174,13122,13122,0,31,4150000.0
4150,4150999,21.060595217237598,38.36998155300862,0.08134095407674202,2738.4911115169525,317.4663805961609,2134.296055793762,17296,4174,13122,13122,0,31,4151000.0
4151,4151999,21.066464739225736,38.38120855558869,0.08140872251956266,2739.326498270035,317.5401349067688,2133.8404207229614,17300,4176,13124,13124,0,31,4152000.0
4152,4152999,21.06898534561314,38.3847674902637,0.08142603273600402,2740.170572757721,317.61155796051025,2133.6604738235474,17314,4177,13137,13137,0,31,4153000.0
4153,4153999,21.067494950365422,38.38285919201971,0.08141702755315017,2740.5746676921844,317.6815302371979,2135.440983772278,17318,4177,13141,13141,0,31,4154000.0
4154,4154999,21.066232388955264,38.38124508842172,0.08141031777205543,2740.851997613907,317.7515389919281,2137.8565034866333,17318,4177,13141,13141,0,31,4155000.0
4155,4155999,21.065467520301908,38.38195754445169,0.08139477557697872,2741.4520947933197,317.8228290081024,2138.71812915802,17320,4178,13142,13142,0,31,4156000.0
4156,4156999,21.064895400728723,38.38082707904737,0.08138023759012403,2742.305451154709,317.89526653289795,2138.285222053528,17323,4179,13144,13144,0,31,4157000.0
4157,4157999,21.063727095707016,38.37824437961869,0.08137416480966353,2742.824396133423,317.96621108055115,2139.466954231262,17325,4180,13145,13145,0,31,4158000.0
4158,4158999,21.062542493752375,38.376305585679106,0.08136525904018055,2743.7640953063965,318.03741788864136,2138.300320625305,17331,4183,13148,13148,0,31,4159000.0
4159,4159999,21.061730875489452,38.374434034837634,0.08135514288929602,2744.4003343582153,318.1082887649536,2138.832043647766,17335,4184,13151,13151,0,31,4160000.0
4160,4160999,21.061001918523388,38.37321926227338,0.08134832918610613,2745.233225107193,318.18222737312317,2138.3331804275513,17344,4187,13157,13157,0,31,4161000.0
4161,4161999,21.060617263352214,38.37208445877671,0.08133467035919972,2745.656802177429,318.2533161640167,2139.782811164856,17349,4189,13160,13160,0,31,4162000.0
4162,4162999,21.060632705630127,38.37169655274248,0.08131564603731656,2746.4138922691345,318.32554292678833,2139.8817949295044,17351,4190,13161,13161,0,31,4163000.0
4163,4163999,21.060913616059054,38.37140656510343,0.08129897724174484,2747.0750653743744,318.39785981178284,2140.4853715896606,17351,4190,13161,13161,0,31,4164000.0
4164,4164999,21.06192473860729,38.372794282192814,0.08127138706826031,2747.5951488018036,318.4686133861542,2141.5011491775513,17355,4191,13164,13164,0,31,4165000.0
4165,4165999,21.062504172707893,38.37294030210542,0.08126216391334706,2748.3263120651245,318.54170846939087,2141.605595588684,17357,4192,13165,13165,0,31,4166000.0
4166,4166999,21.06438151440089,38.379194988450124,0.08122215791878717,2748.7554926872253,318.612633228302,2143.2116441726685,17357,4192,13165,13165,0,31,4167000.0
4167,4167999,21.065048463014808,38.379246751812325,0.08120558160756475,2749.6399977207184,318.68863677978516,2142.674084663391,17361,4193,13168,13168,0,31,4168000.0
4168,4168999,21.065877944013632,38.37909960234934,0.08119289491589465,2750.2744085788727,318.759094953537,2143.1824617385864,17365,4194,13171,13171,0,31,4169000.0
4169,4169999,21.066674330361536,38.37905019809394,0.08118595767610004,2750.783622980118,318.83249258995056,2144.4979677200317,17365,4194,13171,13171,0,31,4170000.0
4170,4170999,21.06699045167406,38.37842134062539,0.08117634276921493,2751.2856595516205,318.90354681015015,2145.935399055481,17365,4194,13171,13171,0,31,4171000.0
4171,4171999,21.065590011423968,38.37570516617085,0.08117167626302879,2751.9792256355286,318.97565603256226,2146.546399116516,17375,4194,13181,13181,0,31,4172000.0
4172,4172999,21.063704062641055,38.372740353559315,0.08117415250294868,2752.5165269374847,319.04568314552307,2147.455533027649,17378,4195,13183,13183,0,31,4173000.0
4173,4173999,21.062326920939306,38.371470717549116,0.08116496398988426,2753.3395800590515,319.1160888671875,2147.032597541809,17382,4197,13185,13185,0,31,4174000.0
4174,4174999,21.061152787129682,38.36967505864692,0.08115556206276064,2754.0420088768005,319.18830609321594,2147.3480195999146,17385,4198,13187,13187,0,31,4175000.0
4175,4175999,21.06013563765079,38.367775871993175,0.0811504408491216,2754.771509408951,319.2595224380493,2147.6530504226685,17385,4198,13187,13187,0,31,4176000.0
4176,4176999,21.05921452581542,38.36606476989494,0.08114007401930512,2755.397863149643,319.33082461357117,2148.2487688064575,17387,4199,13188,13188,0,31,4177000.0
4177,4177999,21.058353253803027,38.36500939960811,0.08112888183890588,2755.9455766677856,319.4040176868439,2149.328984260559,17387,4199,13188,13188,0,31,4178000.0
4178,4178999,21.058932471748236,38.36880838483134,0.08109987651550932,2757.0205352306366,319.47771406173706,2147.6302919387817,17395,4201,13194,13194,0,31,4179000.0
4179,4179999,21.062235239691855,38.381161716128496,0.08106615550520435,2757.6661014556885,319.5505464076996,2148.192006111145,17400,4202,13198,13198,0,31,4180000.0
4180,4180999,21.066115001959297,38.39352547403251,0.0810416200509102,2758.3064579963684,319.6261591911316,2148.7149171829224,17401,4203,13198,13198,0,31,4181000.0
4181,4181999,21.072699267806403,38.417555413937635,0.08101398858394393,2758.8263812065125,319.6986815929413,2149.90505695343,17403,4204,13199,13199,0,31,4182000.0
4182,4182999,21.080498987258633,38.43855659724564,0.08103834729933823,2759.5644674301147,319.7740008831024,2149.8951082229614,17406,4206,13200,13200,0,31,4183000.0
4183,4183999,21.08912904253763,38.46319739674709,0.0810498757415471,2760.2906737327576,319.8490662574768,2150.0066270828247,17410,4208,13202,13202,0,31,4184000.0
4184,4184999,21.09741796292123,38.4836460264503,0.08106897036497795,2761.021534204483,319.92556619644165,2149.9842958450317,17432,4210,13222,13222,0,31,4185000.0
4185,4185999,21.106701078007166,38.504530312121766,0.08114089400804225,2761.5591950416565,319.9993185997009,2151.1864824295044,17432,4210,13222,13222,0,31,4186000.0
4186,4186999,21.116716211103416,38.53231983594536,0.08124823655560032,2761.985591650009,320.07301449775696,2152.7937211990356,17432,4210,13222,13222,0,31,4187000.0
4187,4187999,21.12500974713647,38.54790355556948,0.08132167753670816,2762.735121011734,320.14828729629517,2152.7966737747192,17438,4211,13227,13227,0,31,4188000.0
4188,4188999,21.134239196808995,38.56988408810105,0.08144056279347389,2763.6978709697723,320.22619438171387,2151.9418382644653,17440,4212,13228,13228,0,31,4189000.0
4189,4189999,21.14209237858462,38.58489937221303,0.08158740671145315,2764.384980916977,320.30064725875854,2152.1284532546997,17492,4216,13276,13276,0,31,4190000.0
4190,4190999,21.145984966510365,38.59190117215794,0.08164292543827034,2764.9964666366577,320.3746511936188,2152.8936281204224,17504,4217,13287,13287,0,31,4191000.0
4191,4191999,21.1458202389058,38.5937827803441,0.08161686029804194,2765.3815228939056,320.4455108642578,2154.6321535110474,17509,4218,13291,13291,0,31,4192000.0
4192,4192999,21.146098622783086,38.59704905568283,0.08158360046023616,2765.7928609848022,320.5170066356659,2156.3093767166138,17510,4218,13292,13292,0,31,4193000.0
4193,4193999,21.146425645072256,38.5982134413518,0.08156193042729676,2766.869808912277,320.5899910926819,2154.511387825012,17512,4219,13293,13293,0,31,4194000.0
4194,4194999,21.14676239548115,38.59863226243692,0.08155418547595039,2767.3707270622253,320.6600489616394,2155.893162727356,17513,4219,13294,13294,0,31,4195000.0
4195,4195999,21.146651028651704,38.59791812027256,0.0815419381559187,2767.9021368026733,320.7298221588135,2157.0062913894653,17513,4219,13294,13294,0,31,4196000.0
4196,4196999,21.1464781105329,38.59715576919253,0.08152771063926956,2768.8167095184326,320.8028335571289,2156.516026496887,17518,4220,13298,13298,0,31,4197000.0
4197,4197999,21.14659081643097,38.59656888316243,0.08152241002048599,2769.563731908798,320.8751494884491,2156.5602083206177,17518,4220,13298,13298,0,31,4198000.0
4198,4198999,21.147073325625623,38.597322598850184,0.08150614700601888,2770.3201172351837,320.9478483200073,2156.5938005447388,17521,4221,13300,13300,0,31,4199000.0
4199,4199999,21.14752853712972,38.59797832922201,0.0815053481591077,2770.9613196849823,321.01908016204834,2157.112561225891,17524,4222,13302,13302,0,31,4200000.0
4200,4200999,21.148800868376142,38.59997716693635,0.0815097621980182,2771.620577812195,321.0937623977661,2157.666699409485,17540,4223,13317,13317,0,31,4201000.0
4201,4201999,21.150164683877772,38.60231500538143,0.08151099979239518,2772.4599821567535,321.16861510276794,2156.6598863601685,17558,4228,13330,13330,0,31,4202000.0
4202,4202999,21.152318209127568,38.60543621576516,0.08152117272997195,2772.9913008213043,321.2445583343506,2157.8357515335083,17563,4229,13334,13334,0,31,4203000.0
4203,4203999,21.154715151056564,38.60908870759373,0.08152625967181626,2773.8501057624817,321.3192412853241,2157.3853731155396,17565,4230,13335,13335,0,31,4204000.0
4204,4204999,21.15745294655974,38.61194913221973,0.08153619792514266,2774.3493506908417,321.3919713497162,2158.8375902175903,17565,4230,13335,13335,0,31,4205000.0
4205,4205999,21.160978650152362,38.61716001833603,0.08156355561394857,2775.082734823227,321.4644122123718,2158.820134162903,17569,4232,13337,13337,0,31,4206000.0
4206,4206999,21.164251605180876,38.62097549616146,0.08158633565189022,2775.838919401169,321.5367863178253,2158.8399934768677,17571,4233,13338,13338,0,31,4207000.0
4207,4207999,21.16769748497235,38.626017836471156,0.08162311058172678,2776.2498490810394,321.60993361473083,2160.4247102737427,17573,4234,13339,13339,0,31,4208000.0
4208,4208999,21.17084947576581,38.62888415858777,0.08164534639496601,2776.888685464859,321.6820294857025,2161.030369758606,17575,4235,13340,13340,0,31,4209000.0
4209,4209999,21.174338201680694,38.63256875792977,0.08168426992753852,2778.0554342269897,321.7580199241638,2159.0403718948364,17581,4236,13345,13345,0,31,4210000.0
4210,4210999,21.176015026635863,38.63284655536361,0.0817270177201197,2779.083585500717,321.83441162109375,2157.576413154602,17635,4240,13395,13395,0,31,4211000.0
4211,4211999,21.17694996513146,38.63359303741813,0.08169765202440549,2779.3667068481445,321.9080021381378,2160.0736207962036,17665,4241,13424,13424,0,31,4212000.0
4212,4212999,21.175495132598414,38.63225068900713,0.08168984698248727,2779.6426696777344,321.98098635673523,2162.5246477127075,17673,4241,13432,13432,0,31,4213000.0
4213,4213999,21.17392658661344,38.6297150410379,0.08169011912341162,2779.84552359581,322.05848455429077,2165.3425798416138,17675,4241,13434,13434,0,31,4214000.0
4214,4214999,21.172704138284683,38.627408432919346,0.08168897372390993,2780.34281373024,322.130122423172,2166.4939165115356,17684,4243,13441,13441,0,31,4215000.0
4215,4215999,21.171350434788998,38.62483939818289,0.08168908575229417,2780.9330582618713,322.20068097114563,2167.0672883987427,17693,4247,13446,13446,0,31,4216000.0
4216,4216999,21.170068854393467,38.623022915303665,0.08168378900027329,2781.9364268779755,322.2771806716919,2166.263813972473,17698,4249,13449,13449,0,31,4217000.0
4217,4217999,21.168689587451958,38.6204077245118,0.08168780623651561,2782.3289980888367,322.34886717796326,2168.0946550369263,17701,4250,13451,13451,0,31,4218000.0
4218,4218999,21.167224155311242,38.61770975951632,0.08168571277363357,2783.02166557312,322.4212956428528,2168.5975160598755,17703,4251,13452,13452,0,31,4219000.0
4219,4219999,21.166410025727387,38.61667336862647,0.0816737785297641,2783.528464317322,322.4941484928131,2169.8105516433716,17706,4252,13454,13454,0,31,4220000.0
4220,4220999,21.16561809215086,38.615358319299666,0.08166691500074608,2783.970561027527,322.56440234184265,2171.115544319153,17709,4253,13456,13456,0,31,4221000.0
4221,4221999,21.164707496827713,38.61337819453359,0.08165611687327012,2784.3982915878296,322.6368315219879,2172.5945253372192,17711,4254,13457,13457,0,31,4222000.0
4222,4222999,21.164275407955447,38.61220566948186,0.08164994440576467,2785.0179393291473,322.70918917655945,2173.2576723098755,17713,4255,13458,13458,0,31,4223000.0
4223,4223999,21.16533961987207,38.614303342535756,0.08164582706410561,2785.5678853988647,322.7804505825043,2174.3336687088013,17713,4255,13458,13458,0,31,4224000.0
4224,4224999,21.166324736436117,38.616200145803674,0.0816454143373192,2786.5420775413513,322.85380697250366,2173.6157274246216,17715,4256,13459,13459,0,31,4225000.0
4225,4225999,21.167971293981747,38.61847181525852,0.0816545638238596,2787.170485019684,322.9263572692871,2174.256962776184,17717,4257,13460,13460,0,31,4226000.0
4226,4226999,21.169359460783316,38.621215466885026,0.08165623263635358,2787.808424949646,323.00035333633423,2174.931965827942,17717,4257,13460,13460,0,31,4227000.0
4227,4227999,21.17149366154622,38.6282188452742,0.08164369097683144,2788.747312307358,323.07393312454224,2174.044987678528,17721,4259,13462,13462,0,31,4228000.0
4228,4228999,21.1737492818596,38.63250262277375,0.08165117660810606,2789.4779529571533,323.1473865509033,2174.0747575759888,17741,4261,13480,13480,0,31,4229000.0
4229,4229999,21.175319804364182,38.63545073018596,0.0816668389514782,2790.2019703388214,323.22138142585754,2174.4636735916138,17746,4262,13484,13484,0,31,4230000.0
4230,4230999,21.176710585704814,38.63623710725246,0.08167783404899764,2791.117369413376,323.2970395088196,2173.3623781204224,17752,4265,13487,13487,0,31,4231000.0
4231,4231999,21.177934905201045,38.636715825068066,0.08169399176106074,2791.89529132843,323.3706097602844,2173.0251893997192,17756,4267,13489,13489,0,31,4232000.0
4232,4232999,21.177865548980545,38.635217908373896,0.08169809891622914,2792.6194858551025,323.45437693595886,2173.2562532424927,17769,4268,13501,13501,0,31,4233000.0
4233,4233999,21.175857078730218,38.632463621228425,0.08170553212207621,2793.092984676361,323.5198109149933,2174.5265550613403,17774,4269,13505,13505,0,31,4234000.0
4234,4234999,21.173888043284297,38.63020168532915,0.08171074078834606,2793.60005569458,323.5864176750183,2175.7233934402466,17779,4269,13510,13510,0,31,4235000.0
4235,4235999,21.17178996618815,38.62705602758493,0.08171834532781308,2794.1949741840363,323.65057945251465,2176.5723237991333,17784,4269,13515,13515,0,31,4236000.0
4236,4236999,21.170117734747738,38.624424515627695,0.08171805066725757,2794.8069241046906,323.7142901420593,2177.1771516799927,17788,4270,13518,13518,0,31,4237000.0
4237,4237999,21.16907938600899,38.62329414311024,0.08170183954373811,2795.6305634975433,323.7797632217407,2176.596386909485,17796,4273,13523,13523,0,31,4238000.0
4238,4238999,21.167876400801166,38.62090147404364,0.08169379398353371,2796.255574941635,323.84380292892456,2177.3288774490356,17797,4273,13524,13524,0,31,4239000.0
4239,4239999,21.166861772344898,38.61917186228697,0.08168001317629925,2796.8660299777985,323.90793776512146,2177.6589097976685,17805,4276,13529,13529,0,31,4240000.0
4240,4240999,21.16629720826257,38.61755025760718,0.08166835331263655,2797.687616109848,323.97734570503235,2177.5660905838013,17806,4276,13530,13530,0,31,4241000.0
4241,4241999,21.16624051748448,38.61770265489324,0.08165194033006873,2798.421459674835,324.04389357566833,2177.632580757141,17808,4277,13531,13531,0,31,4242000.0
4242,4242999,21.16623167780763,38.61723024672391,0.08163952562605614,2799.2494564056396,324.11077785491943,2177.1391191482544,17812,4279,13533,13533,0,31,4243000.0
4243,4243999,21.166207215411013,38.616297154516225,0.08163221056495507,2799.8922502994537,324.1774399280548,2177.6455659866333,17814,4280,13534,13534,0,31,4244000.0
4244,4244999,21.167217268661677,38.616982629153036,0.08161978503485068,2800.4147012233734,324.24518632888794,2178.7743883132935,17814,4280,13534,13534,0,31,4245000.0
4245,4245999,21.168708392854295,38.6209409020921,0.08161384775147273,2801.2437086105347,324.3121771812439,2178.5808153152466,17815,4280,13535,13535,0,31,4246000.0
4246,4246999,21.17097981106932,38.623374507269524,0.08162833432219563,2801.756016731262,324.380539894104,2179.567898750305,17816,4281,13535,13535,0,31,4247000.0
4247,4247999,21.172790261723062,38.62477960284907,0.08164364581311212,2802.5117058753967,324.4492244720459,2179.358853340149,17819,4282,13537,13537,0,31,4248000.0
4248,4248999,21.175644922278476,38.62830678023183,0.08167051115337842,2803.1786029338837,324.5185718536377,2179.8534059524536,17819,4282,13537,13537,0,31,4249000.0
4249,4249999,21.17825980510498,38.63073921979158,0.08168787696015745,2804.014892578125,324.5858039855957,2179.1008882522583,17832,4286,13546,13546,0,31,4250000.0
4250,4250999,21.18089756858527,38.63343080034033,0.08170772435588691,2805.0646872520447,324.654043674469,2177.7902574539185,17833,4287,13546,13546,0,31,4251000.0
4251,4251999,21.18320102537486,38.63497993856608,0.08173172376442595,2805.575892686844,324.72314190864563,2178.9535188674927,17848,4288,13560,13560,0,31,4252000.0
4252,4252999,21.185388744752903,38.63610895183772,0.08175629442590238,2805.863361120224,324.7945601940155,2181.174397468567,17854,4289,13565,13565,0,31,4253000.0
4253,4253999,21.186083748677866,38.63709877979277,0.08178589134980896,2806.6067826747894,324.86363768577576,2181.3773851394653,17854,4289,13565,13565,0,31,4254000.0
4254,4254999,21.186558953901383,38.63604311535693,0.08170194207932102,2806.983072280884,324.9322876930237,2183.329586982727,17865,4289,13576,13576,0,31,4255000.0
4255,4255999,21.186407674670367,38.63487683218643,0.08164411059163867,2807.4916338920593,324.99972462654114,2184.57799243927,17869,4289,13580,13580,0,31,4256000.0
4256,4256999,21.18569751404451,38.63309560244476,0.08162052138993126,2807.9828090667725,325.0676348209381,2185.8758668899536,17878,4290,13588,13588,0,31,4257000.0
4257,4257999,21.185148020492672,38.631771070170444,0.08160251629976545,2808.5120050907135,325.13524079322815,2187.0216035842896,17879,4290,13589,13589,0,31,4258000.0
4258,4258999,21.184693719377837,38.631480638942655,0.08157456142848218,2809.3195300102234,325.2046101093292,2187.021954536438,17880,4290,13590,13590,0,31,4259000.0
4259,4259999,21.184030141327987,38.630664265359236,0.08155419640076056,2810.5858175754547,325.27341961860657,2184.369336128235,17886,4293,13593,13593,0,31,4260000.0
4260,4260999,21.18293367197113,38.62823187001398,0.08154467896426199,2810.878454208374,325.3408348560333,2186.4781923294067,17888,4294,13594,13594,0,31,4261000.0
4261,4261999,21.182133016132894,38.626122494224305,0.08152654219071076,2811.637524366379,325.411093711853,2186.3354387283325,17891,4295,13596,13596,0,31,4262000.0
4262,4262999,21.181199512626154,38.62393219853052,0.08151920701616178,2812.064041852951,325.4785180091858,2187.947896003723,17891,4295,13596,13596,0,31,4263000.0
4263,4263999,21.181059834688792,38.62346502462808,0.0814990177415219,2812.9163427352905,325.5495536327362,2187.257290840149,17926,4298,13628,13628,0,31,4264000.0
4264,4264999,21.180457769277588,38.621429837814574,0.08148578093132286,2813.878588438034,325.6180901527405,2186.2823915481567,17928,4299,13629,13629,0,31,4265000.0
4265,4265999,21.17972133913257,38.61971952062635,0.08147959490729717,2814.3103897571564,325.68594455718994,2187.89236164093,17928,4299,13629,13629,0,31,4266000.0
4266,4266999,21.18013716910343,38.621020677710554,0.0814554908547338,2815.394773244858,325.7555830478668,2186.4100770950317,17930,4300,13630,13630,0,31,4267000.0
4267,4267999,21.179704289873957,38.61911465987207,0.08145068844811099,2815.908331632614,325.82567524909973,2187.6554460525513,17930,4300,13630,13630,0,31,4268000.0
4268,4268999,21.179739056678574,38.618524619980036,0.08144088151815443,2817.100635290146,325.8981020450592,2185.6639833450317,17930,4300,13630,13630,0,31,4269000.0
4269,4269999,21.17977177363945,38.61873837056581,0.08144014105623187,2817.7448563575745,325.9728755950928,2186.2223329544067,17930,4300,13630,13630,0,31,4270000.0
4270,4270999,21.179731416084802,38.61808097543893,0.08143333916721707,2818.2667622566223,326.04725980758667,2187.53022480011,17930,4300,13630,13630,0,31,4271000.0
4271,4271999,21.180282345532447,38.62061514084397,0.0814154756546207,2819.022544145584,326.1207835674286,2187.451542854309,17932,4301,13631,13631,0,31,4272000.0
4272,4272999,21.179912983843863,38.61855688973126,0.081414469988904,2819.7549130916595,326.1910889148712,2187.6206483840942,17934,4302,13632,13632,0,31,4273000.0
4273,4273999,21.179865219612843,38.61705340306139,0.08141555455745386,2820.29137468338,326.26250314712524,2188.681721687317,17934,4302,13632,13632,0,31,4274000.0
4274,4274999,21.179122674106473,38.61477445656812,0.08141710039624306,2820.801700592041,326.3319323062897,2189.7965059280396,17941,4303,13638,13638,0,31,4275000.0
4275,4275999,21.17837792815671,38.612887579411,0.0814037938188682,2821.6529994010925,326.4025571346283,2189.481785774231,17955,4303,13652,13652,0,31,4276000.0
4276,4276999,21.177220356849304,38.61105998440595,0.08138887596122357,2822.506058216095,326.4732332229614,2189.1255922317505,17960,4303,13657,13657,0,31,4277000.0
4277,4277999,21.175729393862415,38.60800672800427,0.08137876699761759,2822.804665327072,326.54255270957947,2191.2925233840942,17961,4303,13658,13658,0,31,4278000.0
4278,4278999,21.174616974103422,38.60572115686401,0.08136908029555145,2823.3207082748413,326.6127142906189,2192.404004096985,17963,4304,13659,13659,0,31,4279000.0
4279,4279999,21.173938962360868,38.605125746848394,0.08135630463755994,2823.6614191532135,326.68891978263855,2194.542881965637,17964,4304,13660,13660,0,31,4280000.0
4280,4280999,21.172832831178408,38.602488091820746,0.08133979761659538,2824.2799174785614,326.75737023353577,2195.30366230011,17966,4305,13661,13661,0,31,4281000.0
4281,4281999,21.171758963546186,38.60024669337821,0.08132485675437329,2825.652018547058,326.8282845020294,2192.4443712234497,17968,4306,13662,13662,0,31,4282000.0
4282,4282999,21.17077535278366,38.597935118427934,0.08131364312510403,2826.0891528129578,326.89999651908875,2194.032696723938,17968,4306,13662,13662,0,31,4283000.0
4283,4283999,21.16996058240505,38.59651508163424,0.08130126962529416,2826.622119665146,326.96881771087646,2195.071858406067,17970,4307,13663,13663,0,31,4284000.0
4284,4284999,21.16892919401018,38.59400420861797,0.08129132457789401,2827.2590143680573,327.0385217666626,2195.6284227371216,17970,4307,13663,13663,0,31,4285000.0
4285,4285999,21.168280726317615,38.59233999928194,0.08127998042866869,2827.9362304210663,327.1084842681885,2196.094136238098,17970,4307,13663,13663,0,31,4286000.0
4286,4286999,21.168494753966733,38.59366998555288,0.08124948480096694,2828.7299745082855,327.1797196865082,2196.0473985671997,17972,4308,13664,13664,0,31,4287000.0
4287,4287999,21.168447961115874,38.593010336192116,0.08122715150549953,2829.5042510032654,327.251008272171,2195.855809211731,17974,4309,13665,13665,0,31,4288000.0
4288,4288999,21.16852857702147,38.592209948750984,0.08120581388828274,2830.4605112075806,327.3222713470459,2194.8653383255005,17976,4310,13666,13666,0,31,4289000.0
4289,4289999,21.16975753454153,38.59533197295504,0.08116995513506686,2831.089456319809,327.3925976753235,2195.374608039856,17983,4311,13672,13672,0,31,4290000.0
4290,4290999,21.171215876692603,38.597343835346955,0.08114643789014331,2831.700733423233,327.46326088905334,2195.8854265213013,17988,4313,13675,13675,0,31,4291000.0
4291,4291999,21.172894522510113,38.5999808762407,0.08112245384168226,2832.8711652755737,327.5339004993439,2193.887089729309,17994,4316,13678,13678,0,31,4292000.0
4292,4292999,21.175017706551703,38.603822674502226,0.08109626602587516,2833.2909388542175,327.60282278060913,2195.4690446853638,17996,4317,13679,13679,0,31,4293000.0
4293,4293999,21.177850067689505,38.61124324415822,0.08108082628205471,2833.9288461208344,327.67283153533936,2196.1669664382935,17996,4317,13679,13679,0,31,4294000.0
4294,4294999,21.18143376933241,38.62246613230963,0.08104527717956189,2834.887106657028,327.74463152885437,2195.1527070999146,17998,4318,13680,13680,0,31,4295000.0
4295,4295999,21.183755085363252,38.62644593281822,0.08104769375884258,2835.6318950653076,327.8144693374634,2195.168652534485,18005,4319,13686,13686,0,31,4296000.0
4296,4296999,21.184976563814256,38.62847086292628,0.08105291303059436,2836.265282869339,327.8836874961853,2195.8693132400513,18025,4320,13705,13705,0,31,4297000.0
4297,4297999,21.18407046877566,38.627203129417815,0.0810371481888722,2836.5473437309265,327.95368123054504,2198.20112323761,18039,4320,13719,13719,0,31,4298000.0
4298,4298999,21.182998468918317,38.62595610923946,0.08102275234828304,2836.952027320862,328.02120900154114,2199.8359956741333,18043,4321,13722,13722,0,31,4299000.0
4299,4299999,21.18240736534065,38.625346914085554,0.08100756119776464,2837.613909482956,328.0903446674347,2200.4648866653442,18044,4321,13723,13723,0,31,4300000.0
4300,4300999,21.181440836970996,38.62361074336925,0.08099146322906858,2838.1188395023346,328.15857338905334,2201.8403673171997,18044,4321,13723,13723,0,31,4301000.0
4301,4301999,21.18046388930921,38.62133530927724,0.08098376666080331,2839.031543970108,328.22828936576843,2201.405339241028,18046,4322,13724,13724,0,31,4302000.0
4302,4302999,21.17942874067314,38.61940564002732,0.08097163950632846,2839.6445026397705,328.3017921447754,2202.06187915802,18048,4323,13725,13725,0,31,4303000.0
4303,4303999,21.17881428272557,38.617920871611,0.08095827657483401,2840.309341907501,328.3733367919922,2202.364369392395,18050,4324,13726,13726,0,31,4304000.0
4304,4304999,21.177885637012935,38.61584608293256,0.08094699906345604,2841.151969909668,328.44647216796875,2202.100766181946,18057,4325,13732,13732,0,31,4305000.0
4305,4305999,21.177419405100963,38.614295616521375,0.08093397015422632,2842.0342395305634,328.5181269645691,2201.576024055481,18057,4325,13732,13732,0,31,4306000.0
4306,4306999,21.177018663702555,38.61285282920634,0.08091856750086246,2842.850950241089,328.58932614326477,2201.043782234192,18061,4327,13734,13734,0,31,4307000.0
4307,4307999,21.17676768131567,38.61203970570685,0.0809028009518219,2843.2841749191284,328.6585841178894,2202.457257270813,18067,4329,13738,13738,0,31,4308000.0
4308,4308999,21.175943437412386,38.60987594337081,0.08089617932393156,2844.244068622589,328.72893595695496,2201.473530769348,18076,4331,13745,13745,0,31,4309000.0
4309,4309999,21.175599690383123,38.60842399196716,0.08088330794534626,2844.6668722629547,328.79786920547485,2203.0775117874146,18076,4331,13745,13745,0,31,4310000.0
4310,4310999,21.175863514349036,38.61453964995941,0.08084150479263463,2845.5335726737976,328.8699448108673,2202.5991792678833,18076,4331,13745,13745,0,31,4311000.0
4311,4311999,21.175735178677865,38.613500632353336,0.08082658347237637,2846.288463830948,328.9411361217499,2202.6394472122192,18076,4331,13745,13745,0,31,4312000.0
4312,4312999,21.175630267946413,38.61203549943564,0.08081337343579653,2847.0222663879395,329.01219964027405,2202.65505695343,18078,4332,13746,13746,0,31,4313000.0
4313,4313999,21.175495190603122,38.61066293676034,0.08080165012011409,2847.7636523246765,329.08247351646423,2202.6623888015747,18092,4334,13758,13758,0,31,4314000.0
4314,4314999,21.17506348066609,38.60897303936194,0.08079573813160534,2848.514683008194,329.15413212776184,2202.6993684768677,18092,4334,13758,13758,0,31,4315000.0
4315,4315999,21.17429512444079,38.60683759154926,0.08078555332014148,2849.032098531723,329.22427225112915,2203.9267015457153,18104,4334,13770,13770,0,31,4316000.0
4316,4316999,21.173700902104063,38.60555418879016,0.08077328454767185,2849.433336019516,329.29404306411743,2205.6475191116333,18108,4334,13774,13774,0,31,4317000.0
4317,4317999,21.173680346208634,38.60593686820829,0.08075828901186488,2861.8916103839874,329.3627996444702,2207.2986879348755,18112,4335,13777,13777,0,31,4318000.0
4318,4318999,21.173576436738387,38.60577783787621,0.08074313968248537,2862.208731651306,329.4308195114136,2209.4663820266724,18112,4335,13777,13777,0,31,4319000.0
4319,4319999,21.17335889358771,38.604498466136775,0.08073688293024961,2863.343891620636,329.5020275115967,2207.528386116028,18125,4340,13785,13785,0,31,4320000.0
4320,4320999,21.173544214032805,38.60446650878448,0.0807258535653943,2863.8623893260956,329.57390832901,2208.6227922439575,18127,4341,13786,13786,0,31,4321000.0
4321,4321999,21.173688470981137,38.60369884369378,0.08071684754583885,2864.3675122261047,329.6424868106842,2209.9301195144653,18129,4342,13787,13787,0,31,4322000.0
4322,4322999,21.173611355337556,38.60289957497794,0.0807106491934596,2865.1048636436462,329.7123775482178,2210.019124031067,18131,4343,13788,13788,0,31,4323000.0
4323,4323999,21.173644201499403,38.60202402306605,0.08070071081510966,2866.3831787109375,329.7836606502533,2207.480191230774,18135,4344,13791,13791,0,31,4324000.0
4324,4324999,21.173768681279103,38.60132531639962,0.08069593291665178,2867.030413866043,329.854834318161,2208.071515083313,18135,4344,13791,13791,0,31,4325000.0
4325,4325999,21.17410469698023,38.600794330984684,0.08069306713076951,2867.6664888858795,329.925808429718,2208.576199531555,18137,4345,13792,13792,0,31,4326000.0
4326,4326999,21.17477674693698,38.6023504296072,0.08068852359618717,2867.976957798004,329.99418663978577,2210.800992012024,18137,4345,13792,13792,0,31,4327000.0
4327,4327999,21.175275115944178,38.60224620486321,0.08068659001673995,2869.15295958519,330.06480383872986,2208.7957887649536,18139,4346,13793,13793,0,31,4328000.0
4328,4328999,21.17605897197849,38.602011285354365,0.08069345962815144,2869.70782995224,330.1346707344055,2209.6248750686646,18141,4347,13794,13794,0,31,4329000.0
4329,4329999,21.177629273659985,38.60601026076339,0.08068314807454546,2870.3405437469482,330.2078413963318,2210.173985481262,18143,4348,13795,13795,0,31,4330000.0
4330,4330999,21.179287643761775,38.60735740376481,0.08069840065052125,2870.8690164089203,330.2794327735901,2211.3665590286255,18143,4348,13795,13795,0,31,4331000.0
4331,4331999,21.18205164959723,38.61120121951804,0.08071997644923057,2871.7324080467224,330.34955501556396,2210.8888368606567,18143,4348,13795,13795,0,31,4332000.0
4332,4332999,21.18435511700902,38.61422615692164,0.08076618645629408,2872.694502353668,330.42132544517517,2209.7553911209106,18163,4350,13813,13813,0,31,4333000.0
4333,4333999,21.186785898653373,38.616817689720484,0.08081293817573121,2873.413292169571,330.49110102653503,2209.8862733840942,18170,4351,13819,13819,0,31,4334000.0
4334,4334999,21.18917588451771,38.61917167520281,0.0808590413256487,2874.2710058689117,330.5633273124695,2209.3090028762817,18172,4352,13820,13820,0,31,4335000.0
4335,4335999,21.19033435727497,38.619672983926144,0.08086295460180026,2875.0044367313385,330.6368496417999,2209.4471940994263,18182,4353,13829,13829,0,31,4336000.0
4336,4336999,21.18974113476749,38.618920963943076,0.08082810715566968,2875.28667140007,330.7041437625885,2211.744282722473,18187,4353,13834,13834,0,31,4337000.0
4337,4337999,21.189090420063945,38.621083385856544,0.08079887336861613,2875.826573610306,330.7770779132843,2212.7862672805786,18198,4354,13844,13844,0,31,4338000.0
4338,4338999,21.18819899978992,38.61910329805926,0.08079052852762103,2876.3256182670593,330.84634137153625,2214.0955934524536,18201,4355,13846,13846,0,31,4339000.0
4339,4339999,21.187638688748773,38.617919637417884,0.08077352804834914,2876.9454333782196,330.91419887542725,2214.868046760559,18204,4356,13848,13848,0,31,4340000.0
4340,4340999,21.18669201723928,38.61590388336675,0.08075656752745108,2877.7664201259613,330.9829375743866,2214.4314012527466,18213,4360,13853,13853,0,31,4341000.0
4341,4341999,21.186022115526693,38.61544854918062,0.08073953495974062,2878.6100013256073,331.0523085594177,2214.114926338196,18215,4361,13854,13854,0,31,4342000.0
4342,4342999,21.18577114813915,38.61534950456433,0.0807229820369828,2879.160436630249,331.1226875782013,2215.18639087677,18217,4362,13855,13855,0,31,4343000.0
4343,4343999,21.185539888318754,38.61410093998525,0.08070506715013093,2880.0249185562134,331.19394516944885,2214.7915239334106,18217,4362,13855,13855,0,31,4344000.0
4344,4344999,21.185221000332866,38.612373998921385,0.08069975272042351,2880.561220884323,331.2638289928436,2215.8988847732544,18217,4362,13855,13855,0,31,4345000.0
4345,4345999,21.18596161852944,38.6132817140623,0.08068899251789674,2881.2145681381226,331.3339488506317,2216.149785041809,18232,4365,13867,13867,0,31,4346000.0
4346,4346999,21.186766161004957,38.61408627412566,0.08067692090615286,2882.0026252269745,331.40350675582886,2215.8070039749146,18234,4366,13868,13868,0,31,4347000.0
4347,4347999,21.187541013556928,38.61494400531963,0.080664962356787,2882.7403585910797,331.4771478176117,2215.8536043167114,18240,4367,13873,13873,0,31,4348000.0
4348,4348999,21.188686664275536,38.61644676329346,0.08065350357193113,2883.038680791855,331.54783391952515,2218.153172492981,18240,4367,13873,13873,0,31,4349000.0
4349,4349999,21.190547811755184,38.62118742588476,0.08064265866392428,2883.89648103714,331.621719121933,2217.6945009231567,18242,4368,13874,13874,0,31,4350000.0
4350,4350999,21.192523031632692,38.62888377462727,0.08061995471555872,2884.8622493743896,331.6919448375702,2216.7392473220825,18242,4368,13874,13874,0,31,4351000.0
4351,4351999,21.194915648580444,38.63234400464568,0.08062674822561133,2885.4037494659424,331.76227617263794,2217.5877656936646,18246,4370,13876,13876,0,31,4352000.0
4352,4352999,21.19729652480846,38.63541673364878,0.08062709225794651,2886.282882452011,331.83244252204895,2217.138424873352,18246,4370,13876,13876,0,31,4353000.0
4353,4353999,21.199891866767803,38.63851990452755,0.0806371267035969,2886.7991840839386,331.90274238586426,2218.1446657180786,18259,4372,13887,13887,0,31,4354000.0
4354,4354999,21.202173107950884,38.64064904044284,0.08065291731253665,2887.530216693878,331.97574067115784,2218.291195869446,18261,4373,13888,13888,0,31,4355000.0
4355,4355999,21.205147749798353,38.64404345151125,0.08066618616641386,2888.2821288108826,332.04923582077026,2218.3177995681763,18261,4373,13888,13888,0,31,4356000.0
4356,4356999,21.206028471598223,38.64330924534987,0.08067788963932854,2888.9212114810944,332.11868834495544,2218.860348701477,18267,4374,13893,13893,0,31,4357000.0
4357,4357999,21.205406236140462,38.64162690154396,0.08065621820802515,2889.4108169078827,332.187215089798,2220.3009309768677,18352,4375,13977,13977,0,31,4358000.0
4358,4358999,21.204553670100996,38.641952957707865,0.08063426010737706,2889.70365858078,332.25625824928284,2222.6571702957153,18355,4375,13980,13980,0,31,4359000.0
4359,4359999,21.204137141797084,38.641528235554134,0.08062552106561527,2890.4162378311157,332.3274953365326,2222.841275215149,18363,4377,13986,13986,0,31,4360000.0
4360,4360999,21.204116500095772,38.641100091974785,0.08061321765599527,2890.90105676651,332.39699697494507,2224.1224641799927,18367,4379,13988,13988,0,31,4361000.0
4361,4361999,21.20480004180879,38.643338252215386,0.08057745180126019,2891.596792459488,332.4734697341919,2224.8450441360474,18372,4381,13991,13991,0,31,4362000.0
4362,4362999,21.20531311183938,38.64376041295697,0.0805646782557703,2892.1304066181183,332.5477077960968,2226.076970100403,18381,4383,13998,13998,0,31,4363000.0
4363,4363999,21.205164576428878,38.642532786563244,0.0805575614464531,2892.950898885727,332.61841464042664,2225.9159593582153,18383,4384,13999,13999,0,31,4364000.0
4364,4364999,21.2056468636486,38.642209565625684,0.08054060574744559,2893.815242767334,332.68850660324097,2225.1688661575317,18394,4387,14007,14007,0,31,4365000.0
4365,4365999,21.205470868335148,38.64088680583352,0.08052944216339375,2894.3391847610474,332.75865721702576,2226.28608417511,18394,4387,14007,14007,0,31,4366000.0
4366,4366999,21.205879843860533,38.64052520876877,0.08052808727796512,2894.789232492447,332.8288311958313,2227.5734148025513,18396,4388,14008,14008,0,31,4367000.0
4367,4367999,21.20590802716378,38.63971265046937,0.08052257527151563,2895.675505876541,332.9023644924164,2226.894986152649,18398,4389,14009,14009,0,31,4368000.0
4368,4368999,21.206365241713737,38.63961265515558,0.08051727016993215,2896.2002861499786,332.97145080566406,2228.0358476638794,18398,4389,14009,14009,0,31,4369000.0
4369,4369999,21.20695887403166,38.64020265225683,0.08050959468976948,2897.0681912899017,333.0423560142517,2227.3560457229614,18402,4391,14011,14011,0,31,4370000.0
4370,4370999,21.207670812347036,38.640296172039825,0.08049522014762978,2897.4886305332184,333.1128671169281,2228.966824531555,18402,4391,14011,14011,0,31,4371000.0
4371,4371999,21.20806624376527,38.639865353794576,0.08048721673520187,2898.237781047821,333.1841595172882,2228.996403694153,18402,4391,14011,14011,0,31,4372000.0
4372,4372999,21.2090613926648,38.64076072579696,0.08048447568859862,2899.0863733291626,333.2571153640747,2228.614659309387,18402,4391,14011,14011,0,31,4373000.0
4373,4373999,21.209951242243452,38.64106892133748,0.08048299217752308,2899.8274965286255,333.3267459869385,2228.657895088196,18402,4391,14011,14011,0,31,4374000.0
4374,4374999,21.210825054730684,38.64205900275963,0.08046828407968443,2900.2399673461914,333.3957784175873,2230.2475175857544,18402,4391,14011,14011,0,31,4375000.0
4375,4375999,21.2117032359245,38.64280891317029,0.08045726675109388,2901.2941811084747,333.4664876461029,2228.785656929016,18411,4393,14018,14018,0,31,4376000.0
4376,4376999,21.212278149986187,38.64217284775736,0.08046161537472107,2901.7073423862457,333.5385534763336,2230.3608827590942,18411,4393,14018,14018,0,31,4377000.0
4377,4377999,21.21254287965685,38.64203013070205,0.08045167961434596,2902.5663192272186,333.610205411911,2229.89301776886,18411,4393,14018,14018,0,31,4378000.0
4378,4378999,21.213100395594704,38.64240012286943,0.08042366731409123,2903.068038702011,333.6806831359863,2231.2358827590942,18423,4393,14030,14030,0,31,4379000.0
4379,4379999,21.21333575255688,38.64347034415197,0.08039933079120642,2903.357540369034,333.7493679523468,2233.5340700149536,18427,4393,14034,14034,0,31,4380000.0
4380,4380999,21.213429062426304,38.642690767326705,0.08038321644020374,2903.8669006824493,333.8194980621338,2234.693425178528,18431,4394,14037,14037,0,31,4381000.0
4381,4381999,21.213720832511253,38.642639011517,0.08036996235942395,2904.6037554740906,333.89283776283264,2235.0002489089966,18431,4394,14037,14037,0,31,4382000.0
4382,4382999,21.214159131802305,38.6425471211378,0.08036147405705696,2905.3249378204346,333.9619073867798,2234.999264717102,18438,4397,14041,14041,0,31,4383000.0
4383,4383999,21.215140698563463,38.65310554716843,0.08031610153804758,2905.9634943008423,334.0322666168213,2235.8682222366333,18438,4397,14041,14041,0,31,4384000.0
4384,4384999,21.215164752237115,38.65265477519452,0.08031051879507345,2906.566050052643,334.10238885879517,2236.7016649246216,18441,4398,14043,14043,0,31,4385000.0
4385,4385999,21.2155652272154,38.65287791425349,0.08030440166358432,2907.5127975940704,334.17177748680115,2235.6767320632935,18450,4400,14050,14050,0,31,4386000.0
4386,4386999,21.21575714456464,38.65286016531602,0.08029161574390276,2908.060005903244,334.24183917045593,2236.7112398147583,18450,4400,14050,14050,0,31,4387000.0
4387,4387999,21.216047761636794,38.65298651824588,0.08028387929603353,2909.040855884552,334.3126218318939,2235.620274543762,18454,4402,14052,14052,0,31,4388000.0
4388,4388999,21.216654500097405,38.653620228665105,0.08027959208186564,2910.02197599411,334.3858757019043,2234.5216188430786,18456,4403,14053,14053,0,31,4389000.0
4389,4389999,21.217186996591337,38.65361737412167,0.0802763863792999,2910.454360961914,334.4546523094177,2235.9957551956177,18458,4404,14054,14054,0,31,4390000.0
4390,4390999,21.217876416621255,38.65515189560398,0.08027228631382965,2911.003654241562,334.52516078948975,2236.828526496887,18460,4405,14055,14055,0,31,4391000.0
4391,4391999,21.21868142303132,38.655706859425536,0.08027285628691427,2911.769546031952,334.5956325531006,2236.706624031067,18462,4406,14056,14056,0,31,4392000.0
4392,4392999,21.219697996326992,38.65660868903232,0.08026116946720319,2912.402941942215,334.66541385650635,2237.2925157546997,18462,4406,14056,14056,0,31,4393000.0
4393,4393999,21.22084230174742,38.6572713798205,0.08026656134215049,2912.928777694702,334.73648142814636,2238.388096809387,18462,4406,14056,14056,0,31,4394000.0
4394,4394999,21.222804455897375,38.66387591755808,0.08024583041664979,2913.4520168304443,334.807270526886,2239.4422121047974,18464,4407,14057,14057,0,31,4395000.0
4395,4395999,21.224121440356114,38.66582628105948,0.0802506430793467,2914.197510242462,334.87831115722656,2239.4972887039185,18464,4407,14057,14057,0,31,4396000.0
4396,4396999,21.225344091130374,38.66743823782919,0.08024900213897102,2915.0395929813385,334.95157837867737,2239.107663154602,18464,4407,14057,14057,0,31,4397000.0
4397,4397999,21.226610175836722,38.66984135740012,0.08024440607763761,2915.562126636505,335.0273690223694,2240.1974840164185,18464,4407,14057,14057,0,31,4398000.0
4398,4398999,21.227242513139398,38.66920030509311,0.08023904334902687,2916.302578687668,335.0978510379791,2240.2254152297974,18464,4407,14057,14057,0,31,4399000.0
4399,4399999,21.22690907424171,38.66737954892642,0.08022599458551127,2916.8975281715393,335.1724042892456,2240.910183906555,18502,4410,14092,14092,0,31,4400000.0
4400,4400999,21.22566264412474,38.667169303744735,0.08021359040739529,2917.189785718918,335.2425618171692,2243.2696046829224,18507,4410,14097,14097,0,31,4401000.0
4401,4401999,21.22434318803916,38.6654247062321,0.08020592573503638,2917.9042518138885,335.3158700466156,2243.4466066360474,18519,4412,14107,14107,0,31,4402000.0
4402,4402999,21.223236565074213,38.66376993401643,0.08020000311093611,2918.642796278,335.38575291633606,2243.5270433425903,18528,4414,14114,14114,0,31,4403000.0
4403,4403999,21.222064928984473,38.66131968056386,0.08019294434820357,2919.050860643387,335.4575445652008,2245.2306184768677,18532,4415,14117,14117,0,31,4404000.0
4404,4404999,21.22119332273179,38.65956148902835,0.08018152337421913,2920.0905809402466,335.53150248527527,2243.7924089431763,18540,4419,14121,14121,0,31,4405000.0
4405,4405999,21.220190343696437,38.65690214876824,0.08018030279295396,2920.817385196686,335.60268211364746,2243.7681550979614,18546,4422,14124,14124,0,31,4406000.0
4406,4406999,21.21972049305502,38.65563700477588,0.08017042652614403,2921.241087913513,335.67412853240967,2245.4387407302856,18546,4422,14124,14124,0,31,4407000.0
4407,4407999,21.21952359549961,38.655439727775374,0.08015908024226459,2921.658024787903,335.74762320518494,2247.070065498352,18548,4423,14125,14125,0,31,4408000.0
4408,4408999,21.22023604539577,38.65818760359181,0.08013335218441608,2922.3960020542145,335.81908345222473,2247.1550722122192,18550,4424,14126,14126,0,31,4409000.0
4409,4409999,21.222893845187603,38.66650282936118,0.08007363435779957,2923.01878118515,335.8901917934418,2247.9436082839966,18550,4424,14126,14126,0,31,4410000.0
4410,4410999,21.22645058103421,38.67825865902336,0.08002882745317719,2923.452174425125,335.9624319076538,2249.564778327942,18550,4424,14126,14126,0,31,4411000.0
4411,4411999,21.231220039516103,38.69746737554834,0.07994503025143218,2924.3047387599945,336.0336549282074,2249.066533088684,18563,4426,14137,14137,0,31,4412000.0
4412,4412999,21.23580994299046,38.71142239396646,0.079897841460001,2925.139392375946,336.1041188240051,2248.5203523635864,18569,4429,14140,14140,0,31,4413000.0
4413,4413999,21.240846313016363,38.729043773976805,0.07983634536096063,2925.8681180477142,336.17698645591736,2248.5043001174927,18573,4431,14142,14142,0,31,4414000.0
4414,4414999,21.246731804676266,38.74879886848344,0.07979435986653127,2926.5248329639435,336.24700951576233,2248.9068574905396,18575,4432,14143,14143,0,31,4415000.0
4415,4415999,21.253137600934352,38.77177253435538,0.07975861018349084,2927.2554109096527,336.3208165168762,2249.0081148147583,18589,4434,14155,14155,0,31,4416000.0
4416,4416999,21.259634298900252,38.78865034306462,0.07975074460501741,2927.8013310432434,336.3951053619385,2250.041745185852,18598,4435,14163,14163,0,31,4417000.0
4417,4417999,21.265907045594417,38.80621698180138,0.07976820065966395,2928.7435891628265,336.46785521507263,2249.2196016311646,18607,4437,14170,14170,0,31,4418000.0
4418,4418999,21.273429144412983,38.8260458815962,0.07979663616678445,2929.2912814617157,336.53956866264343,2250.292233467102,18608,4438,14170,14170,0,31,4419000.0
4419,4419999,21.27893578981267,38.84028208301972,0.07982260962308074,2930.1604998111725,336.6140637397766,2249.8032655715942,18610,4439,14171,14171,0,31,4420000.0
4420,4420999,21.27918950025198,38.84102946348889,0.07979881783248921,2930.654878616333,336.7371189594269,2252.335659980774,18635,4439,14196,14196,0,31,4421000.0
4421,4421999,21.277911824239506,38.838776656344486,0.07979196570282332,2930.9457318782806,336.80818152427673,2254.7011003494263,18641,4439,14202,14202,0,31,4422000.0
4422,4422999,21.276823278692806,38.836539776724955,0.07978634094823411,2931.3551144599915,336.8787851333618,2256.3635835647583,18645,4440,14205,14205,0,31,4423000.0
4423,4423999,21.276530713287524,38.84065564452803,0.07976204304632717,2931.657502412796,336.9493634700775,2258.6246461868286,18646,4440,14206,14206,0,31,4424000.0
4424,4424999,21.276245313413035,38.84034963998655,0.07975216487263448,2932.370980501175,337.0207259654999,2258.850255012512,18648,4441,14207,14207,0,31,4425000.0
4425,4425999,21.275731171462667,38.839254235899354,0.07973772983009475,2932.965190887451,337.09279799461365,2259.6087312698364,18652,4443,14209,14209,0,31,4426000.0
4426,4426999,21.274901506305987,38.83707939347244,0.07973673578187213,2933.7761294841766,337.1647951602936,2258.9686250686646,18662,4448,14214,14214,0,31,4427000.0
4427,4427999,21.274396849357437,38.83526465909965,0.07973664278252601,2934.492247581482,337.2387981414795,2258.9590730667114,18683,4452,14231,14231,0,31,4428000.0
4428,4428999,21.27405441131473,38.8339787219258,0.07972794458216248,2935.2186646461487,337.3117790222168,2259.0505266189575,18687,4454,14233,14233,0,31,4429000.0
4429,4429999,21.274421827589865,38.83775328847339,0.07970226226716226,2935.6509029865265,337.3832459449768,2260.49099445343,18689,4455,14234,14234,0,31,4430000.0
4430,4430999,21.275362116454488,38.83919164470342,0.0796829421894174,2936.1804597377777,337.4559917449951,2261.6602449417114,18689,4455,14234,14234,0,31,4431000.0
4431,4431999,21.27636573425753,38.840800038319735,0.07967064865622386,2936.815356492996,337.53018712997437,2262.515034675598,18689,4455,14234,14234,0,31,4432000.0
4432,4432999,21.27750655708189,38.84246107254351,0.0796624617697489,2937.666697740555,337.6032247543335,2262.077488899231,18691,4456,14235,14235,0,31,4433000.0
4433,4433999,21.278919505956463,38.844616554872964,0.07965088756851801,2938.287591934204,337.67368841171265,2262.9298906326294,18691,4456,14235,14235,0,31,4434000.0
4434,4434999,21.280712611457407,38.84826109570929,0.07964955481049019,2939.0044984817505,337.74422121047974,2263.159878730774,18691,4456,14235,14235,0,31,4435000.0
4435,4435999,21.28334687263994,38.85306637740674,0.0796491089434741,2939.727911233902,337.81457924842834,2263.2201356887817,18703,4458,14245,14245,0,31,4436000.0
4436,4436999,21.285361503744166,38.86009232533364,0.079640995938554,2940.658778190613,337.8902163505554,2262.4905366897583,18705,4459,14246,14246,0,31,4437000.0
4437,4437999,21.287567946035878,38.86299327792467,0.07965576186770784,2941.2923181056976,337.96133685112,2263.035771369934,18712,4460,14252,14252,0,31,4438000.0
4438,4438999,21.2900582612514,38.86765148127764,0.07966048300085216,2942.0210580825806,338.03492069244385,2263.0354051589966,18724,4462,14262,14262,0,31,4439000.0
4439,4439999,21.29287911279098,38.8729746198052,0.0796728560583212,2942.7628650665283,338.1060049533844,2263.067708015442,18726,4463,14263,14263,0,31,4440000.0
4440,4440999,21.29439283438231,38.87441559386771,0.07970240428647624,2943.4060781002045,338.1777334213257,2263.6325731277466,18726,4463,14263,14263,0,31,4441000.0
4441,4441999,21.29433891960746,38.87335126553655,0.07970556634395176,2943.903916120529,338.24944591522217,2264.925976753235,18758,4465,14293,14293,0,31,4442000.0
4442,4442999,21.292878801514185,38.87127310537146,0.07970838015483284,2944.1863627433777,338.3220405578613,2267.265019416809,18773,4466,14307,14307,0,31,4443000.0
4443,4443999,21.291404199621507,38.86999705770129,0.07970878908305556,2944.727549791336,338.3940451145172,2268.1702394485474,18777,4467,14310,14310,0,31,4444000.0
4444,4444999,21.289713396780176,38.86774250303406,0.07971358091089609,2945.1348955631256,338.46449398994446,2270.0549745559692,18778,4467,14311,14311,0,31,4445000.0
4445,4445999,21.28827808976486,38.86531187520493,0.07971432014996449,2946.184898853302,338.5366575717926,2268.6374940872192,18809,4470,14339,14339,0,31,4446000.0
4446,4446999,21.28673367625459,38.8627878897053,0.07971960731668326,2946.611076116562,338.607572555542,2270.493809700012,18809,4470,14339,14339,0,31,4447000.0
4447,4447999,21.285283918503097,38.86052967147747,0.07972076272121853,2947.6038269996643,338.6793096065521,2269.3454484939575,18819,4475,14344,14344,0,31,4448000.0
4448,4448999,21.283942117133005,38.857922380930425,0.07972749336792306,2948.2545194625854,338.75250601768494,2269.955906867981,18821,4476,14345,14345,0,31,4449000.0
4449,4449999,21.282653635619578,38.85547594048229,0.07973009114949636,2948.7827200889587,338.827241897583,2271.360058784485,18821,4476,14345,14345,0,31,4450000.0
4450,4450999,21.28149547738384,38.853608047202286,0.07972873603236641,2949.6213941574097,338.8992669582367,2271.0946550369263,18823,4477,14346,14346,0,31,4451000.0
4451,4451999,21.28057904867394,38.85139023574512,0.07972734930523273,2950.066295862198,338.9700689315796,2272.623227119446,18825,4478,14347,14347,0,31,4452000.0
4452,4452999,21.279795938553207,38.8500851447769,0.07972195210221922,2950.83438539505,339.04137992858887,2272.752957344055,18834,4480,14354,14354,0,31,4453000.0
4453,4453999,21.27867043947864,38.84762271820938,0.07972362329589289,2951.5835382938385,339.11602878570557,2272.8264589309692,18836,4481,14355,14355,0,31,4454000.0
4454,4454999,21.277891957657424,38.84562763549244,0.07972152525995468,2952.951184272766,339.2096676826477,2270.9915132522583,18850,4485,14365,14365,0,31,4455000.0
4455,4455999,21.27703616532513,38.84342503742762,0.0797220716482655,2953.7267894744873,339.2830662727356,2270.675518989563,18854,4487,14367,14367,0,31,4456000.0
4456,4456999,21.276351469219463,38.841669051456044,0.07971722292540262,2954.124306678772,339.35634565353394,2272.602231025696,18855,4487,14368,14368,0,31,4457000.0
4457,4457999,21.275603448821762,38.839632255031354,0.07971871659122254,2954.982557296753,339.4296293258667,2272.0020418167114,18861,4490,14371,14371,0,31,4458000.0
4458,4458999,21.274844291391798,38.837531304233025,0.07971740449870968,2955.875367641449,339.5029549598694,2271.2228059768677,18870,4492,14378,14378,0,31,4459000.0
4459,4459999,21.274049475348793,38.83578526646732,0.079716064051646,2956.5173161029816,339.5742676258087,2271.780659675598,18878,4493,14385,14385,0,31,4460000.0
4460,4460999,21.274277320324305,38.83684516970441,0.07959620907860265,2956.8189086914062,339.6468303203583,2274.032597541809,18907,4494,14413,14413,0,31,4461000.0
4461,4461999,21.273281766108365,38.83469628809514,0.07957920801017926,2957.3217735290527,339.7178318500519,2275.241696357727,18912,4495,14417,14417,0,31,4462000.0
4462,4462999,21.27253588168821,38.83363022220346,0.07955900984824094,2957.6125061511993,339.7886517047882,2277.4947023391724,18920,4496,14424,14424,0,31,4463000.0
4463,4463999,21.271150175063344,38.83121149538626,0.0795610624084746,2958.025278568268,339.8604619503021,2279.168957710266,18925,4498,14427,14427,0,31,4464000.0
4464,4464999,21.27003300766404,38.829476327185695,0.07955397389503438,2958.4412784576416,339.93229031562805,2280.8781023025513,18927,4499,14428,14428,0,31,4465000.0
4465,4465999,21.269040736965128,38.82802347955745,0.07954965974211281,2959.235766172409,340.0045189857483,2280.722233772278,18933,4502,14431,14431,0,31,4466000.0
4466,4466999,21.26789211947963,38.82970728869839,0.07952900339412772,2960.024415254593,340.07654786109924,2280.629162788391,18949,4505,14444,14444,0,31,4467000.0
4467,4467999,21.266493945305427,38.827161827217104,0.07952101864783911,2960.6483721733093,340.14905190467834,2281.2723894119263,18953,4507,14446,14446,0,31,4468000.0
4468,4468999,21.26535053017909,38.82484901064325,0.07951317429010474,2961.0781495571136,340.2215328216553,2282.9442644119263,18953,4507,14446,14446,0,31,4469000.0
4469,4469999,21.264138460870228,38.822553986084095,0.07950961577064286,2961.71591424942,340.29493713378906,2283.510190010071,18957,4509,14448,14448,0,31,4470000.0
4470,4470999,21.26331981807975,38.82079476370151,0.07949951625875917,2962.464817762375,340.36679792404175,2283.4934587478638,18961,4511,14450,14450,0,31,4471000.0
4471,4471999,21.262802703781126,38.81938059761165,0.07948587664405415,2963.0222704410553,340.4385163784027,2284.286015510559,18965,4513,14452,14452,0,31,4472000.0
4472,4472999,21.26231805298877,38.818491598391375,0.07947007737156064,2963.7558450698853,340.5120074748993,2284.6735582351685,18965,4513,14452,14452,0,31,4473000.0
4473,4473999,21.261900296321993,38.81729281204635,0.07945758038095507,2964.609900712967,340.58550572395325,2284.135579109192,18969,4515,14454,14454,0,31,4474000.0
4474,4474999,21.26151492568945,38.81599153347715,0.07944464348297553,2965.7636289596558,340.6618037223816,2282.1455965042114,19001,4519,14482,14482,0,31,4475000.0
4475,4475999,21.261297489260166,38.81446908900297,0.07943778913258248,2966.7969777584076,340.73460125923157,2280.787320137024,19005,4521,14484,14484,0,31,4476000.0
4476,4476999,21.260915738408155,38.81270729053668,0.07943213873372212,2967.329037666321,340.8102447986603,2281.9143114089966,19006,4521,14485,14485,0,31,4477000.0
4477,4477999,21.261198328739546,38.81221237002351,0.07941481025527986,2967.959264278412,340.88247537612915,2282.6474809646606,19006,4521,14485,14485,0,31,4478000.0
4478,4478999,21.261268332600192,38.81105309782888,0.07940245461102236,2968.3849682807922,340.9562141895294,2284.23668384552,19006,4521,14485,14485,0,31,4479000.0
4479,4479999,21.261107083448156,38.8097460684872,0.07939185517919611,2969.1476197242737,341.0283658504486,2284.27916431427,19006,4521,14485,14485,0,31,4480000.0
4480,4480999,21.260561843453317,38.80856803862116,0.07938482907745203,2969.8899574279785,341.10277247428894,2284.668393135071,19016,4521,14495,14495,0,31,4481000.0
4481,4481999,21.25949915091678,38.80699648206217,0.0793663437918497,2970.4579660892487,341.17261958122253,2285.5738649368286,19033,4523,14510,14510,0,31,4482000.0
4482,4482999,21.25862851362976,38.80826300942949,0.0793303859337906,2970.9824736118317,341.2432596683502,2286.9050722122192,19039,4523,14516,14516,0,31,4483000.0
4483,4483999,21.257293985193886,38.806149824151966,0.07932356376527139,2971.370549917221,341.3163802623749,2288.7924852371216,19040,4523,14517,14517,0,31,4484000.0
4484,4484999,21.256338036914794,38.80555741997998,0.07931350155865624,2971.6699521541595,341.38772201538086,2290.9707384109497,19043,4524,14519,14519,0,31,4485000.0
4485,4485999,21.254966617703285,38.80309993062941,0.07931186785144728,2972.5985000133514,341.4591329097748,2289.998112678528,19052,4528,14524,14524,0,31,4486000.0
4486,4486999,21.253650613722634,38.80065135187153,0.07931083662895089,2973.0039269924164,341.52884101867676,2291.629849433899,19056,4530,14526,14526,0,31,4487000.0
4487,4487999,21.25219789971478,38.79809437904656,0.0793042907460938,2973.936898946762,341.6000304222107,2290.565754890442,19070,4535,14535,14535,0,31,4488000.0
4488,4488999,21.251160795174084,38.79626473443894,0.07929527461050945,2974.5680253505707,341.6724510192871,2291.1001176834106,19076,4538,14538,14538,0,31,4489000.0
4489,4489999,21.249888684593472,38.79359686911327,0.07929206997030835,2975.424989461899,341.7451503276825,2290.3156328201294,19089,4542,14547,14547,0,31,4490000.0
4490,4490999,21.24864872156468,38.791144472188016,0.07928820384636548,2975.9606091976166,341.81855726242065,2291.493504524231,19089,4542,14547,14547,0,31,4491000.0
4491,4491999,21.24783223859988,38.78940028504571,0.07928225616077411,2976.5090634822845,341.8934659957886,2292.6417741775513,19089,4542,14547,14547,0,31,4492000.0
4492,4492999,21.247294776183473,38.788746779546976,0.07926955021547522,2976.9402627944946,341.96403908729553,2294.279965400696,19089,4542,14547,14547,0,31,4493000.0
4493,4493999,21.246921574950903,38.78778096359442,0.07925957440483045,2977.582125902176,342.0358135700226,2294.966336250305,19089,4542,14547,14547,0,31,4494000.0
4494,4494999,21.246408558814938,38.78666829184673,0.07925155450832555,2978.2149245738983,342.1077826023102,2295.6229753494263,19089,4542,14547,14547,0,31,4495000.0
4495,4495999,21.246374022455548,38.78602378845699,0.07923771538615265,2979.0180191993713,342.1817488670349,2295.736508369446,19089,4542,14547,14547,0,31,4496000.0
4496,4496999,21.246020858305805,38.78432211149541,0.07923179079080911,2979.656829357147,342.2527403831482,2296.209630012512,19091,4543,14548,14548,0,31,4497000.0
4497,4497999,21.245457846820685,38.78267829012945,0.07923034696482933,2980.199408054352,342.32485580444336,2297.2816591262817,19094,4544,14550,14550,0,31,4498000.0
4498,4498999,21.245451648105696,38.78155163271154,0.07922313127054059,2980.8373868465424,342.3977737426758,2297.9300050735474,19094,4544,14550,14550,0,31,4499000.0
4499,4499999,21.245061595367023,38.779778855459746,0.07921491222976662,2981.819270133972,342.4717423915863,2297.430745124817,19094,4544,14550,14550,0,31,4500000.0
4500,4500999,21.245058964387947,38.78010654105003,0.0792036768952663,2982.8141293525696,342.54289531707764,2296.102452278137,19096,4545,14551,14551,0,31,4501000.0
4501,4501999,21.24462563792942,38.77829883410679,0.07920071527879768,2983.55167555809,342.6180145740509,2296.2507905960083,19096,4545,14551,14551,0,31,4502000.0
4502,4502999,21.24429566593703,38.77775274599392,0.07918499038901727,2983.836798429489,342.6886627674103,2298.6521577835083,19116,4545,14571,14571,0,31,4503000.0
4503,4503999,21.243405475713697,38.77767916811786,0.07917260239566104,2984.3320195674896,342.75932693481445,2299.8852739334106,19122,4545,14577,14577,0,31,4504000.0
4504,4504999,21.242439037879674,38.775385048755815,0.0791680389221685,2984.7350461483,342.8303020000458,2301.50621509552,19128,4546,14582,14582,0,31,4505000.0
4505,4505999,21.241654859554316,38.77354272399606,0.07916164779909629,2985.2397112846375,342.90181255340576,2302.629780769348,19138,4548,14590,14590,0,31,4506000.0
4506,4506999,21.240643058780844,38.770935218062405,0.07915668856580593,2985.868323326111,342.9746103286743,2303.223156929016,19143,4550,14593,14593,0,31,4507000.0
4507,4507999,21.23999864535889,38.76966868224953,0.07915188990699307,2986.6660170555115,343.0457408428192,2303.0379915237427,19150,4553,14597,14597,0,31,4508000.0
4508,4508999,21.239689620258254,38.76796160836762,0.07914972302358225,2987.27214884758,343.1181080341339,2303.7883882522583,19163,4556,14607,14607,0,31,4509000.0
4509,4509999,21.239198527282614,38.766249994740086,0.07914934019876241,2987.5844309329987,343.1877851486206,2305.922505378723,19165,4557,14608,14608,0,31,4510000.0
4510,4510999,21.238553045071235,38.76418640794817,0.07914836019770843,2988.293923854828,343.26018738746643,2306.0522966384888,19171,4560,14611,14611,0,31,4511000.0
4511,4511999,21.23810428386306,38.762839649799865,0.07914631023942631,2988.8173644542694,343.33181500434875,2307.1128435134888,19175,4562,14613,14613,0,31,4512000.0
4512,4512999,21.237638966111227,38.760874445311316,0.07915373053033081,2989.705062389374,343.4040689468384,2306.4022035598755,19177,4563,14614,14614,0,31,4513000.0
4513,4513999,21.23743516364129,38.75970037317167,0.07915740043642217,2990.1304116249084,343.4749972820282,2308.061345100403,19177,4563,14614,14614,0,31,4514000.0
4514,4514999,21.237235928756913,38.75858904777471,0.07915316813888784,2990.7607798576355,343.54875683784485,2308.6934785842896,19179,4564,14615,14615,0,31,4515000.0
4515,4515999,21.237208358142084,38.75756946095488,0.07914618714419352,2991.415198326111,343.62304639816284,2309.2904024124146,19179,4564,14615,14615,0,31,4516000.0
4516,4516999,21.236954246870184,38.75584206708884,0.0791438550438347,2992.3831033706665,343.6949224472046,2308.119023323059,19185,4567,14618,14618,0,31,4517000.0
4517,4517999,21.23701037692314,38.75459544232312,0.07913729001414205,3006.160368204117,343.7688298225403,2307.1296739578247,19187,4568,14619,14619,0,31,4518000.0
4518,4518999,21.236864148671778,38.75298631691915,0.07913525005483502,3006.90345621109,343.8407428264618,2307.114903450012,19187,4568,14619,14619,0,31,4519000.0
4519,4519999,21.237069035566307,38.752201505855666,0.0791276318062375,3007.6291060447693,343.9108154773712,2307.074528694153,19190,4569,14621,14621,0,31,4520000.0
4520,4520999,21.237340159798695,38.7512262364978,0.07911987494062334,3008.1376600265503,343.98056650161743,2308.165463447571,19190,4569,14621,14621,0,31,4521000.0
4521,4521999,21.237322687510662,38.74971066324728,0.07911374243527036,3009.074584722519,344.0518362522125,2307.1943712234497,19192,4570,14622,14622,0,31,4522000.0
4522,4522999,21.23739926798596,38.74850972072413,0.0791053907602941,3009.905119895935,344.1227505207062,2306.7192888259888,19192,4570,14622,14622,0,31,4523000.0
4523,4523999,21.236748115690965,38.7468286717713,0.07909041308107301,3010.194202899933,344.1909439563751,2309.0894289016724,19214,4570,14644,14644,0,31,4524000.0
4524,4524999,21.235697392064232,38.74555314314838,0.07906948613980935,3010.5641655921936,344.2571310997009,2310.8070878982544,19223,4571,14652,14652,0,31,4525000.0
4525,4525999,21.234317449699823,38.74329964433459,0.079064251077414,3010.9503271579742,344.3238387107849,2312.5320024490356,19227,4572,14655,14655,0,31,4526000.0
4526,4526999,21.23260699961932,38.74067000517823,0.07906767647448742,3011.3131976127625,344.3897132873535,2314.46324634552,19227,4572,14655,14655,0,31,4527000.0
4527,4527999,21.231440358003937,38.73995047618218,0.07905758171127042,3012.0184800624847,344.4561996459961,2314.6056184768677,19232,4573,14659,14659,0,31,4528000.0
4528,4528999,21.230208322341298,38.73774789048721,0.0790534134070634,3012.9151525497437,344.5259141921997,2313.445523262024,19247,4579,14668,14668,0,31,4529000.0
4529,4529999,21.228740945875234,38.73489677578487,0.07905171570443303,3013.5055060386658,344.5938332080841,2314.0105028152466,19251,4581,14670,14670,0,31,4530000.0
4530,4530999,21.22733991983181,38.732301648912724,0.07904425476070753,3014.091210603714,344.6602826118469,2314.5424013137817,19258,4584,14674,14674,0,31,4531000.0
4531,4531999,21.226032518168942,38.73019049383882,0.07904017281307862,3014.657856464386,344.7286729812622,2315.6907243728638,19258,4584,14674,14674,0,31,4532000.0
4532,4532999,21.224743834783986,38.72787804896889,0.07903293449649829,3015.2687735557556,344.8004457950592,2316.405697822571,19260,4585,14675,14675,0,31,4533000.0
4533,4533999,21.223550955605056,38.725591266058295,0.07902811230991058,3015.9830396175385,344.86897015571594,2316.5304231643677,19260,4585,14675,14675,0,31,4534000.0
4534,4534999,21.222520852248056,38.723746438760706,0.0790195024126531,3016.8067741394043,344.9394567012787,2316.0935945510864,19262,4586,14676,14676,0,31,4535000.0
4535,4535999,21.22213657443227,38.72367692186904,0.07900435622639013,3017.221749305725,345.00782012939453,2317.7324724197388,19262,4586,14676,14676,0,31,4536000.0
4536,4536999,21.221304404856227,38.7222042073974,0.07899402784617804,3017.631014108658,345.07528734207153,2319.351529121399,19262,4586,14676,14676,0,31,4537000.0
4537,4537999,21.220685629376632,38.72062338794194,0.07898067101978334,3018.538106203079,345.1471359729767,2319.002079963684,19262,4586,14676,14676,0,31,4538000.0
4538,4538999,21.220202786124293,38.719124619363356,0.07897187500198488,3019.2510073184967,345.2169599533081,2319.033917427063,19264,4587,14677,14677,0,31,4539000.0
4539,4539999,21.220159535050918,38.718227853056774,0.07895467974144099,3019.672223806381,345.285475730896,2320.6321382522583,19264,4587,14677,14677,0,31,4540000.0
4540,4540999,21.220197251792907,38.717803086327905,0.07893499646474578,3020.2893438339233,345.35414123535156,2321.091221809387,19267,4588,14679,14679,0,31,4541000.0
4541,4541999,21.220615352138932,38.71760950726763,0.07891919916923318,3021.2086350917816,345.42165064811707,2320.1249284744263,19269,4589,14680,14680,0,31,4542000.0
4542,4542999,21.2212773091851,38.717930495673876,0.07889304384477902,3021.9950342178345,345.4906702041626,2320.00906085968,19278,4591,14687,14687,0,31,4543000.0
4543,4543999,21.22215894231099,38.71811126771802,0.07886973720409074,3022.6838676929474,345.5628321170807,2320.390751838684,19280,4592,14688,14688,0,31,4544000.0
4544,4544999,21.221642525698766,38.716354129831245,0.07886387140402518,3023.4241025447845,345.6318781375885,2320.328923225403,19282,4593,14689,14689,0,31,4545000.0
4545,4545999,21.220177088957712,38.713483521686406,0.07885867260051904,3023.789491176605,345.70009684562683,2322.321858406067,19306,4593,14713,14713,0,31,4546000.0
4546,4546999,21.218993658759,38.7121067974427,0.07884580641929073,3024.1653230190277,345.7675642967224,2324.084683418274,19319,4594,14725,14725,0,31,4547000.0
4547,4547999,21.217831943294836,38.71178461694326,0.07882809058534279,3024.6577672958374,345.83354663848877,2325.3977556228638,19321,4594,14727,14727,0,31,4548000.0
4548,4548999,21.21709756376523,38.71029460526306,0.07881592657194592,3025.25749874115,345.90286135673523,2325.9864473342896,19339,4597,14742,14742,0,31,4549000.0
4549,4549999,21.216791390892407,38.71027044697077,0.07879561344781472,3025.647820711136,345.979291677475,2327.882924079895,19342,4598,14744,14744,0,31,4550000.0
4550,4550999,21.21657041830548,38.7094565372616,0.07878101367228207,3026.1601126194,346.0472455024719,2328.826672554016,19348,4601,14747,14747,0,31,4551000.0
4551,4551999,21.21607987908399,38.70917958150489,0.07876823019974744,3026.9645183086395,346.118759393692,2328.449444770813,19356,4605,14751,14751,0,31,4552000.0
4552,4552999,21.21620015863203,38.710099541997636,0.07874926280057315,3027.5626544952393,346.186546087265,2329.0846605300903,19358,4606,14752,14752,0,31,4553000.0
4553,4553999,21.21657166128063,38.71099493543574,0.07874531148243391,3028.4553248882294,346.2556526660919,2328.088032722473,19364,4609,14755,14755,0,31,4554000.0
4554,4554999,21.21712238545497,38.712346424512475,0.07873053128965624,3028.7576179504395,346.3228611946106,2330.2768983840942,19364,4609,14755,14755,0,31,4555000.0
4555,4555999,21.21772896443798,38.71399700456022,0.07872733857868841,3029.4737396240234,346.3915090560913,2330.5182695388794,19364,4609,14755,14755,0,31,4556000.0
4556,4556999,21.218552091114795,38.71540691294505,0.07872214120238707,3030.1057426929474,346.4585428237915,2330.729977607727,19373,4611,14762,14762,0,31,4557000.0
4557,4557999,21.21977338073672,38.71786450529187,0.07871194577615837,3030.7985458374023,346.5256938934326,2331.220845222473,19374,4611,14763,14763,0,31,4558000.0
4558,4558999,21.221992211978105,38.72222067709983,0.07868792361743016,3031.4016501903534,346.5954747200012,2331.773159980774,19376,4612,14764,14764,0,31,4559000.0
4559,4559999,21.224104646794775,38.7254782500485,0.07868985174107923,3032.2710535526276,346.6642551422119,2331.1146364212036,19378,4613,14765,14765,0,31,4560000.0
4560,4560999,21.22626249428487,38.7284389407093,0.07869583584369877,3032.755092382431,346.7322142124176,2332.406430244446,19378,4613,14765,14765,0,31,4561000.0
4561,4561999,21.228880308787904,38.731823825217695,0.07871727226084935,3033.4007234573364,346.80238127708435,2332.980870246887,19379,4613,14766,14766,0,31,4562000.0
4562,4562999,21.231378533780504,38.73575743614286,0.07874361880436931,3034.1256651878357,346.8700256347656,2333.043049812317,19379,4613,14766,14766,0,31,4563000.0
4563,4563999,21.234488350410643,38.74047848549492,0.07876510580453533,3034.785143852234,346.94446849823,2333.36990070343,19394,4615,14779,14779,0,31,4564000.0
4564,4564999,21.237515775642944,38.744509119842576,0.07880205881173563,3035.297733783722,347.0146493911743,2334.4815950393677,19394,4615,14779,14779,0,31,4565000.0
4565,4565999,21.239817207501357,38.74668323121869,0.07883625958225204,3036.02352643013,347.08237957954407,2334.441128730774,19395,4616,14779,14779,0,31,4566000.0
4566,4566999,21.238828795694282,38.744233238152475,0.07882943664716657,3036.614487886429,347.15427350997925,2335.404408454895,19428,4617,14811,14811,0,31,4567000.0
4567,4567999,21.23760333561616,38.742689633608784,0.07882307743579953,3036.8883459568024,347.2199456691742,2337.722783088684,19436,4617,14819,14819,0,31,4568000.0
4568,4568999,21.23630057057466,38.74145595869568,0.07881918969414103,3037.361970424652,347.28778982162476,2338.851902961731,19444,4620,14824,14824,0,31,4569000.0
4569,4569999,21.23473011494278,38.7386064373581,0.07882339185605047,3037.651129722595,347.3542139530182,2341.1062211990356,19445,4620,14825,14825,0,31,4570000.0
4570,4570999,21.233203571714938,38.73588707526581,0.07882200117565852,3038.1290516853333,347.4218804836273,2342.3661699295044,19447,4621,14826,14826,0,31,4571000.0
4571,4571999,21.23194414977654,38.733774042716746,0.07881692855418321,3038.9203028678894,347.49171710014343,2341.9075441360474,19453,4624,14829,14829,0,31,4572000.0
4572,4572999,21.230683243228395,38.73202204017724,0.07881403927169617,3039.59050488472,347.55961656570435,2342.047375679016,19460,4627,14833,14833,0,31,4573000.0
4573,4573999,21.22953320066775,38.730375476806536,0.07880838529047074,3040.122711420059,347.63168144226074,2343.1536149978638,19469,4629,14840,14840,0,31,4574000.0
4574,4574999,21.228422883993428,38.728872378345756,0.07879597271706484,3040.697974920273,347.7000961303711,2344.066014289856,19471,4630,14841,14841,0,31,4575000.0
4575,4575999,21.227628512850906,38.72785011319261,0.07878867127463685,3041.506481409073,347.7687568664551,2343.653256416321,19478,4631,14847,14847,0,31,4576000.0
4576,4576999,21.227296225542332,38.732253287283726,0.07875603975610401,3041.9252586364746,347.8372402191162,2345.0973711013794,19480,4632,14848,14848,0,31,4577000.0
4577,4577999,21.228178179116888,38.735486048258736,0.07873160579227134,3042.646869659424,347.90469241142273,2345.1832094192505,19480,4632,14848,14848,0,31,4578000.0
4578,4578999,21.230613115958185,38.74313849246814,0.07869474045890823,3043.3666157722473,347.9756395816803,2345.0551805496216,19484,4634,14850,14850,0,31,4579000.0
4579,4579999,21.23341271554849,38.75043634199743,0.07868410506379908,3043.8578305244446,348.0428431034088,2346.2690629959106,19486,4635,14851,14851,0,31,4580000.0
4580,4580999,21.236606854177275,38.76000944347757,0.07866835696583296,3044.5643219947815,348.1104073524475,2346.3506898880005,19488,4636,14852,14852,0,31,4581000.0
4581,4581999,21.24130785538984,38.77272186960548,0.07869092131154487,3045.3827555179596,348.1788306236267,2345.817296028137,19494,4639,14855,14855,0,31,4582000.0
4582,4582999,21.246100298772106,38.784388371053105,0.07870350029061057,3046.412333726883,348.2477705478668,2344.425877571106,19499,4641,14858,14858,0,31,4583000.0
4583,4583999,21.25126777129743,38.79845634271436,0.0787351124699569,3046.9110090732574,348.31661343574524,2345.5481843948364,19501,4642,14859,14859,0,31,4584000.0
4584,4584999,21.2551451186648,38.80634272766301,0.07877949114919502,3047.5682170391083,348.3862147331238,2346.0100297927856,19503,4643,14860,14860,0,31,4585000.0
4585,4585999,21.260079334325265,38.8153415905819,0.07884021266399643,3048.5964159965515,348.45737528800964,2344.5923738479614,19503,4643,14860,14860,0,31,4586000.0
4586,4586999,21.262317048283755,38.81849258011916,0.07885714993757764,3049.106677055359,348.5254445075989,2345.876675605774,19526,4644,14882,14882,0,31,4587000.0
4587,4587999,21.261233837976697,38.81793831999272,0.07883650090054395,3049.480318069458,348.59196281433105,2347.897831916809,19545,4644,14901,14901,0,31,4588000.0
4588,4588999,21.26024684172863,38.817409585262,0.07882854564287223,3049.7819526195526,348.6617181301117,2350.213345527649,19552,4644,14908,14908,0,31,4589000.0
4589,4589999,21.259098066102077,38.815615617310485,0.0788264500431457,3050.129452228546,348.7278537750244,2352.405674934387,19553,4644,14909,14909,0,31,4590000.0
4590,4590999,21.257917563753992,38.813415181420176,0.07882404459297021,3050.745546579361,348.79710936546326,2353.072522163391,19561,4646,14915,14915,0,31,4591000.0
4591,4591999,21.25691208273076,38.81221324781943,0.07881604683959831,3051.33492231369,348.86594915390015,2353.8745698928833,19563,4647,14916,14916,0,31,4592000.0
4592,4592999,21.25583843710144,38.81107452144095,0.07880835739683012,3052.122454404831,348.9353325366974,2353.619542121887,19569,4650,14919,14919,0,31,4593000.0
4593,4593999,21.254592206890155,38.80873917684033,0.07880673786528991,3052.4154126644135,349.00534749031067,2355.752751350403,19571,4651,14920,14920,0,31,4594000.0
4594,4594999,21.253626453247854,38.80670209496132,0.07879821980801927,3053.011031627655,349.0734281539917,2356.4642839431763,19573,4652,14921,14921,0,31,4595000.0
4595,4595999,21.25293018176839,38.80507928362037,0.07878985958145168,3053.723852157593,349.1414761543274,2356.3691911697388,19577,4654,14923,14923,0,31,4596000.0
4596,4596999,21.252603022570838,38.804134500020076,0.07877726195633294,3054.5385575294495,349.20936274528503,2355.859974861145,19589,4657,14932,14932,0,31,4597000.0
4597,4597999,21.252368746007974,38.80395222845187,0.07876733492883825,3055.1587493419647,349.27698278427124,2356.5477571487427,19591,4658,14933,14933,0,31,4598000.0
4598,4598999,21.25220855090555,38.80295008448954,0.07875381064956977,3055.8223361968994,349.3445384502411,2356.6033754348755,19595,4660,14935,14935,0,31,4599000.0
4599,4599999,21.252337184619744,38.802611209611136,0.07873982608318641,3056.5243995189667,349.4157178401947,2356.8869676589966,19595,4660,14935,14935,0,31,4600000.0
4600,4600999,21.253033818300302,38.80628307955566,0.07870982313949593,3057.345667362213,349.4879951477051,2356.4275331497192,19597,4661,14936,14936,0,31,4601000.0
4601,4601999,21.253352281515006,38.807212734444725,0.07869621029994955,3057.951194047928,349.55479311943054,2356.9906435012817,19599,4662,14937,14937,0,31,4602000.0
4602,4602999,21.25412603666701,38.808640959003796,0.07868178889221455,3058.630262851715,349.6247766017914,2357.4528093338013,19600,4662,14938,14938,0,31,4603000.0
4603,4603999,21.254528403890184,38.80978493142002,0.07867588304226114,3059.2514033317566,349.695631980896,2358.0370149612427,19600,4662,14938,14938,0,31,4604000.0
4604,4604999,21.254879396697543,38.80901630862902,0.07866991323373274,3060.0092055797577,349.7673296928406,2358.1127519607544,19600,4662,14938,14938,0,31,4605000.0
4605,4605999,21.25471720025543,38.80820136757567,0.07865098380161473,3060.296184539795,349.8352544307709,2360.5669374465942,19626,4662,14964,14964,0,31,4606000.0
4606,4606999,21.25395408341499,38.807892261448835,0.07865585256934426,3060.5541818141937,349.90251064300537,2362.9740419387817,19635,4662,14973,14973,0,31,4607000.0
4607,4607999,21.252735548579285,38.80623301983453,0.07865796803436265,3060.824317216873,349.96847677230835,2365.321957588196,19639,4662,14977,14977,0,31,4608000.0
4608,4608999,21.251625169599453,38.804313072394365,0.07866253920836563,3061.206357240677,350.0362985134125,2366.961194038391,19644,4664,14980,14980,0,31,4609000.0
4609,4609999,21.25160552916792,38.805715013359155,0.07865116457520005,3061.860627889633,350.1026406288147,2367.426838874817,19648,4666,14982,14982,0,31,4610000.0
4610,4610999,21.252384581042534,38.80703061586698,0.07864126094341128,3062.324255466461,350.17008566856384,2368.8258867263794,19650,4667,14983,14983,0,31,4611000.0
4611,4611999,21.253376622272725,38.808054683338554,0.0786336808125383,3063.024171113968,350.23976945877075,2368.8176698684692,19660,4671,14989,14989,0,31,4612000.0
4612,4612999,21.25427867908329,38.810582539280816,0.07863769326580239,3063.6016488075256,350.30909061431885,2369.4851655960083,19666,4674,14992,14992,0,31,4613000.0
4613,4613999,21.254902652686372,38.810659093668136,0.07864245657711488,3064.1070845127106,350.378134727478,2370.531979560852,19668,4675,14993,14993,0,31,4614000.0
4614,4614999,21.256175067446094,38.81209763271386,0.07865972006522559,3064.812266111374,350.44730043411255,2370.787678718567,19679,4678,15001,15001,0,31,4615000.0
4615,4615999,21.25801471996585,38.81493480790129,0.078698612315376,3065.6140372753143,350.5167553424835,2370.251156806946,19690,4681,15009,15009,0,31,4616000.0
4616,4616999,21.259922433921574,38.81760859118079,0.07872924745653831,3066.229129076004,350.5888092517853,2370.8979082107544,19703,4682,15021,15021,0,31,4617000.0
4617,4617999,21.261205422385558,38.81899480653349,0.07875320324086976,3066.8649876117706,350.65804505348206,2371.3701906204224,19707,4684,15023,15023,0,31,4618000.0
4618,4618999,21.262981825679653,38.821559940384425,0.07878335077281884,3067.393832206726,350.73047637939453,2372.2617082595825,19711,4686,15025,15025,0,31,4619000.0
4619,4619999,21.264919488019327,38.825405799341354,0.07885093702156487,3068.12291264534,350.8010787963867,2372.179440498352,19713,4687,15026,15026,0,31,4620000.0
4620,4620999,21.26685599407513,38.82803371745998,0.07891220344199479,3068.83913397789,350.87487173080444,2372.361149787903,19715,4688,15027,15027,0,31,4621000.0
4621,4621999,21.26908222420137,38.83247627569224,0.07897107041416385,3069.987067461014,350.9486644268036,2370.419949531555,19721,4690,15031,15031,0,31,4622000.0
4622,4622999,21.271566506450174,38.836276945346356,0.07903070596880502,3070.2882084846497,351.0183629989624,2372.5846223831177,19721,4690,15031,15031,0,31,4623000.0
4623,4623999,21.27347564470335,38.83807411686238,0.07909627391144924,3070.7855088710785,351.08616161346436,2373.822262763977,19721,4690,15031,15031,0,31,4624000.0
4624,4624999,21.275277906221024,38.84107644117613,0.07912846681004271,3071.7389838695526,351.1577477455139,2372.4946184158325,19723,4691,15032,15032,0,31,4625000.0
4625,4625999,21.276191794931968,38.841162788118076,0.07912805434247527,3072.0286581516266,351.22632217407227,2374.961850166321,19751,4691,15060,15060,0,31,4626000.0
4626,4626999,21.27510409077161,38.83996810697514,0.07912449326772786,3072.399191379547,351.2933158874512,2376.64781665802,19763,4692,15071,15071,0,31,4627000.0
4627,4627999,21.27415057128916,38.838245105889904,0.07913152963658965,3072.5781841278076,351.36296367645264,2379.4722108840942,19765,4692,15073,15073,0,31,4628000.0
4628,4628999,21.27346663184575,38.83654678514808,0.07913355559276514,3072.865428686142,351.43177366256714,2381.69086933136,19767,4693,15074,15074,0,31,4629000.0
4629,4629999,21.27313080512957,38.83554561511059,0.07913563038145555,3073.339577436447,351.49909353256226,2382.913472175598,19774,4695,15079,15079,0,31,4630000.0
4630,4630999,21.27324387175382,38.83600916486956,0.07913414169764599,3073.981339454651,351.5668704509735,2383.4135637283325,19780,4698,15082,15082,0,31,4631000.0
4631,4631999,21.27336376553918,38.835813816041785,0.07913257209285385,3074.552004337311,351.6329758167267,2384.0839433670044,19786,4701,15085,15085,0,31,4632000.0
4632,4632999,21.273156976477953,38.8344652114788,0.07914410210448497,3075.206374168396,351.70196413993835,2384.4482774734497,19797,4705,15092,15092,0,31,4633000.0
4633,4633999,21.272941468859546,38.833402884283885,0.07916391845854931,3075.889065027237,351.7704961299896,2384.6397981643677,19799,4706,15093,15093,0,31,4634000.0
4634,4634999,21.27330289380475,38.835859505973495,0.07918571606873714,3076.199423313141,351.84025621414185,2386.8337831497192,19799,4706,15093,15093,0,31,4635000.0
4635,4635999,21.273556824624407,38.83587303507178,0.0791993364110345,3076.927908182144,351.9083559513092,2386.577778816223,19801,4707,15094,15094,0,31,4636000.0
4636,4636999,21.27498872443584,38.83902255851015,0.07922313135891912,3077.5439453125,351.97938656806946,2387.054409980774,19825,4710,15115,15115,0,31,4637000.0
4637,4637999,21.276813744282492,38.842556168745226,0.07926147607396539,3077.974245071411,352.04797291755676,2388.6768007278442,19825,4710,15115,15115,0,31,4638000.0
4638,4638999,21.27805970450327,38.84423592331872,0.07929516783482327,3078.704714536667,352.1160395145416,2388.5276460647583,19828,4711,15117,15117,0,31,4639000.0
4639,4639999,21.280086774058045,38.84753116036244,0.07932594167964857,3079.181719303131,352.18547558784485,2389.8265504837036,19828,4711,15117,15117,0,31,4640000.0
4640,4640999,21.282724296427816,38.85124809451163,0.0793592987336803,3079.996912240982,352.25352454185486,2389.1863374710083,19832,4713,15119,15119,0,31,4641000.0
4641,4641999,21.285097924939368,38.854552360718344,0.07942225753130083,3080.5861279964447,352.32168841362,2389.782940864563,19841,4715,15126,15126,0,31,4642000.0
4642,4642999,21.287946828366035,38.86063188908569,0.07947643135421278,3081.1545174121857,352.3903341293335,2390.6815004348755,19851,4717,15134,15134,0,31,4643000.0
4643,4643999,21.291282856793398,38.868496797898665,0.07952927446137859,3082.1071014404297,352.4618446826935,2389.9659090042114,19855,4719,15136,15136,0,31,4644000.0
4644,4644999,21.293816510419454,38.872540427510465,0.07956139577163923,3083.2163956165314,352.53117179870605,2388.005223274231,19862,4721,15141,15141,0,31,4645000.0
4645,4645999,21.29583957759063,38.87456785879674,0.07959722131159952,3083.720644712448,352.5991008281708,2389.1134691238403,19862,4721,15141,15141,0,31,4646000.0
4646,4646999,21.296735018824876,38.87651127389985,0.07950933910706459,3084.002185344696,352.66653776168823,2391.5215044021606,19892,4722,15170,15170,0,31,4647000.0
4647,4647999,21.295657185711512,38.87598051972256,0.07949984236916197,3084.3673248291016,352.73459815979004,2393.400776863098,19900,4722,15178,15178,0,31,4648000.0
4648,4648999,21.29469878212999,38.87450961071311,0.07949829257261432,3084.557379961014,352.80379033088684,2396.1895112991333,19904,4722,15182,15182,0,31,4649000.0
4649,4649999,21.29415361322074,38.873241967522226,0.07949578312974281,3085.2219750881195,352.87299394607544,2396.785092353821,19905,4722,15183,15183,0,31,4650000.0
4650,4650999,21.29367861734826,38.87283055607404,0.07949009861277057,3085.802075624466,352.94069600105286,2397.5347871780396,19910,4724,15186,15186,0,31,4651000.0
4651,4651999,21.29343373420878,38.871750106832195,0.07948788564791842,3086.3489055633545,353.00866532325745,2398.636815071106,19914,4726,15188,15188,0,31,4652000.0
4652,4652999,21.293086346766472,38.870931229857575,0.07947924545253482,3086.843558549881,353.0776455402374,2399.555989265442,19920,4729,15191,15191,0,31,4653000.0
4653,4653999,21.29256884354448,38.869359072900195,0.07947769895086954,3087.6598615646362,353.1452646255493,2398.672101020813,19928,4733,15195,15195,0,31,4654000.0
4654,4654999,21.292730863256935,38.86965249921314,0.07947470142864,3088.371029138565,353.2150721549988,2398.5498628616333,19934,4736,15198,15198,0,31,4655000.0
4655,4655999,21.293116911521796,38.87066263923995,0.07946694409534971,3088.8674092292786,353.2837734222412,2399.8291063308716,19934,4736,15198,15198,0,31,4656000.0
4656,4656999,21.29374802378309,38.87169511099002,0.07945874708011469,3089.7153651714325,353.3537631034851,2399.3496294021606,19936,4737,15199,15199,0,31,4657000.0
4657,4657999,21.295117031504237,38.87635170887514,0.0794465075567391,3090.328416109085,353.42148447036743,2399.9774446487427,19936,4737,15199,15199,0,31,4658000.0
4658,4658999,21.29604123247005,38.8783470034224,0.07943761979228059,3090.6422011852264,353.4904863834381,2402.1221895217896,19936,4737,15199,15199,0,31,4659000.0
4659,4659999,21.29684756220035,38.87896804401399,0.07943555881508269,3091.447930574417,353.55953550338745,2401.6011934280396,19940,4739,15201,15201,0,31,4660000.0
4660,4660999,21.29782260936236,38.87996039538901,0.07943385741105335,3092.050472021103,353.6272768974304,2402.1115617752075,19944,4741,15203,15203,0,31,4661000.0
4661,4661999,21.299753225783462,38.88268667238746,0.0794554990326537,3092.763802051544,353.6971688270569,2402.20747089386,19946,4742,15204,15204,0,31,4662000.0
4662,4662999,21.301745994126048,38.886412555939025,0.07946508133837127,3093.495411157608,353.76858949661255,2402.0512132644653,19949,4743,15206,15206,0,31,4663000.0
4663,4663999,21.30329659271872,38.887987581621196,0.07947754510692673,3093.8933510780334,353.835679769516,2403.6681566238403,19949,4743,15206,15206,0,31,4664000.0
4664,4664999,21.304711826762393,38.88860827903792,0.07948737962187769,3094.3999071121216,353.90358233451843,2404.756016731262,19956,4744,15212,15212,0,31,4665000.0
4665,4665999,21.306379800308633,38.89027758963459,0.07947709495194477,3095.356721162796,353.9736611843109,2403.593197822571,19958,4745,15213,15213,0,31,4666000.0
4666,4666999,21.30707316849913,38.8899540894892,0.0794669534748097,3095.8812096118927,354.0478799343109,2404.8974199295044,19978,4745,15233,15233,0,31,4667000.0
4667,4667999,21.30586090915807,38.888259727097626,0.07946305226312111,3096.1310544013977,354.11397218704224,2407.3372774124146,19996,4746,15250,15250,0,31,4668000.0
4668,4668999,21.30446422121914,38.88614726708898,0.07946377170020202,3096.4039969444275,354.18006777763367,2409.6468172073364,19999,4746,15253,15253,0,31,4669000.0
4669,4669999,21.303054411826036,38.88369556709386,0.07946631308136265,3096.773481607437,354.2476963996887,2411.305676460266,20003,4748,15255,15255,0,31,4670000.0
4670,4670999,21.30199459311377,38.88260524265125,0.07945986309373099,3097.059147119522,354.31306767463684,2413.5114030838013,20006,4749,15257,15257,0,31,4671000.0
4671,4671999,21.300612928908656,38.88003741648785,0.07946295468819231,3097.846477985382,354.37932538986206,2413.052929878235,20015,4753,15262,15262,0,31,4672000.0
4672,4672999,21.299320359389238,38.87729166690855,0.0794627360532858,3098.5415477752686,354.44661569595337,2413.1438493728638,20021,4756,15265,15265,0,31,4673000.0
4673,4673999,21.298559802950397,38.87654063628589,0.07945718042245087,3099.1750915050507,354.5142865180969,2413.739193916321,20026,4758,15268,15268,0,31,4674000.0
4674,4674999,21.297501830972536,38.87424210250029,0.07946044800494279,3099.5644116401672,354.5806849002838,2415.424626350403,20026,4758,15268,15268,0,31,4675000.0
4675,4675999,21.296650785092208,38.87240400934512,0.07946430521328296,3100.2687163352966,354.650999546051,2415.28307056427,20041,4762,15279,15279,0,31,4676000.0
4676,4676999,21.295999863613986,38.87107890651475,0.07946453601445802,3100.8481154441833,354.71776151657104,2416.078923225403,20049,4763,15286,15286,0,31,4677000.0
4677,4677999,21.2956046279557,38.87000514991481,0.07946741273743163,3101.5741381645203,354.78956294059753,2416.1837663650513,20049,4763,15286,15286,0,31,4678000.0
4678,4678999,21.295731677189305,38.87240544085089,0.07945467315611532,3101.979439496994,354.8578453063965,2417.809750556946,20049,4763,15286,15286,0,31,4679000.0
4679,4679999,21.295551069639128,38.87166624998456,0.07944475251782745,3102.837260246277,354.9277505874634,2417.069760322571,20051,4764,15287,15287,0,31,4680000.0
4680,4680999,21.295890736333593,38.87162941200798,0.07944521615107314,3103.538234472275,354.99449133872986,2416.9819383621216,20055,4766,15289,15289,0,31,4681000.0
4681,4681999,21.296488083500975,38.87232734061985,0.07944460939316933,3103.927363395691,355.06119322776794,2418.545506477356,20059,4768,15291,15291,0,31,4682000.0
4682,4682999,21.297307974834844,38.872528980442254,0.07945843113467022,3104.672050714493,355.1311893463135,2418.624691963196,20059,4768,15291,15291,0,31,4683000.0
4683,4683999,21.299537664252895,38.88434985064358,0.07945034560557651,3105.253574371338,355.1989223957062,2419.4490251541138,20062,4769,15293,15293,0,31,4684000.0
4684,4684999,21.300723253721554,38.88568317999168,0.07945157685762949,3106.0676329135895,355.2682328224182,2419.0238313674927,20062,4769,15293,15293,0,31,4685000.0
4685,4685999,21.302107521597055,38.88904415765109,0.07944872483260546,3107.015810728073,355.33988904953003,2417.904667854309,20066,4771,15295,15295,0,31,4686000.0
4686,4686999,21.30331233603457,38.89023833345218,0.07945908671233815,3107.6085333824158,355.40789556503296,2418.4591188430786,20068,4772,15296,15296,0,31,4687000.0
4687,4687999,21.30317283043344,38.88931328134875,0.07945492432483825,3107.8906724452972,355.4753255844116,2420.8477602005005,20098,4773,15325,15325,0,31,4688000.0
4688,4688999,21.302226380067037,38.88840246222478,0.07945020351025656,3108.2620227336884,355.5449447631836,2422.6550645828247,20107,4774,15333,15333,0,31,4689000.0
4689,4689999,21.3013578350454,38.88903021513656,0.07945420723817964,3108.428511619568,355.61088824272156,2425.469807624817,20109,4774,15335,15335,0,31,4690000.0
4690,4690999,21.30060997848664,38.88801481757387,0.0794481788781588,3108.9011788368225,355.6773805618286,2426.6284685134888,20113,4776,15337,15337,0,31,4691000.0
4691,4691999,21.299465176349166,38.885718071480625,0.0794490605043583,3109.3841812610626,355.7434425354004,2427.7767992019653,20120,4778,15342,15342,0,31,4692000.0
4692,4692999,21.298713981772224,38.88418326762488,0.07944297685258506,3109.959005355835,355.8104820251465,2428.606602668762,20126,4781,15345,15345,0,31,4693000.0
4693,4693999,21.298322774606714,38.883834489212944,0.07942959271263939,3110.5396904945374,355.87845492362976,2429.238018989563,20130,4783,15347,15347,0,31,4694000.0
4694,4694999,21.297623156785715,38.88194914765872,0.07942790043475834,3111.19286775589,355.94635248184204,2429.750226020813,20132,4784,15348,15348,0,31,4695000.0
4695,4695999,21.297265496261453,38.881655085610106,0.07941371224899196,3111.6884875297546,356.01510524749756,2430.9256105422974,20132,4784,15348,15348,0,31,4696000.0
4696,4696999,21.29750399045635,38.88251177781235,0.07939982744248963,3112.4647607803345,356.08488488197327,2430.858654975891,20144,4787,15357,15357,0,31,4697000.0
4697,4697999,21.297805297469704,38.88437438018535,0.07940335487710537,3112.964257955551,356.153044462204,2431.9502458572388,20146,4788,15358,15358,0,31,4698000.0
4698,4698999,21.298560728740217,38.88624341890819,0.07940657258764616,3113.587968826294,356.22169065475464,2432.6198167800903,20148,4789,15359,15359,0,31,4699000.0
4699,4699999,21.300205186437587,38.89184914317781,0.07940100529234317,3114.196843624115,356.2894275188446,2433.131688117981,20158,4791,15367,15367,0,31,4700000.0
4700,4700999,21.30209664889925,38.89680670796768,0.07938193177737951,3114.9224236011505,356.3650326728821,2433.4570741653442,20158,4791,15367,15367,0,31,4701000.0
4701,4701999,21.304521052871788,38.90454642746672,0.07935180823846577,3116.1632854938507,356.4371817111969,2431.2383852005005,20166,4793,15373,15373,0,31,4702000.0
4702,4702999,21.307508947232364,38.9133660354281,0.07933762331487737,3116.6857318878174,356.50443625450134,2432.065396308899,20168,4794,15374,15374,0,31,4703000.0
4703,4703999,21.311108455711764,38.92494816596763,0.07930743594314249,3117.3942182064056,356.5773751735687,2432.6856355667114,20171,4795,15376,15376,0,31,4704000.0
4704,4704999,21.315283014956226,38.93648493243655,0.07926898254149206,3117.9185655117035,356.650390625,2433.903218269348,20171,4795,15376,15376,0,31,4705000.0
4705,4705999,21.31907549856103,38.94734120958154,0.07924424386422324,3118.692650079727,356.7192931175232,2433.7211961746216,20173,4796,15377,15377,0,31,4706000.0
4706,4706999,21.323686365442928,38.9590343577087,0.07922175801862619,3119.5284218788147,356.7898383140564,2433.2019472122192,20175,4797,15378,15378,0,31,4707000.0
4707,4707999,21.326485963080124,38.964493244079314,0.07920375432351989,3119.8203291893005,356.8609447479248,2435.6318254470825,20203,4797,15406,15406,0,31,4708000.0
4708,4708999,21.324926134673927,38.961755289449734,0.07920143546539637,3120.386340379715,356.92978501319885,2436.5181703567505,20234,4798,15436,15436,0,31,4709000.0
4709,4709999,21.32419841582474,38.96163711696492,0.07918620094290763,3120.5732424259186,356.999587059021,2439.3235216140747,20236,4798,15438,15438,0,31,4710000.0
4710,4710999,21.323569676151763,38.961157334197516,0.07917026113239312,3121.362497806549,357.0674338340759,2438.8820085525513,20242,4801,15441,15441,0,31,4711000.0
4711,4711999,21.32280004782753,38.959833563324,0.07915848734126785,3121.7572214603424,357.1339771747589,2440.4979219436646,20253,4803,15450,15450,0,31,4712000.0
4712,4712999,21.322119547007315,38.95843044375373,0.079153453025396,3122.263430118561,357.2024064064026,2441.656247138977,20255,4804,15451,15451,0,31,4713000.0
4713,4713999,21.321325497988536,38.95619420959896,0.07915054579679226,3122.9069702625275,357.2694802284241,2442.306263923645,20259,4806,15453,15453,0,31,4714000.0
4714,4714999,21.32063781503277,38.95428063247704,0.07914729369394768,3123.9082794189453,357.33738017082214,2440.8271226882935,20265,4809,15456,15456,0,31,4715000.0
4715,4715999,21.3200276545689,38.95276795000956,0.07914285465861859,3124.3929936885834,357.40460443496704,2442.197178840637,20265,4809,15456,15456,0,31,4716000.0
4716,4716999,21.319510165145225,38.952898496713836,0.07913191607274739,3125.0038046836853,357.4750597476959,2442.818181037903,20267,4810,15457,15457,0,31,4717000.0
4717,4717999,21.31951013156171,38.952447963653675,0.0791214271341032,3125.5096259117126,357.5437424182892,2443.945164680481,20274,4811,15463,15463,0,31,4718000.0
4718,4718999,21.319710867798804,38.9526154293057,0.079106816543844,3126.133670091629,357.612370967865,2444.4811296463013,20277,4812,15465,15465,0,31,4719000.0
4719,4719999,21.320120582394146,38.953365640041326,0.07909754763205057,3126.772015094757,357.67999482154846,2444.850682258606,20283,4815,15468,15468,0,31,4720000.0
4720,4720999,21.321098176761666,38.95492344127142,0.07908964235607985,3127.1658720970154,357.74895882606506,2446.736584663391,20283,4815,15468,15468,0,31,4721000.0
4721,4721999,21.323004568294888,38.958640972982586,0.0790742714799284,3127.8808476924896,357.81775999069214,2446.977551460266,20285,4816,15469,15469,0,31,4722000.0
4722,4722999,21.325908392362464,38.96506720232114,0.07906704069331683,3128.663797855377,357.885879278183,2446.8816270828247,20287,4817,15470,15470,0,31,4723000.0
4723,4723999,21.33001424256596,38.97342486678425,0.07906497662974254,3129.173901081085,357.9529347419739,2447.996739387512,20287,4817,15470,15470,0,31,4724000.0
4724,4724999,21.333512292187592,38.97882753631399,0.07908968979516351,3129.8160588741302,358.0226287841797,2448.320508003235,20292,4819,15473,15473,0,31,4725000.0
4725,4725999,21.337551998969097,38.98589258438491,0.07911764946504563,3144.0221564769745,358.0953154563904,2449.07497882843,20292,4819,15473,15473,0,31,4726000.0
4726,4726999,21.34218583090319,38.996265761228884,0.07917461042541785,3145.0331239700317,358.16577315330505,2447.7723894119263,20294,4820,15474,15474,0,31,4727000.0
4727,4727999,21.345731450686323,39.00334654146904,0.07922155238073714,3145.4251494407654,358.23321056365967,2449.6315507888794,20294,4820,15474,15474,0,31,4728000.0
4728,4728999,21.346715815050764,39.00406958149093,0.07923120723847055,3145.8202290534973,358.3029456138611,2451.5723161697388,20323,4821,15502,15502,0,31,4729000.0
4729,4729999,21.34652226146975,39.00486971688239,0.07921367914745614,3146.091532230377,358.3700199127197,2453.9929933547974,20338,4821,15517,15517,0,31,4730000.0
4730,4730999,21.346378319543042,39.004964757725965,0.07920016176531719,3146.527763605118,358.43608832359314,2455.6801042556763,20350,4822,15528,15528,0,31,4731000.0
4731,4731999,21.346447445895635,39.00505531255806,0.07920971663127141,3147.0169191360474,358.5034267902374,2456.917996406555,20350,4822,15528,15528,0,31,4732000.0
4732,4732999,21.346666317231332,39.00579037892885,0.07920057455535046,3147.4073719978333,358.5697500705719,2458.556851387024,20357,4824,15533,15533,0,31,4733000.0
4733,4733999,21.34630765567988,39.004739006752025,0.07919930437649247,3147.9267234802246,358.63846039772034,2459.3191804885864,20366,4827,15539,15539,0,31,4734000.0
4734,4734999,21.345903799893556,39.00388304759132,0.07921504806687762,3148.5746746063232,358.7048945426941,2459.8947038650513,20376,4830,15546,15546,0,31,4735000.0
4735,4735999,21.34535606245054,39.00264887251461,0.07922807803356835,3149.272707462311,358.77294850349426,2459.93492603302,20380,4832,15548,15548,0,31,4736000.0
4736,4736999,21.345365361870503,39.00241473695122,0.07922582766717057,3149.864515542984,358.8425464630127,2460.5439348220825,20384,4834,15550,15550,0,31,4737000.0
4737,4737999,21.34553020108579,39.00243831362851,0.07923089650757109,3150.0601654052734,358.90951013565063,2463.227520942688,20384,4834,15550,15550,0,31,4738000.0
4738,4738999,21.345555748706342,39.001795306513635,0.07922978826425675,3150.687493085861,358.9793345928192,2463.7187395095825,20390,4837,15553,15553,0,31,4739000.0
4739,4739999,21.345775754964173,39.001506066434104,0.0792342186548397,3151.4339830875397,359.04760217666626,2463.696873664856,20393,4838,15555,15555,0,31,4740000.0
4740,4740999,21.345903626100654,39.001308497292435,0.0792374095238666,3152.1577677726746,359.115047454834,2463.391453742981,20398,4840,15558,15558,0,31,4741000.0
4741,4741999,21.34692810214445,39.0029304655003,0.07923271007678612,3152.45246219635,359.1820321083069,2465.5525636672974,20398,4840,15558,15558,0,31,4742000.0
4742,4742999,21.34848039584337,39.00607016927237,0.07923855363838539,3153.45339512825,359.2524778842926,2464.0374574661255,20402,4842,15560,15560,0,31,4743000.0
4743,4743999,21.349784578678793,39.00737552026352,0.07925208041247755,3154.0341277122498,359.3211033344269,2464.805745124817,20407,4844,15563,15563,0,31,4744000.0
4744,4744999,21.350901974677047,39.008723901294736,0.0792694791646773,3154.7389986515045,359.3895654678345,2464.878010749817,20407,4844,15563,15563,0,31,4745000.0
4745,4745999,21.352481501370157,39.01178115040586,0.07925751934705028,3155.367731809616,359.46035718917847,2465.57465839386,20407,4844,15563,15563,0,31,4746000.0
4746,4746999,21.35285399828392,39.01428719121452,0.07923696856281492,3155.8436665534973,359.5293698310852,2467.1044130325317,20439,4844,15595,15595,0,31,4747000.0
4747,4747999,21.35137077178097,39.01307816003335,0.07923994919374766,3156.106732606888,359.5974061489105,2469.541974067688,20448,4844,15604,15604,0,31,4748000.0
4748,4748999,21.349548059885024,39.01024939450924,0.07925890116527878,3156.281548023224,359.66463136672974,2472.3508882522583,20450,4844,15606,15606,0,31,4749000.0
4749,4749999,21.347957548504024,39.008611390068566,0.0792666221110011,3156.8773744106293,359.73239827156067,2472.964550971985,20459,4847,15612,15612,0,31,4750000.0
4750,4750999,21.34631868716928,39.00618226083285,0.0792778521298374,3157.383810520172,359.8041446208954,2474.1870546340942,20463,4849,15614,15614,0,31,4751000.0
4751,4751999,21.3448450441682,39.004263417329845,0.07928457228825025,3157.9592113494873,359.8715398311615,2474.9629106521606,20467,4851,15616,15616,0,31,4752000.0
4752,4752999,21.343142150906207,39.00137487768741,0.07929648716351989,3158.411106824875,359.9417510032654,2476.658268928528,20467,4851,15616,15616,0,31,4753000.0
4753,4753999,21.341591805529404,38.99895496630508,0.07930304182302694,3159.0835840702057,360.0104911327362,2477.0857515335083,20469,4852,15617,15617,0,31,4754000.0
4754,4754999,21.340290047490853,38.99670740574615,0.07930382858858365,3159.694889307022,360.0787901878357,2477.4390687942505,20480,4855,15625,15625,0,31,4755000.0
4755,4755999,21.338894501706513,38.994222055703155,0.07930648490313363,3160.197329044342,360.14636635780334,2478.577031135559,20482,4856,15626,15626,0,31,4756000.0
4756,4756999,21.338118944927064,38.99291330953406,0.07929710701578119,3160.7187733650208,360.21605229377747,2479.604893684387,20484,4857,15627,15627,0,31,4757000.0
4757,4757999,21.337498485771512,38.99173945261314,0.07928860649615277,3161.448841571808,360.2879147529602,2479.929295539856,20484,4857,15627,15627,0,31,4758000.0
4758,4758999,21.336762872915415,38.99009799715502,0.07928355117838759,3162.1687626838684,360.3590214252472,2479.791760444641,20494,4859,15635,15635,0,31,4759000.0
4759,4759999,21.337306153719837,38.99056328439987,0.07926393279033128,3162.898562192917,360.43294405937195,2479.8047456741333,20496,4860,15636,15636,0,31,4760000.0
4760,4760999,21.33801641873729,38.99252313350722,0.07924384347972024,3163.718794822693,360.5018630027771,2479.009419441223,20502,4863,15639,15639,0,31,4761000.0
4761,4761999,21.338695737627894,38.99279028258871,0.07923726517420504,3164.3285298347473,360.5714542865753,2479.4940462112427,20508,4866,15642,15642,0,31,4762000.0
4762,4762999,21.33975595910019,38.995691240465206,0.0792228075248188,3164.8394045829773,360.6429252624512,2480.5684785842896,20511,4867,15644,15644,0,31,4763000.0
4763,4763999,21.340485866165704,38.996154339051415,0.07922276291405617,3165.231910467148,360.712744474411,2482.213200569153,20511,4867,15644,15644,0,31,4764000.0
4764,4764999,21.340689731386814,38.99506379191234,0.07923020887264254,3166.068934202194,360.7829327583313,2481.346203804016,20515,4869,15646,15646,0,31,4765000.0
4765,4765999,21.34087966910573,38.99388268193772,0.07923228282041173,3166.4707894325256,360.8509027957916,2482.991597175598,20515,4869,15646,15646,0,31,4766000.0
4766,4766999,21.341137850829245,38.99685507071243,0.0792072789814896,3166.860246896744,360.92065715789795,2484.893002510071,20540,4869,15671,15671,0,31,4767000.0
4767,4767999,21.339662124002864,38.99460134264908,0.07920057573588224,3167.1476566791534,361.0000624656677,2487.3328676223755,20549,4869,15680,15680,0,31,4768000.0
4768,4768999,21.337969939075123,38.991959377154245,0.07921108525881349,3167.315092563629,361.06645607948303,2490.15017414093,20551,4869,15682,15682,0,31,4769000.0
4769,4769999,21.336415954288878,38.98947868510882,0.07921862156071224,3167.6784262657166,361.1337766647339,2492.0845766067505,20552,4869,15683,15683,0,31,4770000.0
4770,4770999,21.334921864268196,38.987252318151356,0.07922361585579107,3168.154819250107,361.2018187046051,2493.2082109451294,20560,4872,15688,15688,0,31,4771000.0
4771,4771999,21.333632704090938,38.98468107995635,0.07922978658158986,3168.835381746292,361.2686517238617,2493.3192110061646,20569,4876,15693,15693,0,31,4772000.0
4772,4772999,21.3322682652035,38.98245893289176,0.07923533640946401,3169.4296226501465,361.3360686302185,2493.863896369934,20577,4879,15698,15698,0,31,4773000.0
4773,4773999,21.33107916505659,38.980106302071015,0.07923730307089116,3170.2946491241455,361.4043519496918,2493.341763496399,20587,4883,15704,15704,0,31,4774000.0
4774,4774999,21.330302048970832,38.97856542623251,0.0792342675465525,3170.787613391876,361.4723038673401,2494.5237245559692,20595,4884,15711,15711,0,31,4775000.0
4775,4775999,21.32905217764226,38.9764433990966,0.0792360838245475,3171.457038640976,361.54162669181824,2495.0067415237427,20595,4884,15711,15711,0,31,4776000.0
4776,4776999,21.327833005540054,38.973902412486275,0.07923799662939934,3171.9718639850616,361.6102738380432,2496.1411714553833,20595,4884,15711,15711,0,31,4777000.0
4777,4777999,21.32690326520734,38.97200911117107,0.07924070177651332,3172.50261259079,361.67961740493774,2496.984112739563,20597,4885,15712,15712,0,31,4778000.0
4778,4778999,21.325745040644946,38.969490533709724,0.07924448034120224,3173.020733833313,361.74824929237366,2497.9944581985474,20599,4886,15713,15713,0,31,4779000.0
4779,4779999,21.325016139859407,38.96807891089883,0.07923933968831565,3173.762600183487,361.8196358680725,2497.7873582839966,20601,4887,15714,15714,0,31,4780000.0
4780,4780999,21.324459235347067,38.96649221300206,0.07923498409858509,3174.47993850708,361.8875102996826,2497.7650423049927,20610,4889,15721,15721,0,31,4781000.0
4781,4781999,21.32377507166822,38.96508498300189,0.07923308102485338,3175.3772299289703,361.95572423934937,2496.9018907546997,20614,4891,15723,15723,0,31,4782000.0
4782,4782999,21.323485024937625,38.963921371023666,0.07923312040093278,3175.9920122623444,362.02820229530334,2497.4877672195435,20642,4893,15749,15749,0,31,4783000.0
4783,4783999,21.323206349924824,38.96305683650352,0.07922804543896489,3176.9461345672607,362.0984652042389,2496.258008003235,20647,4895,15752,15752,0,31,4784000.0
4784,4784999,21.323301975670972,38.962673520042934,0.07922247433184226,3177.4329805374146,362.16723346710205,2497.67174243927,20649,4896,15753,15753,0,31,4785000.0
4785,4785999,21.322858688621743,38.96121265569637,0.07922764842456775,3178.0623779296875,362.23844623565674,2498.093518257141,20659,4898,15761,15761,0,31,4786000.0
4786,4786999,21.322377328874587,38.95942440601329,0.07923415263791866,3178.7930147647858,362.30709505081177,2498.1577348709106,20659,4898,15761,15761,0,31,4787000.0
4787,4787999,21.321564407677435,38.9610572272792,0.07921597335192154,3179.297874689102,362.375461101532,2499.2406816482544,20664,4899,15765,15765,0,31,4788000.0
4788,4788999,21.32009911946538,38.959912997473204,0.07921492034010413,3179.4478969573975,362.442893743515,2502.3171739578247,20687,4899,15788,15788,0,31,4789000.0
4789,4789999,21.318150278012503,38.95674736230394,0.0792321372125604,3179.7167468070984,362.5096068382263,2504.659825325012,20692,4899,15793,15793,0,31,4790000.0
4790,4790999,21.31659717221018,38.95496880270704,0.07923809280712701,3180.2018954753876,362.57762479782104,2505.8041429519653,20702,4901,15801,15801,0,31,4791000.0
4791,4791999,21.31491614768014,38.95206738063732,0.07925728106652208,3181.004026889801,362.6472797393799,2505.257046699524,20716,4904,15812,15812,0,31,4792000.0
4792,4792999,21.313229038440227,38.949649093563025,0.07926769723273841,3181.6955626010895,362.71800351142883,2505.5015687942505,20725,4908,15817,15817,0,31,4793000.0
4793,4793999,21.311645264352016,38.94725994479057,0.07928191691578379,3182.1895418167114,362.78656673431396,2506.6121797561646,20733,4911,15822,15822,0,31,4794000.0
4794,4794999,21.30987903594624,38.94443836521384,0.0792951728906428,3183.0945043563843,362.85458421707153,2505.6693925857544,20746,4915,15831,15831,0,31,4795000.0
4795,4795999,21.308068953820026,38.941475387556,0.0793107551845682,3183.488367319107,362.9220700263977,2507.319218635559,20749,4916,15833,15833,0,31,4796000.0
4796,4796999,21.306391959346545,38.93874342382448,0.07932186822265952,3184.1539976596832,362.9921827316284,2507.9233751296997,20759,4918,15841,15841,0,31,4797000.0
4797,4797999,21.304844670911123,38.9363883568062,0.07933056548663653,3184.673362493515,363.0637083053589,2508.8751497268677,20761,4919,15842,15842,0,31,4798000.0
4798,4798999,21.303422316279747,38.933808454586035,0.07933925589399182,3185.615972518921,363.1328682899475,2507.7016801834106,20794,4922,15872,15872,0,31,4799000.0
4799,4799999,21.302003574261082,38.93126936002496,0.07934640435083029,3186.4296221733093,363.20126605033875,2507.3204164505005,20794,4922,15872,15872,0,31,4800000.0
4800,4800999,21.300713106418705,38.929137038732044,0.07935159361139477,3187.168027639389,363.2739179134369,2507.3462648391724,20820,4924,15896,15896,0,31,4801000.0
4801,4801999,21.299505799846173,38.92720329014566,0.07935731896386733,3187.6771833896637,363.34754967689514,2508.754704475403,20820,4924,15896,15896,0,31,4802000.0
4802,4802999,21.298728164826162,38.925679329642165,0.07935296908547129,3188.5980014801025,363.41914463043213,2507.954258918762,20822,4925,15897,15897,0,31,4803000.0
4803,4803999,21.29790715349306,38.92368656704669,0.07935897963267546,3188.7990624904633,363.48658752441406,2510.5878496170044,20822,4925,15897,15897,0,31,4804000.0
4804,4804999,21.297055056021577,38.92168239705929,0.07936147370078372,3189.6347727775574,363.55558681488037,2510.1208391189575,20825,4926,15899,15899,0,31,4805000.0
4805,4805999,21.296650615950444,38.92160483247133,0.07935431963002282,3190.1623272895813,363.62611746788025,2511.2047243118286,20825,4926,15899,15899,0,31,4806000.0
4806,4806999,21.295708853333913,38.91927545612217,0.07935962219916359,3190.799339056015,363.69644045829773,2511.749608039856,20825,4926,15899,15899,0,31,4807000.0
4807,4807999,21.294622999260636,38.91685604752212,0.0793635290240684,3191.9629702568054,363.76899099349976,2509.323140144348,20833,4929,15904,15904,0,31,4808000.0
4808,4808999,21.293683107583686,38.91682364019048,0.07934656020520581,3192.361184358597,363.84053230285645,2511.2285203933716,20856,4929,15927,15927,0,31,4809000.0
4809,4809999,21.292083321611585,38.915392826651804,0.07931973743423493,3192.625509738922,363.9093236923218,2513.672459602356,20866,4929,15937,15937,0,31,4810000.0
4810,4810999,21.29031243725739,38.91280779172328,0.07931926529447442,3193.00670170784,363.97541642189026,2515.4007844924927,20876,4930,15946,15946,0,31,4811000.0
4811,4811999,21.288881560753076,38.912097396992074,0.0793160504617918,3193.5827708244324,364.0425877571106,2516.1491289138794,20886,4933,15953,15953,0,31,4812000.0
4812,4812999,21.287282438920204,38.9096595583544,0.0793200134341433,3194.092479467392,364.1121971607208,2517.284489631653,20892,4935,15957,15957,0,31,4813000.0
4813,4813999,21.285817368283546,38.907494450107016,0.07931948019279933,3194.6704790592194,364.1786632537842,2518.104916572571,20898,4938,15960,15960,0,31,4814000.0
4814,4814999,21.284274629116684,38.90552793119222,0.07932217200655589,3195.344663143158,364.24684405326843,2518.4820833206177,20900,4939,15961,15961,0,31,4815000.0
4815,4815999,21.28284519552562,38.903034715116284,0.07932716713938859,3196.029869556427,364.3158645629883,2518.736226081848,20904,4941,15963,15963,0,31,4816000.0
4816,4816999,21.281308093052164,38.9005160039931,0.07933128078277485,3196.3307831287384,364.3834116458893,2520.905941963196,20904,4941,15963,15963,0,31,4817000.0
4817,4817999,21.279889955068942,38.8983233681142,0.07933231244907624,3197.1351232528687,364.4515588283539,2520.4695405960083,20908,4943,15965,15965,0,31,4818000.0
4818,4818999,21.27886328536336,38.896617938923434,0.07932284739865969,3197.818687438965,364.5203948020935,2520.6913118362427,20912,4945,15967,15967,0,31,4819000.0
4819,4819999,21.278135899775474,38.89544443639648,0.07930852721096815,3198.4564003944397,364.58931255340576,2520.986973762512,20914,4946,15968,15968,0,31,4820000.0
4820,4820999,21.27918972475351,38.89764931106759,0.07927595051863878,3199.4160494804382,364.6601445674896,2519.667675971985,20931,4950,15981,15981,0,31,4821000.0
4821,4821999,21.28087945228741,38.90037843329469,0.07923838511195713,3200.044513940811,364.7280042171478,2520.052441596985,20941,4953,15988,15988,0,31,4822000.0
4822,4822999,21.283145624690594,38.904209140611066,0.07921319457959286,3200.746515750885,364.79800057411194,2520.333821296692,20945,4955,15990,15990,0,31,4823000.0
4823,4823999,21.284963237450636,38.90690467270967,0.07920889284614618,3201.365046977997,364.86961460113525,2520.9641618728638,20954,4957,15997,15997,0,31,4824000.0
4824,4824999,21.28705458295531,38.909773876474375,0.07921607094033667,3202.096909761429,364.9381091594696,2520.875241279602,20960,4960,16000,16000,0,31,4825000.0
4825,4825999,21.28881173217363,38.9114816360388,0.07922717780974708,3202.73197221756,365.0131871700287,2521.665349006653,20961,4960,16001,16001,0,31,4826000.0
4826,4826999,21.290776401677945,38.913637253860855,0.07924143065441702,3203.3407492637634,365.0824339389801,2522.265278816223,20961,4960,16001,16001,0,31,4827000.0
4827,4827999,21.29219962228788,38.916193150993045,0.07923950867906726,3204.400070667267,365.15409231185913,2520.4842958450317,20965,4962,16003,16003,0,31,4828000.0
4828,4828999,21.29319679408419,38.916396693871086,0.07925159179442676,3205.3075935840607,365.22502398490906,2519.8336305618286,20965,4962,16003,16003,0,31,4829000.0
4829,4829999,21.292360397378957,38.91480193218538,0.07926224917606661,3205.688750743866,365.29559326171875,2521.8142824172974,20991,4962,16029,16029,0,31,4830000.0
4830,4830999,21.290532403732815,38.911998210563375,0.079271718443917,3206.0661261081696,365.3647882938385,2523.677975654602,21003,4963,16040,16040,0,31,4831000.0
4831,4831999,21.288863253382623,38.909400256828675,0.07927837200510301,3206.3506875038147,365.4318141937256,2525.914860725403,21007,4964,16043,16043,0,31,4832000.0
4832,4832999,21.28743557216478,38.90708899742106,0.07928209425219157,3206.9458169937134,365.49900484085083,2526.5130281448364,21014,4967,16047,16047,0,31,4833000.0
4833,4833999,21.286258221508003,38.90571554218085,0.07927866276868833,3207.3475801944733,365.5656671524048,2528.243733406067,21018,4968,16050,16050,0,31,4834000.0
4834,4834999,21.28473880198,38.9033249550695,0.07928481080129113,3208.163813829422,365.63774132728577,2527.885266304016,21028,4973,16055,16055,0,31,4835000.0
4835,4835999,21.283356050609395,38.900895213340746,0.07928838494628498,3209.1568837165833,365.70864605903625,2526.665120124817,21034,4976,16058,16058,0,31,4836000.0
4836,4836999,21.281979622628697,38.898692343791055,0.07928959809247438,3209.65762090683,365.7799849510193,2527.788510322571,21048,4979,16069,16069,0,31,4837000.0
4837,4837999,21.280764655873902,38.896612448875594,0.07928963968480551,3210.3774404525757,365.84976625442505,2527.8702516555786,21059,4982,16077,16077,0,31,4838000.0
4838,4838999,21.279376920171277,38.89390474548486,0.0792940728771,3211.000120162964,365.9237985610962,2528.566960334778,21059,4982,16077,16077,0,31,4839000.0
4839,4839999,21.27834057401097,38.89254555820735,0.07928917662027846,3211.948033809662,365.9935710430145,2527.544369697571,21116,4985,16131,16131,0,31,4840000.0
4840,4840999,21.27732408261079,38.890519594792536,0.07928966010743765,3212.577138185501,366.0623140335083,2528.172032356262,21116,4985,16131,16131,0,31,4841000.0
4841,4841999,21.27740579154109,38.89219656060501,0.07926954091529481,3213.127871274948,366.13309502601624,2528.946301460266,21118,4986,16132,16132,0,31,4842000.0
4842,4842999,21.278398558255226,38.894667275373656,0.07925344364440101,3213.733612537384,366.20250940322876,2529.6037950515747,21121,4987,16134,16134,0,31,4843000.0
4843,4843999,21.280075070469625,38.89737599263489,0.07923311136757949,3214.246506690979,366.2722852230072,2530.6819581985474,21123,4988,16135,16135,0,31,4844000.0
4844,4844999,21.282015836848846,38.90063676271923,0.07922667797546867,3214.5460817813873,366.3396005630493,2532.8201875686646,21123,4988,16135,16135,0,31,4845000.0
4845,4845999,21.285263853117215,38.910579896582405,0.07920934624585507,3215.6574907302856,366.40857672691345,2531.013669013977,21140,4992,16148,16148,0,31,4846000.0
4846,4846999,21.287594121677987,38.91393170591194,0.07922207744427723,3216.5713074207306,366.481041431427,2530.2762575149536,21141,4992,16149,16149,0,31,4847000.0
4847,4847999,21.28945864926521,38.916274301290024,0.0792390770928817,3217.252665281296,366.54937863349915,2530.620457649231,21141,4992,16149,16149,0,31,4848000.0
4848,4848999,21.29182960733523,38.91879461234406,0.07926999944426993,3217.996776342392,366.620108127594,2530.7076234817505,21155,4995,16160,16160,0,31,4849000.0
4849,4849999,21.293178091578113,38.92080346421948,0.07929153478267637,3218.50825548172,366.69186449050903,2531.9227113723755,21157,4996,16161,16161,0,31,4850000.0
4850,4850999,21.29320958621344,38.92061095678427,0.07929598621817568,3218.8906428813934,366.7624056339264,2533.87934589386,21183,4996,16187,16187,0,31,4851000.0
4851,4851999,21.291552659196455,38.91829145880786,0.0793050429543557,3219.235988855362,366.82875895500183,2535.999852180481,21191,4996,16195,16195,0,31,4852000.0
4852,4852999,21.28987460886946,38.91611116476838,0.07931572736800074,3219.5155782699585,366.9059798717499,2538.510235786438,21192,4996,16196,16196,0,31,4853000.0
4853,4853999,21.28852375831027,38.91496308754882,0.07931530844389656,3220.08252286911,366.97379994392395,2539.3710374832153,21194,4997,16197,16197,0,31,4854000.0
4854,4854999,21.28694995777497,38.91284389920941,0.07932497559225171,3220.587084531784,367.0451362133026,2540.6295824050903,21197,4998,16199,16199,0,31,4855000.0
4855,4855999,21.28548257272577,38.910780195072284,0.07932845426801893,3221.2199869155884,367.1162700653076,2540.9298524856567,21203,5001,16202,16202,0,31,4856000.0
4856,4856999,21.283961024023053,38.90833491818849,0.07933450206276138,3222.082031726837,367.1837158203125,2540.354878425598,21211,5005,16206,16206,0,31,4857000.0
4857,4857999,21.28267958498406,38.90691167174182,0.07933348205048729,3222.4767351150513,367.25028586387634,2541.8307847976685,21216,5007,16209,16209,0,31,4858000.0
4858,4858999,21.281387229406633,38.9051807546229,0.07933080302070494,3222.855231285095,367.31864190101624,2543.6666917800903,21216,5007,16209,16209,0,31,4859000.0
4859,4859999,21.280047854275537,38.90272013293553,0.0793312237907835,3223.569583415985,367.3879804611206,2543.730206489563,21218,5008,16210,16210,0,31,4860000.0
4860,4860999,21.279366438105217,38.901742614446746,0.07932188728800948,3224.060112476349,367.45678639411926,2544.8937196731567,21218,5008,16210,16210,0,31,4861000.0
4861,4861999,21.278536838895302,38.9004645162613,0.0793130283233533,3224.3618128299713,367.526486158371,2547.0467500686646,21218,5008,16210,16210,0,31,4862000.0
4862,4862999,21.278450957848687,38.90038295568828,0.07930030069526095,3224.990455389023,367.59699964523315,2547.876561164856,21218,5008,16210,16210,0,31,4863000.0
4863,4863999,21.278232247758613,38.899823215419985,0.07929389031252876,3225.741266489029,367.6656906604767,2547.670834541321,21220,5009,16211,16211,0,31,4864000.0
4864,4864999,21.278461188174553,38.899556395576724,0.07928814780396953,3226.853251218796,367.73617458343506,2545.735508918762,21226,5012,16214,16214,0,31,4865000.0
4865,4865999,21.279420083180163,38.900802281790014,0.07928631668194475,3227.341046333313,367.8045799732208,2546.9519395828247,21226,5012,16214,16214,0,31,4866000.0
4866,4866999,21.280691297169508,38.90200600376123,0.07927383271406985,3227.9533910751343,367.8741319179535,2547.530453681946,21228,5013,16215,16215,0,31,4867000.0
4867,4867999,21.282139638162302,38.903576280834066,0.07926740878967864,3228.777209043503,367.94120740890503,2546.9249773025513,21231,5014,16217,16217,0,31,4868000.0
4868,4868999,21.28349574528162,38.90484079382908,0.07926665139682842,3229.0891954898834,368.01066064834595,2549.0979433059692,21231,5014,16217,16217,0,31,4869000.0
4869,4869999,21.284725748716536,38.905735616029865,0.07926496335703448,3229.8150482177734,368.07849979400635,2548.907307624817,21233,5015,16218,16218,0,31,4870000.0
4870,4870999,21.28568702146448,38.905937389336714,0.0792701453160578,3230.3060479164124,368.14645886421204,2550.0634355545044,21233,5015,16218,16218,0,31,4871000.0
4871,4871999,21.285631062574428,38.90488394392893,0.0792810803823909,3230.7982997894287,368.22776675224304,2551.3210802078247,21245,5015,16230,16230,0,31,4872000.0
4872,4872999,21.28414361740219,38.90294573125905,0.07928862039622664,3231.25315618515,368.29001116752625,2552.670392036438,21262,5016,16246,16246,0,31,4873000.0
4873,4873999,21.28279653312509,38.90374533661099,0.07928984286631391,3231.6153087615967,368.35026121139526,2554.4246492385864,21267,5016,16251,16251,0,31,4874000.0
4874,4874999,21.28181927382311,38.90439935415073,0.0792846436571979,3232.181483268738,368.411660194397,2555.263928413391,21273,5016,16257,16257,0,31,4875000.0
4875,4875999,21.280582226088658,38.90928949037506,0.07926690780471801,3232.5347719192505,368.4750418663025,2557.1652421951294,21289,5017,16272,16272,0,31,4876000.0
4876,4876999,21.27963307530622,38.9091520538842,0.07926388266598594,3232.7230920791626,368.54210782051086,2559.983769416809,21291,5017,16274,16274,0,31,4877000.0
4877,4877999,21.27801104280243,38.90610606413704,0.07927302908713585,3233.3057878017426,368.60457134246826,2560.833706855774,21295,5017,16278,16278,0,31,4878000.0
4878,4878999,21.276455432236467,38.90333781675128,0.07928686112004935,3233.691708803177,368.6663842201233,2562.71430683136,21296,5017,16279,16279,0,31,4879000.0
4879,4879999,21.274900795032725,38.90054392138934,0.07929627985021237,3234.397988319397,368.7297887802124,2562.751378059387,21300,5019,16281,16281,0,31,4880000.0
4880,4880999,21.273389550908337,38.897898978935686,0.07930748526315845,3235.2729341983795,368.79251313209534,2562.1771211624146,21302,5019,16283,16283,0,31,4881000.0
4881,4881999,21.272226597604895,38.89794334556623,0.07930331368432897,3235.8894588947296,368.85504245758057,2562.454167366028,21304,5020,16284,16284,0,31,4882000.0
4882,4882999,21.2711027349581,38.89548901617807,0.07931504618654706,3236.2892751693726,368.9186089038849,2564.07839679718,21304,5020,16284,16284,0,31,4883000.0
4883,4883999,21.270100888307837,38.8939007377855,0.07931959294703272,3236.8686532974243,368.981778383255,2564.8442811965942,21305,5020,16285,16285,0,31,4884000.0
4884,4884999,21.269105755003295,38.892026296993585,0.0793284861984157,3237.697765111923,369.0457217693329,2563.9807710647583,21307,5021,16286,16286,0,31,4885000.0
4885,4885999,21.268200899280895,38.88978481992301,0.07934352048315041,3238.4007439613342,369.107786655426,2563.892544746399,21309,5022,16287,16287,0,31,4886000.0
4886,4886999,21.267326360303873,38.88759800033408,0.07935806530501965,3238.988152742386,369.1713469028473,2564.5510759353638,21310,5022,16288,16288,0,31,4887000.0
4887,4887999,21.266230559084793,38.88498280825874,0.079380387687506,3239.481549024582,369.234623670578,2565.637692451477,21311,5022,16289,16289,0,31,4888000.0
4888,4888999,21.26527037728113,38.88354709878512,0.07939213467878126,3240.286451816559,369.3007411956787,2565.3198976516724,21323,5022,16301,16301,0,31,4889000.0
4889,4889999,21.264122202250668,38.88386492870206,0.07940775904734132,3240.6490807533264,369.3642613887787,2567.0288133621216,21327,5022,16305,16305,0,31,4890000.0
4890,4890999,21.26267334646754,38.88204293106509,0.0794387219999908,3241.1290695667267,369.42669439315796,2568.2103548049927,21329,5022,16307,16307,0,31,4891000.0
4891,4891999,21.26110981406281,38.880381049644555,0.07946422093239103,3241.624710559845,369.4894723892212,2569.3412675857544,21330,5022,16308,16308,0,31,4892000.0
4892,4892999,21.25927873879674,38.87735007303014,0.07949905448444283,3242.023011445999,369.552663564682,2570.941472053528,21335,5023,16312,16312,0,31,4893000.0
4893,4893999,21.257293788615506,38.8740700152369,0.079532289808119,3242.7256729602814,369.6150918006897,2570.9885835647583,21340,5025,16315,16315,0,31,4894000.0
4894,4894999,21.25562883881892,38.87146464888443,0.07955661510222678,3243.212020635605,369.6763029098511,2572.042592048645,21342,5026,16316,16316,0,31,4895000.0
4895,4895999,21.25379958573809,38.86891557472877,0.07958404429344645,3243.903379678726,369.74042439460754,2572.13210773468,21346,5028,16318,16318,0,31,4896000.0
4896,4896999,21.252100467652014,38.86639302052019,0.07960809488052056,3244.7310152053833,369.80575013160706,2571.7862977981567,21346,5028,16318,16318,0,31,4897000.0
4897,4897999,21.25052478183667,38.86418681051295,0.07962964544183271,3245.430207014084,369.8680737018585,2571.8487062454224,21346,5028,16318,16318,0,31,4898000.0
4898,4898999,21.24892679822792,38.86163842534318,0.07965139793511866,3246.026063680649,369.92962288856506,2572.389256477356,21348,5029,16319,16319,0,31,4899000.0
4899,4899999,21.24744491310381,38.85889586774243,0.07967669079853823,3246.701130628586,369.99199390411377,2572.6820573806763,21348,5029,16319,16319,0,31,4900000.0
4900,4900999,21.24609177673986,38.85642300914043,0.07969902587235456,3247.090380191803,370.0555348396301,2574.2523317337036,21348,5029,16319,16319,0,31,4901000.0
4901,4901999,21.24494380189427,38.85413555164115,0.07973156482389954,3247.993822336197,370.11782908439636,2573.4234895706177,21348,5029,16319,16319,0,31,4902000.0
4902,4902999,21.243646654706982,38.85152972250764,0.0797592931202804,3248.4834253787994,370.18094873428345,2574.4867601394653,21348,5029,16319,16319,0,31,4903000.0
4903,4903999,21.242113175844896,38.84867708052584,0.07978811354581061,3249.259021759033,370.2437393665314,2574.27778339386,21348,5029,16319,16319,0,31,4904000.0
4904,4904999,21.240976523194043,38.846532216799815,0.07981688624970029,3249.775257587433,370.30867886543274,2575.0983629226685,21350,5030,16320,16320,0,31,4905000.0
4905,4905999,21.239415953047295,38.844461736076404,0.07983892983054885,3250.678490638733,370.37462639808655,2574.3143587112427,21361,5030,16331,16331,0,31,4906000.0
4906,4906999,21.23748084557287,38.84186565870932,0.07986280216298725,3251.1709504127502,370.44056725502014,2575.477131843567,21364,5030,16334,16334,0,31,4907000.0
4907,4907999,21.23600648242229,38.842269082802396,0.0798751033733518,3251.6610605716705,370.50272035598755,2576.615231513977,21365,5030,16335,16335,0,31,4908000.0
4908,4908999,21.234434770812776,38.84028707116858,0.07990061417194116,3252.143859386444,370.564040184021,2577.803608894348,21370,5031,16339,16339,0,31,4909000.0
4909,4909999,21.232521485703256,38.83735084596417,0.07993214352858724,3252.611841917038,370.6262047290802,2579.1353578567505,21374,5032,16342,16342,0,31,4910000.0
4910,4910999,21.230624552807473,38.834648951816646,0.07995992068939539,3253.3206615448,370.68796396255493,2579.1567125320435,21376,5033,16343,16343,0,31,4911000.0
4911,4911999,21.228794171452854,38.83224650407545,0.07998130018251282,3253.9334065914154,370.74984073638916,2579.6325426101685,21378,5034,16344,16344,0,31,4912000.0
4912,4912999,21.227143757167394,38.83043640408614,0.07999080885650045,3254.5344667434692,370.813227891922,2580.1910219192505,21378,5034,16344,16344,0,31,4913000.0
4913,4913999,21.22559450437226,38.82905660724453,0.0799998023573728,3255.43434381485,370.8761193752289,2579.1026277542114,21393,5038,16355,16355,0,31,4914000.0
4914,4914999,21.224681965878386,38.828311820845514,0.07998931352093452,3255.962726831436,370.93922662734985,2579.812008857727,21398,5040,16358,16358,0,31,4915000.0
4915,4915999,21.223688483997027,38.827028091454366,0.0799829522174128,3256.689164876938,371.00175189971924,2579.8495531082153,21398,5040,16358,16358,0,31,4916000.0
4916,4916999,21.2231709435045,38.82646565966174,0.07996500091679692,3257.4901053905487,371.0642113685608,2579.514805793762,21398,5040,16358,16358,0,31,4917000.0
4917,4917999,21.22257279910625,38.8257172842531,0.07994719381170912,3258.0666658878326,371.1273138523102,2580.4197359085083,21398,5040,16358,16358,0,31,4918000.0
4918,4918999,21.222446960809155,38.8258375165489,0.07992561061417769,3258.6473565101624,371.1903667449951,2581.2253160476685,21398,5040,16358,16358,0,31,4919000.0
4919,4919999,21.222026589008642,38.82468363346483,0.07991123485840346,3259.4479150772095,371.254519701004,2580.903416633606,21401,5041,16360,16360,0,31,4920000.0
4920,4920999,21.22206518185378,38.82597885487584,0.0798881480132172,3259.9572043418884,371.3165338039398,2581.8389177322388,21403,5042,16361,16361,0,31,4921000.0
4921,4921999,21.221924912243562,38.82547201447154,0.07986880860946777,3260.7787914276123,371.3854215145111,2581.602307319641,21403,5042,16361,16361,0,31,4922000.0
4922,4922999,21.221571429688584,38.8246416996028,0.07985255324112184,3261.477014064789,371.4487500190735,2581.6957216262817,21403,5042,16361,16361,0,31,4923000.0
4923,4923999,21.22089078385675,38.82307304917736,0.07984698252264011,3262.081072807312,371.5135772228241,2582.4787645339966,21403,5042,16361,16361,0,31,4924000.0
4924,4924999,21.22053754730232,38.822188407967616,0.0798374626512871,3263.1941418647766,371.57653737068176,2580.540036201477,21403,5042,16361,16361,0,31,4925000.0
4925,4925999,21.219083035679507,38.81964228772037,0.07984508276527136,3263.682788848877,371.6397259235382,2581.807499885559,21419,5042,16377,16377,0,31,4926000.0
4926,4926999,21.217563344833398,38.81792726412918,0.07984801034526734,3264.0474298000336,371.70410418510437,2583.6391191482544,21427,5042,16385,16385,0,31,4927000.0
4927,4927999,21.215470316462014,38.814787587462185,0.07986443020783951,3264.446890115738,371.76922273635864,2585.362690925598,21429,5042,16387,16387,0,31,4928000.0
4928,4928999,21.213621965557124,38.81234875585291,0.07987516285149676,3265.1107738018036,371.83221530914307,2585.7238512039185,21437,5045,16392,16392,0,31,4929000.0
4929,4929999,21.211964203782912,38.809595112151236,0.07988792221155772,3265.609908103943,371.89878153800964,2586.8850526809692,21440,5046,16394,16394,0,31,4930000.0
4930,4930999,21.21016084701746,38.80664464527006,0.07989972115007704,3266.5111739635468,371.9602470397949,2585.6094636917114,21447,5049,16398,16398,0,31,4931000.0
4931,4931999,21.20869044584514,38.80433440601485,0.07991068713905458,3266.794486761093,372.0205888748169,2587.7963609695435,21447,5049,16398,16398,0,31,4932000.0
4932,4932999,21.20721813964425,38.801726262632705,0.07992137705799263,3267.4051508903503,372.0833914279938,2588.381962776184,21447,5049,16398,16398,0,31,4933000.0
4933,4933999,21.20564964251782,38.79936443376756,0.07992989745298562,3268.109076023102,372.14788937568665,2588.4586610794067,21447,5049,16398,16398,0,31,4934000.0
4934,4934999,21.204263898550344,38.797169000431516,0.07993681021906907,3268.608779668808,372.2127408981323,2589.6272478103638,21447,5049,16398,16398,0,31,4935000.0
4935,4935999,21.203002415321443,38.79493199781118,0.07994303891110455,3269.635608434677,372.2770445346832,2587.921772956848,21461,5053,16408,16408,0,31,4936000.0
4936,4936999,21.201725092785225,38.79273625456805,0.07994783677460804,3270.252058982849,372.33976221084595,2588.416096687317,21463,5054,16409,16409,0,31,4937000.0
4937,4937999,21.20058029224273,38.79039081663434,0.0799590498387246,3270.7520372867584,372.4032082557678,2589.51052570343,21463,5054,16409,16409,0,31,4938000.0
4938,4938999,21.19947091054644,38.78864144866838,0.0799596128680009,3271.4339339733124,372.46760272979736,2589.809239387512,21463,5054,16409,16409,0,31,4939000.0
4939,4939999,21.198608646317588,38.78669258768765,0.07996702358392482,3272.0274431705475,372.53130984306335,2590.2657289505005,21467,5056,16411,16411,0,31,4940000.0
4940,4940999,21.19773343421977,38.78490934004656,0.07996513501163371,3272.6297647953033,372.5943343639374,2590.832112312317,21467,5056,16411,16411,0,31,4941000.0
4941,4941999,21.1968904815725,38.78305809153374,0.07996936458443638,3273.4383845329285,372.6587402820587,2590.3640031814575,21469,5057,16412,16412,0,31,4942000.0
4942,4942999,21.19614458700778,38.78103415309612,0.07997076152158045,3274.029946565628,372.7220597267151,2591.1236085891724,21469,5057,16412,16412,0,31,4943000.0
4943,4943999,21.1957484932188,38.77979089400994,0.07996817482672391,3274.6257996559143,372.7863676548004,2591.6803941726685,21469,5057,16412,16412,0,31,4944000.0
4944,4944999,21.195134266901277,38.77865103129371,0.07996285188717189,3275.3329343795776,372.8526887893677,2591.727520942688,21469,5057,16412,16412,0,31,4945000.0
4945,4945999,21.194436162297393,38.77678484410429,0.07995966640934427,3276.234375,372.9175169467926,2590.728840827942,21492,5058,16434,16434,0,31,4946000.0
4946,4946999,21.193229133096676,38.775289360404315,0.0799609896355501,3276.722278356552,372.9810552597046,2591.97789478302,21511,5059,16452,16452,0,31,4947000.0
4947,4947999,21.192285457340574,38.77396763254019,0.07995525216661192,3291.267724275589,373.04388642311096,2593.2075624465942,21515,5059,16456,16456,0,31,4948000.0
4948,4948999,21.190821754573648,38.77155049769771,0.0799622713570668,3291.4502124786377,373.10516357421875,2595.9004335403442,21515,5059,16456,16456,0,31,4949000.0
4949,4949999,21.18956160276705,38.769180270139636,0.07997266518593837,3292.2404088974,373.1677174568176,2595.5053148269653,21522,5062,16460,16460,0,31,4950000.0
4950,4950999,21.18845324373703,38.76719579481263,0.07997602898213652,3292.7172162532806,373.22940254211426,2596.770833015442,21524,5062,16462,16462,0,31,4951000.0
4951,4951999,21.18716206045416,38.76463005094141,0.07997927535634186,3293.4870495796204,373.29414463043213,2596.7071657180786,21528,5064,16464,16464,0,31,4952000.0
4952,4952999,21.186080892611834,38.76257796147531,0.07998381747435968,3294.081123113632,373.35717725753784,2597.118962287903,21535,5066,16469,16469,0,31,4953000.0
4953,4953999,21.185011967550025,38.760338373340545,0.079983592118262,3294.913868665695,373.4217047691345,2596.5248308181763,21537,5067,16470,16470,0,31,4954000.0
4954,4954999,21.18431173910231,38.76478901748875,0.07995438283130563,3295.321802377701,373.4844055175781,2598.118718147278,21537,5067,16470,16470,0,31,4955000.0
4955,4955999,21.182995638676168,38.762390279692596,0.07996093836282214,3296.319253921509,373.54771518707275,2596.909420967102,21544,5068,16476,16476,0,31,4956000.0
4956,4956999,21.18194214108335,38.76059089958896,0.07996348848136081,3297.1770312786102,373.6120367050171,2596.3135499954224,21554,5070,16484,16484,0,31,4957000.0
4957,4957999,21.180853193160928,38.758395187861474,0.07996257486249725,3297.990651369095,373.67498254776,2596.0303316116333,21554,5070,16484,16484,0,31,4958000.0
4958,4958999,21.17974708150286,38.75607928363885,0.07996268282428898,3298.599152326584,373.73908591270447,2596.583020210266,21554,5070,16484,16484,0,31,4959000.0
4959,4959999,21.17864540178596,38.7540658876399,0.07996048189807425,3298.8968381881714,373.80580472946167,2598.67507648468,21554,5070,16484,16484,0,31,4960000.0
4960,4960999,21.177686714436213,38.75173696659278,0.07996056059178325,3299.703003168106,373.8702893257141,2598.3930101394653,21554,5070,16484,16484,0,31,4961000.0
4961,4961999,21.17700636354644,38.74968793706359,0.07995509544713308,3300.562631368637,373.93675899505615,2597.6029863357544,21561,5072,16489,16489,0,31,4962000.0
4962,4962999,21.17645681306984,38.74780662519336,0.07994994407076106,3301.4776406288147,374.00001525878906,2596.617154121399,21561,5072,16489,16489,0,31,4963000.0
4963,4963999,21.17625441780955,38.74654795737541,0.07994180916200944,3301.869529247284,374.0674526691437,2598.20242023468,21561,5072,16489,16489,0,31,4964000.0
4964,4964999,21.175625336290594,38.74472310700096,0.07993638221310906,3302.5455482006073,374.1341094970703,2598.4973039627075,21563,5073,16490,16490,0,31,4965000.0
4965,4965999,21.174727411225476,38.74230764758357,0.07993849701313793,3303.0479300022125,374.20175194740295,2599.5485887527466,21563,5073,16490,16490,0,31,4966000.0
4966,4966999,21.173519502945627,38.73983150743421,0.07994153845386276,3303.772856235504,374.2668950557709,2599.5200624465942,21563,5073,16490,16490,0,31,4967000.0
4967,4967999,21.171938047374955,38.73868188684473,0.07995570327092671,3304.360000371933,374.3336684703827,2600.2763566970825,21589,5074,16515,16515,0,31,4968000.0
4968,4968999,21.17009932114792,38.73693330913619,0.0799678823757719,3304.632848739624,374.3969931602478,2602.5662355422974,21594,5074,16520,16520,0,31,4969000.0
4969,4969999,21.16803384032448,38.73392336337252,0.07998690180073376,3305.4336433410645,374.460298538208,2602.3804445266724,21597,5075,16522,16522,0,31,4970000.0
4970,4970999,21.165910741563657,38.73061893548285,0.08001544655299253,3305.718115091324,374.5223579406738,2604.5762300491333,21601,5076,16525,16525,0,31,4971000.0
4971,4971999,21.164009103672257,38.72782118460137,0.08003379448980152,3306.2231364250183,374.5861532688141,2605.7127656936646,21606,5078,16528,16528,0,31,4972000.0
4972,4972999,21.162355355787106,38.725072548502986,0.08004973959197548,3307.1180136203766,374.6513030529022,2604.862889289856,21612,5081,16531,16531,0,31,4973000.0
4973,4973999,21.160623966308393,38.72243276878996,0.08006388254318841,3307.582428455353,374.7147762775421,2606.2953996658325,21612,5081,16531,16531,0,31,4974000.0
4974,4974999,21.15884423409073,38.71939104381922,0.08007720958604048,3308.167563676834,374.7767107486725,2606.93110370636,21612,5081,16531,16531,0,31,4975000.0
4975,4975999,21.157039116573237,38.716585640005405,0.08009262669312267,3308.871666431427,374.8416042327881,2606.999218940735,21612,5081,16531,16531,0,31,4976000.0
4976,4976999,21.155262212854645,38.714235798039724,0.08010458870102644,3309.2861285209656,374.9047348499298,2608.5726442337036,21614,5082,16532,16532,0,31,4977000.0
4977,4977999,21.153794978500542,38.711875199923526,0.08010999121252016,3310.233758687973,374.9687786102295,2607.5466203689575,21626,5085,16541,16541,0,31,4978000.0
4978,4978999,21.152186819005713,38.70908841467939,0.08011845847131338,3310.8696999549866,375.0332896709442,2607.7935762405396,21628,5086,16542,16542,0,31,4979000.0
4979,4979999,21.15086392183565,38.70687119429342,0.08011839420351485,3311.674442768097,375.0984716415405,2607.311779975891,21639,5089,16550,16550,0,31,4980000.0
4980,4980999,21.149777810848,38.70527470414371,0.08011385846898622,3312.577566385269,375.1626970767975,2606.4993028640747,21641,5090,16551,16551,0,31,4981000.0
4981,4981999,21.14932210814159,38.705097561345255,0.08009843768047786,3312.879369020462,375.2288656234741,2608.5748796463013,21643,5091,16552,16552,0,31,4982000.0
4982,4982999,21.148905344778495,38.70428131144039,0.0800913066341622,3313.5736553668976,375.29317021369934,2608.7503023147583,21643,5091,16552,16552,0,31,4983000.0
4983,4983999,21.149246460775,38.704775807471066,0.08007182003138424,3314.6271393299103,375.35836458206177,2607.2987489700317,21645,5092,16553,16553,0,31,4984000.0
4984,4984999,21.14967559220474,38.70515943409427,0.08005375802385395,3315.0265715122223,375.4239857196808,2608.880482673645,21647,5093,16554,16554,0,31,4985000.0
4985,4985999,21.149757608037213,38.704687059888414,0.0800446417927072,3315.6211500167847,375.4897618293762,2609.4923601150513,21647,5093,16554,16554,0,31,4986000.0
4986,4986999,21.149947964524806,38.704215562895904,0.08003749393367598,3316.327754020691,375.5553414821625,2609.706151008606,21647,5093,16554,16554,0,31,4987000.0
4987,4987999,21.14954267228179,38.70388741538677,0.08002770765014955,3316.779090642929,375.61993050575256,2610.606541633606,21651,5095,16556,16556,0,31,4988000.0
4988,4988999,21.14815949898156,38.70200540759284,0.0800291062263091,3317.1300089359283,375.6858320236206,2612.6292085647583,21674,5095,16579,16579,0,31,4989000.0
4989,4989999,21.14618691167038,38.698820773804634,0.08004620722900613,3317.402002811432,375.748473405838,2614.932499885559,21680,5095,16585,16585,0,31,4990000.0
4990,4990999,21.14452185365823,38.697064041719536,0.08005590562890819,3318.089872121811,375.810996055603,2614.9763078689575,21689,5099,16590,16590,0,31,4991000.0
4991,4991999,21.14306441805073,38.69441016786639,0.08006728369480531,3318.282716035843,375.8759264945984,2617.748875617981,21690,5099,16591,16591,0,31,4992000.0
4992,4992999,21.141737930948043,38.692337328842584,0.08006905799515585,3318.6439731121063,375.9383430480957,2619.775113105774,21690,5099,16591,16591,0,31,4993000.0
4993,4993999,21.14092081643932,38.69069943384155,0.08006952990491423,3319.795737028122,376.0060679912567,2617.9228410720825,21696,5102,16594,16594,0,31,4994000.0
4994,4994999,21.140101895689966,38.68899227602723,0.08007087832957693,3320.3905868530273,376.07002449035645,2618.438977241516,21702,5105,16597,16597,0,31,4995000.0
4995,4995999,21.139277626792794,38.68750722724937,0.08007142827129221,3321.0970141887665,376.1347670555115,2618.490071296692,21704,5106,16598,16598,0,31,4996000.0
4996,4996999,21.138728800124042,38.68614703581085,0.08007434123714874,3321.8238887786865,376.20193243026733,2618.5960969924927,21704,5106,16598,16598,0,31,4997000.0
4997,4997999,21.138380279676422,38.68521106183637,0.0800717539579675,3322.615784883499,376.26497316360474,2618.6854066848755,21704,5106,16598,16598,0,31,4998000.0
4998,4998999,21.13814938203745,38.68446518242878,0.08008781685481559,3323.25923871994,376.3289749622345,2618.970440864563,21706,5107,16599,16599,0,31,4999000.0
4999,4999999,21.137909357328226,38.68363504303294,0.08011306963955211,3323.75323843956,376.3922429084778,2620.0143327713013,21708,5108,16600,16600,0,31,5000000.0
5000,5000999,21.137702980659647,38.682761343446224,0.08013238603257189,3324.23978471756,376.45558404922485,2621.2303133010864,21708,5108,16600,16600,0,31,5001000.0
5001,5001999,21.137606919481577,38.68210909752292,0.08016689364203056,3324.965524673462,376.52118825912476,2621.2130098342896,21708,5108,16600,16600,0,31,5002000.0
5002,5002999,21.137822595130775,38.68213888576043,0.08018694396861192,3325.715140104294,376.58634853363037,2620.8958024978638,21710,5109,16601,16601,0,31,5003000.0
5003,5003999,21.138108006667053,38.68337517959628,0.08019200016200034,3326.4373564720154,376.650288105011,2620.7068452835083,21714,5111,16603,16603,0,31,5004000.0
5004,5004999,21.138251626441985,38.68309689098618,0.08021822386339883,3327.2396111488342,376.71522283554077,2620.2734727859497,21718,5113,16605,16605,0,31,5005000.0
5005,5005999,21.138354087834553,38.68213317610496,0.0802407987253484,3327.739048719406,376.7804045677185,2621.3849687576294,21718,5113,16605,16605,0,31,5006000.0
5006,5006999,21.138375921895502,38.68122136220519,0.08024930135575159,3328.281583547592,376.84551525115967,2622.168698310852,21720,5114,16606,16606,0,31,5007000.0
5007,5007999,21.138304513346053,38.67997880823757,0.0802535674897854,3328.883656024933,376.909560918808,2622.737614631653,21722,5115,16607,16607,0,31,5008000.0
5008,5008999,21.13773663304763,38.678323851991735,0.08025878729648062,3329.3789541721344,376.97363448143005,2623.878087043762,21739,5116,16623,16623,0,31,5009000.0
5009,5009999,21.136285473562083,38.675757526316566,0.08027372868643634,3329.5275297164917,377.0376286506653,2626.8524446487427,21753,5116,16637,16637,0,31,5010000.0
5010,5010999,21.134928160222962,38.67406265510844,0.08028823840650345,3329.920134305954,377.10293793678284,2628.580891609192,21758,5117,16641,16641,0,31,5011000.0
5011,5011999,21.133254459564505,38.671132280256415,0.08031021155470885,3330.406176328659,377.1654043197632,2629.7301530838013,21770,5119,16651,16651,0,31,5012000.0
5012,5012999,21.13208584731048,38.67003213992681,0.0803142926143785,3331.0030467510223,377.2284803390503,2630.2930116653442,21782,5122,16660,16660,0,31,5013000.0
5013,5013999,21.130674072977406,38.66785999847111,0.08032973895339401,3331.4789838790894,377.2923994064331,2631.8458223342896,21782,5122,16660,16660,0,31,5014000.0
5014,5014999,21.129382397005557,38.66574739382553,0.08033996881110161,3332.0560235977173,377.35512471199036,2632.6473207473755,21785,5123,16662,16662,0,31,5015000.0
5015,5015999,21.128180106342604,38.66349595424284,0.08035018296243346,3333.1614089012146,377.42088317871094,2630.6594743728638,21792,5127,16665,16665,0,31,5016000.0
5016,5016999,21.126840362037687,38.66096093318255,0.08036063123300563,3333.846598148346,377.48490810394287,2630.861813545227,21794,5128,16666,16666,0,31,5017000.0
5017,5017999,21.12594751377608,38.6665525962052,0.08033522413026406,3334.2382576465607,377.5492618083954,2632.533085823059,21794,5128,16666,16666,0,31,5018000.0
5018,5018999,21.124746993161185,38.664264495136514,0.0803414234799158,3334.6728899478912,377.6131765842438,2633.8227128982544,21798,5130,16668,16668,0,31,5019000.0
5019,5019999,21.12352245273151,38.661668873294424,0.08035151307097443,3335.4925661087036,377.6802055835724,2633.2379121780396,21800,5131,16669,16669,0,31,5020000.0
5020,5020999,21.12251481946808,38.66217129643578,0.08035011178578866,3336.296083688736,377.7436308860779,2632.839253425598,21800,5131,16669,16669,0,31,5021000.0
5021,5021999,21.12161455845611,38.66024010931038,0.08035268457540312,3336.910313606262,377.80666065216064,2633.427403450012,21800,5131,16669,16669,0,31,5022000.0
5022,5022999,21.12076676164759,38.65826321888526,0.08035845697048005,3337.5116214752197,377.8698170185089,2634.207226753235,21800,5131,16669,16669,0,31,5023000.0
5023,5023999,21.1198243533971,38.65614462911852,0.08036830537699746,3338.311458349228,377.9349362850189,2633.7451906204224,21800,5131,16669,16669,0,31,5024000.0
5024,5024999,21.118896197895918,38.654624822635235,0.08037503315295669,3339.0151920318604,377.9980285167694,2633.785298347473,21800,5131,16669,16669,0,31,5025000.0
5025,5025999,21.117934167844773,38.65237714131301,0.0803893193276537,3339.298763513565,378.06210470199585,2635.947781562805,21806,5131,16675,16675,0,31,5026000.0
5026,5026999,21.116328709215875,38.650555651930055,0.0804033977096883,3339.544223546982,378.127316236496,2638.431408882141,21831,5132,16699,16699,0,31,5027000.0
5027,5027999,21.114457992686553,38.647784583317,0.08042428946345648,3339.8078112602234,378.18953227996826,2640.745518684387,21833,5132,16701,16701,0,31,5028000.0
5028,5028999,21.112810259584926,38.64553324450674,0.08043778283491343,3340.2840020656586,378.2519609928131,2642.035756111145,21835,5132,16703,16703,0,31,5029000.0
5029,5029999,21.111442364831255,38.6441631239036,0.08044509290635615,3340.6449778079987,378.3140308856964,2643.9016618728638,21838,5133,16705,16705,0,31,5030000.0
5030,5030999,21.110061032904174,38.64226453201804,0.08045184244163339,3341.384178161621,378.37718510627747,2643.6667909622192,21844,5136,16708,16708,0,31,5031000.0
5031,5031999,21.10902437617327,38.64118084480007,0.08045448198392058,3342.0023481845856,378.44174337387085,2644.1785707473755,21848,5138,16710,16710,0,31,5032000.0
5032,5032999,21.107778859448874,38.63954012066817,0.08045758340896458,3342.7749557495117,378.5052890777588,2644.116597175598,21852,5140,16712,16712,0,31,5033000.0
5033,5033999,21.1065319835571,38.63759036332533,0.0804591031379509,3343.681689977646,378.5702328681946,2643.1424989700317,21854,5141,16713,16713,0,31,5034000.0
5034,5034999,21.105601290014828,38.63579167679063,0.08045666303276955,3344.0594186782837,378.63342928886414,2644.798840522766,21854,5141,16713,16713,0,31,5035000.0
5035,5035999,21.105217359082843,38.63560468126071,0.08043897921862753,3344.6611564159393,378.69688606262207,2645.388264656067,21856,5142,16714,16714,0,31,5036000.0
5036,5036999,21.105254496591627,38.6360598237319,0.08042410487157314,3345.1623673439026,378.76166892051697,2646.5000734329224,21856,5142,16714,16714,0,31,5037000.0
5037,5037999,21.10529585692558,38.63605162685895,0.08041221566273837,3346.076616048813,378.8272633552551,2645.3598985671997,21869,5145,16724,16724,0,31,5038000.0
5038,5038999,21.105430674300855,38.63591677078054,0.08040819234070751,3346.77024269104,378.8924527168274,2645.581234931946,21871,5146,16725,16725,0,31,5039000.0
5039,5039999,21.105511614139388,38.63570446244723,0.08040049067483668,3347.259996175766,378.95693349838257,2646.69477558136,21871,5146,16725,16725,0,31,5040000.0
5040,5040999,21.105846095265,38.63717954279357,0.08038460137422132,3348.2576217651367,379.0234260559082,2645.5114030838013,21878,5147,16731,16731,0,31,5041000.0
5041,5041999,21.105819994149662,38.636621531265796,0.08038094308589383,3348.8604834079742,379.088604927063,2646.0765352249146,21880,5148,16732,16732,0,31,5042000.0
5042,5042999,21.105917239332836,38.63598055435911,0.08038800024032544,3349.3668451309204,379.1531970500946,2647.160367012024,21882,5149,16733,16733,0,31,5043000.0
5043,5043999,21.105695730401102,38.63454785135356,0.08038634047532833,3349.997786283493,379.2198815345764,2647.5311784744263,21884,5150,16734,16734,0,31,5044000.0
5044,5044999,21.105360662627927,38.63295331668585,0.08039078117533782,3350.622179031372,379.28482151031494,2648.1035737991333,21886,5151,16735,16735,0,31,5045000.0
5045,5045999,21.10475390729721,38.63160994612425,0.08038893413606751,3351.1068754196167,379.35058093070984,2649.4543046951294,21904,5151,16753,16753,0,31,5046000.0
5046,5046999,21.103409076955472,38.62932296630264,0.08039702542922189,3351.4649710655212,379.4130132198334,2651.2816667556763,21909,5151,16758,16758,0,31,5047000.0
5047,5047999,21.102977786140336,38.630575164035434,0.08039877028917608,3351.941298007965,379.4780216217041,2652.399235725403,21914,5153,16761,16761,0,31,5048000.0
5048,5048999,21.102945470804688,38.630666289852314,0.08040873737934762,3352.3183438777924,379.5413122177124,2654.2433519363403,21917,5154,16763,16763,0,31,5049000.0
5049,5049999,21.10284627565096,38.63078040445642,0.08041400902559648,3352.61571598053,379.60665488243103,2656.450619697571,21922,5155,16767,16767,0,31,5050000.0
5050,5050999,21.103584703334292,38.639159182270475,0.080416137413577,3353.504597902298,379.671010017395,2655.6786012649536,21932,5160,16772,16772,0,31,5051000.0
5051,5051999,21.10352060684357,38.6390861882867,0.08045605827097835,3354.2164623737335,379.73475456237793,2655.703061103821,21936,5162,16774,16774,0,31,5052000.0
5052,5052999,21.103482859000124,38.63927138824419,0.08050070276324872,3354.914201974869,379.80048847198486,2655.732113838196,21950,5165,16785,16785,0,31,5053000.0
5053,5053999,21.10439853859744,38.642394985181475,0.08050728921275474,3355.3994855880737,379.86589193344116,2656.9137468338013,21950,5165,16785,16785,0,31,5054000.0
5054,5054999,21.105290385383352,38.649028098585624,0.08049294786075334,3355.8949258327484,379.9305558204651,2658.0453310012817,21950,5165,16785,16785,0,31,5055000.0
5055,5055999,21.105957940501327,38.64946614335411,0.08050347429949367,3356.712507009506,379.99372243881226,2657.3046464920044,21952,5166,16786,16786,0,31,5056000.0
5056,5056999,21.106557734961914,38.649862436991846,0.0805216971107835,3357.1014783382416,380.05781960487366,2658.9366273880005,21952,5166,16786,16786,0,31,5057000.0
5057,5057999,21.10758201558978,38.651147679219186,0.0805279854961003,3357.9111659526825,380.12319231033325,2658.329525947571,21956,5168,16788,16788,0,31,5058000.0
5058,5058999,21.10793701868666,38.650916038776884,0.08054004161041273,3358.608476161957,380.18645453453064,2658.377865791321,21960,5170,16790,16790,0,31,5059000.0
5059,5059999,21.108561957336207,38.651178902105116,0.08056001181023265,3359.3772461414337,380.2515149116516,2658.2109575271606,21969,5171,16798,16798,0,31,5060000.0
5060,5060999,21.10962533762868,38.652240536159624,0.0805531100411957,3360.113956451416,380.3177752494812,2658.267216682434,21971,5172,16799,16799,0,31,5061000.0
5061,5061999,21.110920972003825,38.65321518564714,0.08056623534648999,3360.7069368362427,380.3815634250641,2658.8402757644653,21973,5173,16800,16800,0,31,5062000.0
5062,5062999,21.11216128664076,38.653822863360745,0.08059913220014137,3361.295086622238,380.4458420276642,2659.430806159973,21973,5173,16800,16800,0,31,5063000.0
5063,5063999,21.113251350503326,38.654208872155436,0.08061813420973762,3361.811615228653,380.50996112823486,2660.3791933059692,21975,5174,16801,16801,0,31,5064000.0
5064,5064999,21.113959054177908,38.65381570115852,0.08064396623480152,3362.482323408127,380.5766463279724,2660.7271089553833,21975,5174,16801,16801,0,31,5065000.0
5065,5065999,21.11392528075466,38.65263243546993,0.08066022368908488,3363.194741010666,380.6425976753235,2660.965916633606,21988,5174,16814,16814,0,31,5066000.0
5066,5066999,21.112763302278474,38.65151918681889,0.0806570741789071,3363.565173625946,380.70874214172363,2662.819088935852,21995,5174,16821,16821,0,31,5067000.0
5067,5067999,21.111196854649634,38.6491161160816,0.08066322813025117,3363.8651049137115,380.7796275615692,2665.0661821365356,21998,5174,16824,16824,0,31,5068000.0
5068,5068999,21.10971025668461,38.647770126940316,0.08066465812841717,3364.3561861515045,380.8438391685486,2666.172818183899,22005,5176,16829,16829,0,31,5069000.0
5069,5069999,21.10819787749318,38.645225625109155,0.08067176449143354,3364.7470512390137,380.9069187641144,2667.843777656555,22008,5177,16831,16831,0,31,5070000.0
5070,5070999,21.107029084560644,38.64302867609387,0.08067144692386086,3365.4333164691925,380.9715814590454,2668.0707063674927,22017,5181,16836,16836,0,31,5071000.0
5071,5071999,21.10592657305583,38.64096597864965,0.08067355299834167,3366.1639223098755,381.04133462905884,2668.1021852493286,22025,5185,16840,16840,0,31,5072000.0
5072,5072999,21.105458844579623,38.64059303681963,0.08066309679630035,3366.556189775467,381.1067078113556,2669.7831926345825,22026,5185,16841,16841,0,31,5073000.0
5073,5073999,21.105352138303637,38.64076869896974,0.080647554234068,3367.723044157028,381.1701192855835,2667.4126558303833,22032,5188,16844,16844,0,31,5074000.0
5074,5074999,21.1054915041867,38.640959640616835,0.08063655048478002,3368.0242478847504,381.23490619659424,2669.5763444900513,22032,5188,16844,16844,0,31,5075000.0
5075,5075999,21.10575521573195,38.641550375737864,0.08062181271655511,3368.859249353409,381.2997260093689,2668.9206895828247,22058,5190,16868,16868,0,31,5076000.0
5076,5076999,21.10629614753648,38.64262940311889,0.08060660415223586,3369.475655555725,381.36806416511536,2669.7511415481567,22058,5190,16868,16868,0,31,5077000.0
5077,5077999,21.106877676726945,38.644155444963964,0.08058678490728399,3370.0903873443604,381.4323296546936,2670.300419807434,22060,5191,16869,16869,0,31,5078000.0
5078,5078999,21.10750101764841,38.64526769561632,0.08057042022245431,3370.4885182380676,381.4962339401245,2671.903500556946,22062,5192,16870,16870,0,31,5079000.0
5079,5079999,21.108105326060386,38.64601647288769,0.08056104723777047,3371.3635494709015,381.5605459213257,2671.1477937698364,22066,5194,16872,16872,0,31,5080000.0
5080,5080999,21.109053270952792,38.646964042979285,0.08056387537856025,3371.9842550754547,381.6274824142456,2671.759274482727,22068,5195,16873,16873,0,31,5081000.0
5081,5081999,21.109729589066173,38.64713954730112,0.08055444151274238,3372.788829088211,381.6914689540863,2671.308117866516,22070,5196,16874,16874,0,31,5082000.0
5082,5082999,21.110466768700412,38.64725145831211,0.0805516885421711,3373.3956892490387,381.7594530582428,2671.9120378494263,22070,5196,16874,16874,0,31,5083000.0
5083,5083999,21.110562280073236,38.64649804680207,0.08055161117930798,3373.693214893341,381.82338070869446,2674.0485429763794,22070,5196,16874,16874,0,31,5084000.0
5084,5084999,21.111043374209515,38.645960036945795,0.08053835975335732,3374.7044627666473,381.88923954963684,2672.414128303528,22076,5199,16877,16877,0,31,5085000.0
5085,5085999,21.11073503466714,38.64498902219262,0.08052992339145315,3375.2607142925262,381.9537994861603,2673.5271043777466,22090,5199,16891,16891,0,31,5086000.0
5086,5086999,21.109394244425456,38.64496263327477,0.08053060341896945,3375.622748851776,382.01796221733093,2675.381070137024,22098,5199,16899,16899,0,31,5087000.0
5087,5087999,21.10756295462012,38.641914792985695,0.08054744940174663,3376.006206035614,382.08245611190796,2677.0520219802856,22106,5200,16906,16906,0,31,5088000.0
5088,5088999,21.105941642600104,38.63956756153414,0.08055850296024791,3376.585637331009,382.14581203460693,2677.77908039093,22111,5202,16909,16909,0,31,5089000.0
5089,5089999,21.104236136037596,38.63699693328456,0.0805711614257596,3376.874839067459,382.20939779281616,2679.970768928528,22115,5203,16912,16912,0,31,5090000.0
5090,5090999,21.102872401445683,38.63462787916037,0.08057330693100817,3377.7192738056183,382.27613162994385,2679.2925233840942,22126,5208,16918,16918,0,31,5091000.0
5091,5091999,21.101302370590705,38.63212771546406,0.08058212347972282,3378.30437207222,382.3393223285675,2679.937039375305,22130,5210,16920,16920,0,31,5092000.0
5092,5092999,21.099581996612446,38.62932473811891,0.08060384588919234,3378.9166638851166,382.40434432029724,2680.59597492218,22130,5210,16920,16920,0,31,5093000.0
5093,5093999,21.09817780288838,38.62724171394897,0.0806151804726396,3379.6994149684906,382.4689450263977,2680.3210191726685,22130,5210,16920,16920,0,31,5094000.0
5094,5094999,21.096849153802676,38.62503395086625,0.08062905706147294,3380.2000863552094,382.5323233604431,2681.3860063552856,22140,5212,16928,16928,0,31,5095000.0
5095,5095999,21.095735737738313,38.623127316853456,0.08063350657912338,3381.019594669342,382.59668374061584,2680.862729072571,22154,5214,16940,16940,0,31,5096000.0
5096,5096999,21.09444291984372,38.62076731378553,0.08063751420357657,3381.632905960083,382.6642003059387,2681.40514087677,22156,5215,16941,16941,0,31,5097000.0
5097,5097999,21.093183692870692,38.61852245530235,0.0806527981006292,3382.136218070984,382.72887134552,2682.4987382888794,22158,5216,16942,16942,0,31,5098000.0
5098,5098999,21.09197125315913,38.61683114771789,0.08065448990059632,3382.938104391098,382.7928695678711,2682.103581428528,22160,5217,16943,16943,0,31,5099000.0
5099,5099999,21.090887320062635,38.61457290027682,0.08066020872729152,3383.3333592414856,382.8561658859253,2683.7264833450317,22160,5217,16943,16943,0,31,5100000.0
5100,5100999,21.08991357737248,38.612792048003485,0.08066408260724256,3384.4241161346436,382.9227159023285,2682.174229621887,22160,5217,16943,16943,0,31,5101000.0
5101,5101999,21.088933738819254,38.61085764715368,0.08066387904182559,3385.0217185020447,382.9861707687378,2682.7465105056763,22160,5217,16943,16943,0,31,5102000.0
5102,5102999,21.08813428414879,38.609456461275265,0.08066721839793423,3385.6068053245544,383.0496048927307,2683.43533039093,22160,5217,16943,16943,0,31,5103000.0
5103,5103999,21.086931719801093,38.6069479140032,0.08067096585877753,3386.2269973754883,383.1150732040405,2683.9053926467896,22160,5217,16943,16943,0,31,5104000.0
5104,5104999,21.08605390369905,38.60492224681622,0.08067624129279605,3387.016369342804,383.17919397354126,2683.5608949661255,22162,5218,16944,16944,0,31,5105000.0
5105,5105999,21.084848612030378,38.60310490312537,0.08068371306423539,3387.6287553310394,383.2443583011627,2684.084858894348,22164,5219,16945,16945,0,31,5106000.0
5106,5106999,21.083285927959075,38.60024131119137,0.08069820813373962,3388.2081060409546,383.3104929924011,2684.9602937698364,22186,5220,16966,16966,0,31,5107000.0
5107,5107999,21.081548184651982,38.598096599348686,0.08070676998878923,3388.5846586227417,383.3733434677124,2686.7320528030396,22193,5220,16973,16973,0,31,5108000.0
5108,5108999,21.079815684298186,38.595331037770876,0.08071849526066865,3388.959126472473,383.44436025619507,2688.6416902542114,22201,5221,16980,16980,0,31,5109000.0
5109,5109999,21.078032619813612,38.592566009135574,0.08073506485858228,3389.351349592209,383.50841069221497,2690.291615486145,22207,5223,16984,16984,0,31,5110000.0
5110,5110999,21.076059960132632,38.589449895031976,0.08075108819420551,3390.069193840027,383.57195520401,2690.314145088196,22214,5226,16988,16988,0,31,5111000.0
5111,5111999,21.07421611782315,38.586452550882505,0.08076368713831494,3390.767056941986,383.6379864215851,2690.8633394241333,22225,5228,16997,16997,0,31,5112000.0
5112,5112999,21.072364341666553,38.58349247792798,0.08077572635831298,3391.584970474243,383.7042570114136,2690.4160509109497,22227,5229,16998,16998,0,31,5113000.0
5113,5113999,21.07063632079157,38.58114559973096,0.08078395969643248,3392.0701909065247,383.76792311668396,2691.5624055862427,22229,5230,16999,16999,0,31,5114000.0
5114,5114999,21.069128722548,38.5791304625436,0.08078579609710945,3392.47683429718,383.8351261615753,2693.1775484085083,22238,5231,17007,17007,0,31,5115000.0
5115,5115999,21.067476513388385,38.57632566901592,0.08079895837928108,3393.182663679123,383.89946269989014,2693.297200202942,22238,5231,17007,17007,0,31,5116000.0
5116,5116999,21.066274190299914,38.57438425577188,0.08080097254889551,3393.8344700336456,383.9632041454315,2693.3957872390747,22242,5233,17009,17009,0,31,5117000.0
5117,5117999,21.065663367480813,38.57351635307958,0.08079897549298698,3394.6447007656097,384.02962708473206,2692.95112323761,22244,5234,17010,17010,0,31,5118000.0
5118,5118999,21.065595890646748,38.572918506899924,0.08079286851963419,3395.241553544998,384.0935435295105,2693.546109199524,22244,5234,17010,17010,0,31,5119000.0
5119,5119999,21.06613398591648,38.576422117228624,0.08077123523803587,3395.8423969745636,384.15925455093384,2694.098790168762,22246,5235,17011,17011,0,31,5120000.0
5120,5120999,21.06634803555819,38.57707451328945,0.0807637175421747,3396.7774624824524,384.2254889011383,2692.9052019119263,22248,5236,17012,17012,0,31,5121000.0
5121,5121999,21.066617848428432,38.577415122751226,0.08076886311855835,3397.395127773285,384.2921483516693,2693.4232454299927,22248,5236,17012,17012,0,31,5122000.0
5122,5122999,21.067296139815568,38.578476398695756,0.08078224477158125,3397.8988814353943,384.3585047721863,2694.5148820877075,22248,5236,17012,17012,0,31,5123000.0
5123,5123999,21.067166004821416,38.57807078880781,0.08082086610051131,3398.6210045814514,384.42644000053406,2694.475728034973,22250,5237,17013,17013,0,31,5124000.0
5124,5124999,21.066629169394254,38.57648967992134,0.0808339049889244,3399.1265597343445,384.49052238464355,2695.5708589553833,22250,5237,17013,17013,0,31,5125000.0
5125,5125999,21.066432111440808,38.57553211860261,0.08086013875461395,3400.016707420349,384.55520391464233,2694.757435798645,22254,5239,17015,17015,0,31,5126000.0
5126,5126999,21.066289417405166,38.574586789167924,0.08089111117170544,3400.7206432819366,384.6194703578949,2694.8155946731567,22256,5240,17016,17016,0,31,5127000.0
5127,5127999,21.065329012343074,38.572876707534604,0.08087760917904518,3401.2911846637726,384.68394327163696,2695.7608461380005,22280,5241,17039,17039,0,31,5128000.0
5128,5128999,21.064010848712698,38.57091993191952,0.08087385369859934,3401.4618861675262,384.7507555484772,2698.5592317581177,22286,5241,17045,17045,0,31,5129000.0
5129,5129999,21.06269199525358,38.56854363609993,0.08087825943691562,3402.0391640663147,384.8154306411743,2699.3640336990356,22292,5243,17049,17049,0,31,5130000.0
5130,5130999,21.061365873731013,38.56692715232274,0.08088160941788447,3402.439522743225,384.8796591758728,2701.0014543533325,22295,5244,17051,17051,0,31,5131000.0
5131,5131999,21.060037922043474,38.56466643893793,0.080879399800865,3403.1721000671387,384.9467964172363,2700.9492769241333,22299,5246,17053,17053,0,31,5132000.0
5132,5132999,21.059051788409565,38.562894542481324,0.08087628677244185,3403.897472858429,385.014511346817,2701.040051460266,22306,5249,17057,17057,0,31,5133000.0
5133,5133999,21.057906648198596,38.56080968463476,0.08087490138087883,3404.398103237152,385.07872104644775,2702.1512880325317,22311,5251,17060,17060,0,31,5134000.0
5134,5134999,21.05684647529171,38.558719990194916,0.080873512756096,3404.99911904335,385.14465856552124,2702.812581062317,22313,5252,17061,17061,0,31,5135000.0
5135,5135999,21.055666842840584,38.558840737191495,0.08086756612936752,3405.6296191215515,385.2124516963959,2703.388310432434,22317,5254,17063,17063,0,31,5136000.0
5136,5136999,21.054840037522673,38.557547898807535,0.08086731109923562,3406.1360490322113,385.2787435054779,2704.5151109695435,22317,5254,17063,17063,0,31,5137000.0
5137,5137999,21.054439502520772,38.5571772976837,0.08086468526825707,3407.1897921562195,385.3465144634247,2703.011441230774,22348,5256,17092,17092,0,31,5138000.0
5138,5138999,21.054321210676317,38.559572285107514,0.08085887990016527,3407.9152941703796,385.41300320625305,2703.143666267395,22350,5257,17093,17093,0,31,5139000.0
5139,5139999,21.0549094353658,38.56332364734257,0.08086672969386921,3408.3169252872467,385.4772744178772,2704.78071308136,22350,5257,17093,17093,0,31,5140000.0
5140,5140999,21.055834989001053,38.56491710586826,0.08088875587058741,3408.9291520118713,385.5421624183655,2705.287365913391,22352,5258,17094,17094,0,31,5141000.0
5141,5141999,21.057232191322026,38.567760430488974,0.08090087853445627,3409.539314508438,385.6080496311188,2705.726658821106,22356,5260,17096,17096,0,31,5142000.0
5142,5142999,21.05869986541037,38.570174548312096,0.08094003480776024,3410.272115468979,385.67631363868713,2705.6966676712036,22367,5261,17106,17106,0,31,5143000.0
5143,5143999,21.060663376955493,38.574132521004,0.0809901528453405,3411.2029089927673,385.7429025173187,2704.73383808136,22367,5261,17106,17106,0,31,5144000.0
5144,5144999,21.062469691680846,38.57734587793247,0.08102119677769604,3411.496686935425,385.80778193473816,2706.8560609817505,22367,5261,17106,17106,0,31,5145000.0
5145,5145999,21.063704228036173,38.578715668345296,0.08103322214670339,3412.1173248291016,385.8738088607788,2707.426205635071,22367,5261,17106,17106,0,31,5146000.0
5146,5146999,21.065049058871804,38.57987561095818,0.08106134084392658,3413.0272431373596,385.9405298233032,2706.7058000564575,22377,5263,17114,17114,0,31,5147000.0
5147,5147999,21.06648507029589,38.581904727147375,0.0810963849538886,3413.8516964912415,386.0060496330261,2706.2869997024536,22385,5264,17121,17121,0,31,5148000.0
5148,5148999,21.065121702072926,38.57972300113608,0.08110643046920074,3414.0165209770203,386.07457065582275,2709.3167390823364,22412,5264,17148,17148,0,31,5149000.0
5149,5149999,21.063735935026838,38.57814961214777,0.08111126941514246,3414.4870421886444,386.1375524997711,2710.5609560012817,22418,5264,17154,17154,0,31,5150000.0
5150,5150999,21.06231362947741,38.575859465998136,0.08112269723468024,3414.870340824127,386.2029330730438,2712.249821662903,22423,5265,17158,17158,0,31,5151000.0
5151,5151999,21.061160381360786,38.575851129547345,0.08111675675868435,3415.471151828766,386.2676920890808,2712.9827394485474,22426,5266,17160,17160,0,31,5152000.0
5152,5152999,21.059780380575965,38.57702564892,0.08110843033497583,3416.252285003662,386.3334197998047,2712.848774909973,22430,5268,17162,17162,0,31,5153000.0
5153,5153999,21.05822245580503,38.574280198078434,0.08111888747146245,3416.6332795619965,386.39753580093384,2714.7230195999146,22431,5268,17163,17163,0,31,5154000.0
5154,5154999,21.05711721915586,38.57244077787443,0.0811201769205927,3417.539486885071,386.46249437332153,2713.857579231262,22435,5270,17165,17165,0,31,5155000.0
5155,5155999,21.055872123780965,38.57081422332402,0.08112066291473641,3418.1414387226105,386.5284171104431,2714.4443254470825,22437,5271,17166,17166,0,31,5156000.0
5156,5156999,21.05451510492755,38.568831434189214,0.08112721996827166,3418.6417095661163,386.5938572883606,2715.59166431427,22439,5272,17167,17167,0,31,5157000.0
5157,5157999,21.053425371717612,38.56689243310779,0.0811324504957377,3419.0339365005493,386.6563448905945,2717.2173433303833,22439,5272,17167,17167,0,31,5158000.0
5158,5158999,21.05242390851762,38.567273330588726,0.08112777824624817,3419.88822388649,386.72083044052124,2716.260968208313,22443,5274,17169,17169,0,31,5159000.0
5159,5159999,21.05116723910124,38.56490247190557,0.08113812752898075,3420.5971994400024,386.78605365753174,2716.2330598831177,22447,5276,17171,17171,0,31,5160000.0
5160,5160999,21.050083469282725,38.56310815614577,0.08114549205941946,3421.1210091114044,386.85198187828064,2717.1524934768677,22449,5277,17172,17172,0,31,5161000.0
5161,5161999,21.049022002271375,38.56315006745273,0.08115013871301668,3421.618839740753,386.91772627830505,2718.266514778137,22449,5277,17172,17172,0,31,5162000.0
5162,5162999,21.04789640644564,38.56085855508609,0.08116340217528739,3422.722271680832,386.98468923568726,2716.3311281204224,22458,5278,17180,17180,0,31,5163000.0
5163,5163999,21.04654190018361,38.55819534032119,0.08118097678014147,3423.335723876953,387.0508689880371,2716.9370546340942,22466,5279,17187,17187,0,31,5164000.0
5164,5164999,21.04512578798918,38.556498044952356,0.08119648849573646,3424.1085016727448,387.11574268341064,2716.919186592102,22470,5280,17190,17190,0,31,5165000.0
5165,5165999,21.0437699253337,38.5538548245599,0.08119807608460161,3424.4696414470673,387.1812641620636,2718.91433429718,22496,5280,17216,17216,0,31,5166000.0
5166,5166999,21.04238303301867,38.55173632382599,0.08120198818135727,3424.8332843780518,387.24623370170593,2720.7549028396606,22501,5280,17221,17221,0,31,5167000.0
5167,5167999,21.04099743306128,38.55043129153553,0.0812035124020638,3425.4242584705353,387.31054067611694,2721.4047060012817,22505,5281,17224,17224,0,31,5168000.0
5168,5168999,21.03936989414299,38.54765769310917,0.08121506462393835,3425.908433198929,387.37626028060913,2722.7686586380005,22510,5283,17227,17227,0,31,5169000.0
5169,5169999,21.038092183253394,38.54574257760147,0.08122034490350194,3426.311442375183,387.4417576789856,2724.404980659485,22512,5284,17228,17228,0,31,5170000.0
5170,5170999,21.036873105489125,38.54377222832267,0.08123315961054867,3427.2363650798798,387.5071518421173,2723.3971757888794,22518,5287,17231,17231,0,31,5171000.0
5171,5171999,21.035772080125337,38.54281567425616,0.08123353431864844,3427.75084066391,387.57361245155334,2724.4553575515747,22522,5289,17233,17233,0,31,5172000.0
5172,5172999,21.03450915292426,38.54082640734069,0.08123740517884726,3428.7342047691345,387.6387884616852,2723.135396003723,22526,5291,17235,17235,0,31,5173000.0
5173,5173999,21.033513246023556,38.539475916081194,0.08123891329533861,3429.2269761562347,387.7049837112427,2724.29226398468,22526,5291,17235,17235,0,31,5174000.0
5174,5174999,21.03231037800613,38.53757060317096,0.08123798055186549,3429.9503226280212,387.7742042541504,2724.6508226394653,22556,5292,17264,17264,0,31,5175000.0
5175,5175999,21.031574537384994,38.53622561906661,0.08122688058313665,3430.7603001594543,387.84025287628174,2724.5647554397583,22558,5293,17265,17265,0,31,5176000.0
5176,5176999,21.031274198511426,38.53604227515039,0.08121071738392671,3431.3703162670135,387.9064197540283,2725.1679430007935,22558,5293,17265,17265,0,31,5177000.0
5177,5177999,21.03084681751803,38.53512983270271,0.08120209436282455,3432.090359687805,387.97341442108154,2725.2175188064575,22560,5294,17266,17266,0,31,5178000.0
5178,5178999,21.03006223814717,38.533428916586494,0.0811983642016827,3432.6941039562225,388.03702092170715,2725.7732133865356,22562,5295,17267,17267,0,31,5179000.0
5179,5179999,21.029840258513993,38.53291750786166,0.08118576951579193,3433.0275926589966,388.10420298576355,2727.8652772903442,22562,5295,17267,17267,0,31,5180000.0
5180,5180999,21.029196308799982,38.53128321753527,0.08118187859183879,3433.8526775836945,388.16915488243103,2727.35183429718,22564,5296,17268,17268,0,31,5181000.0
5181,5181999,21.028530126627214,38.52962320684379,0.08117429036960411,3434.2588675022125,388.23391914367676,2728.9386796951294,22564,5296,17268,17268,0,31,5182000.0
5182,5182999,21.027981986652293,38.528303614180444,0.0811620796591006,3450.103590965271,388.29955196380615,2728.9749727249146,22564,5296,17268,17268,0,31,5183000.0
5183,5183999,21.027798161023654,38.530726173078676,0.08113368883649841,3450.805418252945,388.36607003211975,2729.050602912903,22564,5296,17268,17268,0,31,5184000.0
5184,5184999,21.027147275148902,38.53133413965349,0.08111537576166161,3451.7830946445465,388.4340121746063,2728.0657625198364,22580,5297,17283,17283,0,31,5185000.0
5185,5185999,21.025696704715376,38.529453716256796,0.08112054439125904,3452.1544053554535,388.4989113807678,2729.9501161575317,22592,5297,17295,17295,0,31,5186000.0
5186,5186999,21.02405975195948,38.52791241285751,0.08112891445758819,3452.4483139514923,388.56463646888733,2732.1589784622192,22598,5298,17300,17300,0,31,5187000.0
5187,5187999,21.022697776890368,38.52699699281173,0.08112758224781869,3452.9019677639008,388.6271605491638,2733.7148790359497,22602,5299,17303,17303,0,31,5188000.0
5188,5188999,21.021466970913547,38.525129510476866,0.08112953167458092,3453.3772966861725,388.69180274009705,2735.056492805481,22606,5300,17306,17306,0,31,5189000.0
5189,5189999,21.02059627352021,38.52421044280234,0.081123359696599,3454.2972247600555,388.7580943107605,2734.1415758132935,22613,5303,17310,17310,0,31,5190000.0
5190,5190999,21.019472643181917,38.52245417324432,0.08112392572179583,3454.9229967594147,388.82239603996277,2734.4624223709106,22617,5305,17312,17312,0,31,5191000.0
5191,5191999,21.018297090886982,38.5203970082208,0.08112700645152182,3455.6470687389374,388.88761591911316,2734.616467475891,22620,5306,17314,17314,0,31,5192000.0
5192,5192999,21.017078374607443,38.51812025559625,0.08113089003188034,3456.59263420105,388.95484375953674,2733.673108100891,22622,5307,17315,17315,0,31,5193000.0
5193,5193999,21.01612199209119,38.516308376301566,0.08112818277242706,3457.08993768692,389.02161383628845,2734.880192756653,22624,5308,17316,17316,0,31,5194000.0
5194,5194999,21.015439330016118,38.51564979348245,0.08113075188848262,3457.497355699539,389.0847280025482,2736.4918718338013,22624,5308,17316,17316,0,31,5195000.0
5195,5195999,21.014598545666797,38.51365446993879,0.08112946945389954,3458.4438445568085,389.1509518623352,2735.3719987869263,22628,5310,17318,17318,0,31,5196000.0
5196,5196999,21.01398552647273,38.51235236628667,0.08112743922205012,3459.0500485897064,389.216509103775,2735.989758491516,22628,5310,17318,17318,0,31,5197000.0
5197,5197999,21.01316856724418,38.510615764328065,0.08112662408609927,3459.7626044750214,389.28081488609314,2736.0416765213013,22630,5311,17319,17319,0,31,5198000.0
5198,5198999,21.012671123880555,38.51181750144023,0.08111355839199896,3460.173418521881,389.34396839141846,2737.6530199050903,22630,5311,17319,17319,0,31,5199000.0
5199,5199999,21.01183799952493,38.509778965097006,0.08111793267986855,3460.6926414966583,389.4105591773987,2738.4864320755005,22632,5312,17320,17320,0,31,5200000.0
5200,5200999,21.011108522476466,38.50781679583283,0.08111750982226074,3461.514110803604,389.47776532173157,2738.0577058792114,22632,5312,17320,17320,0,31,5201000.0
5201,5201999,21.01076746304712,38.506901177505874,0.0811093339585488,3462.2909874916077,389.5433087348938,2737.8743257522583,22632,5312,17320,17320,0,31,5202000.0
5202,5202999,21.0102823407715,38.505136691010506,0.08110702747272402,3462.715302467346,389.6089496612549,2739.139416694641,22634,5313,17321,17321,0,31,5203000.0
5203,5203999,21.009328007898414,38.50286684421318,0.08110647312901831,3463.532099723816,389.67510771751404,2738.668194770813,22634,5313,17321,17321,0,31,5204000.0
5204,5204999,21.008165672751986,38.500481976240856,0.08110803989343451,3463.9018182754517,389.74211382865906,2740.43159198761,22634,5313,17321,17321,0,31,5205000.0
5205,5205999,21.007196198225056,38.49830764676202,0.08111300572049263,3464.7224621772766,389.80858397483826,2740.054944038391,22650,5313,17337,17337,0,31,5206000.0
5206,5206999,21.005576784248635,38.49564187934672,0.08112682895941525,3465.0987322330475,389.8741977214813,2741.936619758606,22662,5313,17349,17349,0,31,5207000.0
5207,5207999,21.003743803785945,38.49284282238704,0.08114116959096773,3465.39959859848,389.9380421638489,2744.1628999710083,22668,5314,17354,17354,0,31,5208000.0
5208,5208999,21.00212399355258,38.49009478079733,0.08115489012880583,3465.790846347809,390.00227189064026,2745.822033882141,22674,5316,17358,17358,0,31,5209000.0
5209,5209999,21.000550440306874,38.48751125412918,0.08116750730715683,3466.5318236351013,390.06625032424927,2745.9838075637817,22680,5318,17362,17362,0,31,5210000.0
5210,5210999,20.999200844616905,38.48627151987431,0.0811748058408468,3467.4611904621124,390.13122820854187,2745.014561653137,22688,5322,17366,17366,0,31,5211000.0
5211,5211999,20.99764367082672,38.48367043732342,0.08118571734211655,3467.8641963005066,390.1949760913849,2746.6702241897583,22690,5323,17367,17367,0,31,5212000.0
5212,5212999,20.996080693769446,38.48110004630377,0.08119662860386323,3468.820780277252,390.25872468948364,2745.4994707107544,22695,5325,17370,17370,0,31,5213000.0
5213,5213999,20.994792409665518,38.478731796970095,0.08120291460107909,3469.2007081508636,390.3265917301178,2747.3828020095825,22695,5325,17370,17370,0,31,5214000.0
5214,5214999,20.993532753642558,38.47685207797783,0.0812156378539407,3469.72390127182,390.3929750919342,2748.2798585891724,22699,5327,17372,17372,0,31,5215000.0
5215,5215999,20.992348169194283,38.474953917708376,0.0812224711102233,3470.473776102066,390.4607262611389,2748.09028339386,22703,5329,17374,17374,0,31,5216000.0
5216,5216999,20.99074653186969,38.47224571079377,0.08123910876128293,3471.384875059128,390.5271122455597,2747.173031806946,22705,5330,17375,17375,0,31,5217000.0
5217,5217999,20.989346868118666,38.46969753985903,0.08124978283978834,3471.7853288650513,390.59403443336487,2748.814450263977,22705,5330,17375,17375,0,31,5218000.0
5218,5218999,20.988189005265554,38.46783452833129,0.08125746101748865,3472.377876520157,390.65702509880066,2749.363522529602,22707,5331,17376,17376,0,31,5219000.0
5219,5219999,20.987119453518705,38.46591825695503,0.08126631779209559,3473.0915908813477,390.7221074104309,2749.427861213684,22707,5331,17376,17376,0,31,5220000.0
5220,5220999,20.98649229635139,38.46506804407965,0.08126797411146003,3473.635900259018,390.788311958313,2750.3191804885864,22709,5332,17377,17377,0,31,5221000.0
5221,5221999,20.985793955454906,38.46338114700145,0.08127345423162302,3474.1317665576935,390.8542742729187,2751.393696784973,22709,5332,17377,17377,0,31,5222000.0
5222,5222999,20.9852098977709,38.462150639199834,0.08127325553894993,3474.943572282791,390.9195041656494,2751.002408027649,22720,5334,17386,17386,0,31,5223000.0
5223,5223999,20.98450837299875,38.461643376332496,0.08126934184613488,3475.6522901058197,390.9841933250427,2751.006657600403,22722,5335,17387,17387,0,31,5224000.0
5224,5224999,20.983371140239875,38.460433280991474,0.08127025347425498,3476.369637489319,391.04929542541504,2750.9664964675903,22724,5336,17388,17388,0,31,5225000.0
5225,5225999,20.982451225741066,38.45833762971036,0.0812694309135974,3476.974419593811,391.1150290966034,2751.711079597473,22742,5337,17405,17405,0,31,5226000.0
5226,5226999,20.9810884773397,38.45728643655813,0.08127484660937478,3477.23618888855,391.18034958839417,2754.1200075149536,22753,5337,17416,17416,0,31,5227000.0
5227,5227999,20.979406272884656,38.45465014968778,0.08128311178918168,3477.4032986164093,391.24126863479614,2756.9031343460083,22756,5337,17419,17419,0,31,5228000.0
5228,5228999,20.97755545644167,38.451691626166486,0.08129797578030584,3478.1087460517883,391.30806589126587,2757.2213945388794,22759,5338,17421,17421,0,31,5229000.0
5229,5229999,20.976034776375915,38.449114202696094,0.08130635354732274,3478.70175075531,391.3725996017456,2757.9758348464966,22762,5339,17423,17423,0,31,5230000.0
5230,5230999,20.974809582422445,38.44731784352212,0.08130626698691712,3479.293539047241,391.43727588653564,2758.6917390823364,22769,5342,17427,17427,0,31,5231000.0
5231,5231999,20.973215099857875,38.44463229715224,0.08131557193159522,3480.3299033641815,391.5042636394501,2756.909977912903,22779,5347,17432,17432,0,31,5232000.0
5232,5232999,20.971962589711197,38.44266019601444,0.0813191752189385,3480.9113047122955,391.56638050079346,2757.498730659485,22781,5348,17433,17433,0,31,5233000.0
5233,5233999,20.97071828602485,38.44084606646665,0.08132200153950053,3481.5002992153168,391.6318347454071,2758.2190523147583,22790,5349,17441,17441,0,31,5234000.0
5234,5234999,20.96940962912778,38.43841773883307,0.08132542628620887,3482.0223824977875,391.6980721950531,2759.469853401184,22790,5349,17441,17441,0,31,5235000.0
5235,5235999,20.968089977688972,38.43596227922648,0.08133168280366465,3482.7327852249146,391.76439571380615,2759.66726398468,22798,5350,17448,17448,0,31,5236000.0
5236,5236999,20.96691268613314,38.43405868077058,0.08133533195605269,3483.5365059375763,391.8288230895996,2759.228138923645,22798,5350,17448,17448,0,31,5237000.0
5237,5237999,20.96572190908738,38.43212816679729,0.08133417155730815,3483.864667892456,391.9007580280304,2761.3364992141724,22798,5350,17448,17448,0,31,5238000.0
5238,5238999,20.9643328302098,38.429788584463076,0.08134138572921334,3484.712244749069,391.964807510376,2760.517773628235,22800,5351,17449,17449,0,31,5239000.0
5239,5239999,20.963247559181728,38.4275387553468,0.08134243436785882,3485.1426622867584,392.0289478302002,2761.8103227615356,22802,5352,17450,17450,0,31,5240000.0
5240,5240999,20.962067154927627,38.426525064952465,0.08134114614026067,3486.162791967392,392.09438967704773,2760.2800493240356,22804,5353,17451,17451,0,31,5241000.0
5241,5241999,20.960928472719736,38.424190761981606,0.08134544068677818,3486.569485425949,392.1613759994507,2761.875699043274,22804,5353,17451,17451,0,31,5242000.0
5242,5242999,20.959985059944174,38.4221722518273,0.08134657341716756,3486.9711463451385,392.2267858982086,2763.453709602356,22804,5353,17451,17451,0,31,5243000.0
5243,5243999,20.958810367257723,38.41977222263476,0.08134941079560831,3487.9062209129333,392.29265213012695,2762.493977546692,22806,5354,17452,17452,0,31,5244000.0
5244,5244999,20.95745467204669,38.41717826905442,0.08135445692210774,3488.425449848175,392.35670590400696,2763.4650621414185,22816,5356,17460,17460,0,31,5245000.0
5245,5245999,20.95607756448023,38.414740925498386,0.08135957709420516,3489.0297117233276,392.4201865196228,2764.02322101593,22816,5356,17460,17460,0,31,5246000.0
5246,5246999,20.95516540760925,38.41296770250894,0.08132798097842153,3489.7961087226868,392.48567938804626,2764.010281562805,22845,5356,17489,17489,0,31,5247000.0
5247,5247999,20.95331888156376,38.410339381130356,0.08133093258444357,3489.9625091552734,392.5520443916321,2766.8851976394653,22851,5356,17495,17495,0,31,5248000.0
5248,5248999,20.951487922878844,38.407665600737765,0.08134252292678346,3490.4665772914886,392.61597967147827,2767.964596748352,22859,5359,17500,17500,0,31,5249000.0
5249,5249999,20.949732715364235,38.40493715530945,0.08135996086601194,3491.0131528377533,392.68058228492737,2769.0418977737427,22863,5360,17503,17503,0,31,5250000.0
5250,5250999,20.94809212809558,38.4024489358862,0.08136920054640784,3491.3978226184845,392.74713015556335,2770.932698249817,22866,5361,17505,17505,0,31,5251000.0
5251,5251999,20.94678710880223,38.40111026830184,0.08137541886305866,3492.239355325699,392.8130078315735,2770.2119722366333,22876,5366,17510,17510,0,31,5252000.0
5252,5252999,20.945200503268268,38.39916708359775,0.08138410696899923,3492.9614822864532,392.87765312194824,2770.159161567688,22881,5368,17513,17513,0,31,5253000.0
5253,5253999,20.94381634178344,38.39718110270638,0.08139884995357372,3493.663468837738,392.94312858581543,2770.2322511672974,22893,5371,17522,17522,0,31,5254000.0
5254,5254999,20.942421882668388,38.3950573762479,0.08140761350427561,3493.951849460602,393.0074050426483,2772.431088447571,22893,5371,17522,17522,0,31,5255000.0
5255,5255999,20.9410793392732,38.39284447744686,0.08141724958316343,3494.563083410263,393.07436895370483,2772.954197883606,22895,5372,17523,17523,0,31,5256000.0
5256,5256999,20.93980402907528,38.39057845843581,0.08142899604239684,3495.063098669052,393.14107060432434,2774.0833711624146,22895,5372,17523,17523,0,31,5257000.0
5257,5257999,20.93847548314633,38.38853066739832,0.08143507237086556,3495.466865301132,393.2069239616394,2775.710270881653,22895,5372,17523,17523,0,31,5258000.0
5258,5258999,20.937377894824095,38.386791089179184,0.08143699164691875,3496.071125268936,393.27274346351624,2776.305142402649,22895,5372,17523,17523,0,31,5259000.0
5259,5259999,20.936149646018823,38.38468212005549,0.08144032144711755,3496.971197128296,393.3375897407532,2775.329167366028,22898,5373,17525,17525,0,31,5260000.0
5260,5260999,20.9355068530291,38.385245972809365,0.08143558155204844,3497.667745113373,393.4007456302643,2775.236714363098,22900,5374,17526,17526,0,31,5261000.0
5261,5261999,20.934754612641957,38.384447746838525,0.08144082064326841,3498.157152891159,393.46465396881104,2776.3055086135864,22902,5375,17527,17527,0,31,5262000.0
5262,5262999,20.934073472946075,38.384420223820406,0.08144532044707575,3498.551232814789,393.52885365486145,2777.9072465896606,22902,5375,17527,17527,0,31,5263000.0
5263,5263999,20.933572044637497,38.38314272590586,0.08146283103943497,3499.3314037323,393.5937604904175,2777.781392097473,22906,5377,17529,17529,0,31,5264000.0
5264,5264999,20.93304392982312,38.38288465183095,0.0814626640642514,3500.318839788437,393.66066002845764,2776.519444465637,22908,5378,17530,17530,0,31,5265000.0
5265,5265999,20.932159697623938,38.381055524167444,0.08146316684703714,3500.914365053177,393.7280511856079,2777.035710334778,22910,5379,17531,17531,0,31,5266000.0
5266,5266999,20.93095067022428,38.37892247889508,0.08147145574820291,3501.3081665039062,393.79371428489685,2778.6208391189575,22912,5380,17532,17532,0,31,5267000.0
5267,5267999,20.929810141148714,38.37838381238841,0.08146589840533547,3501.8884167671204,393.8636658191681,2779.570378303528,22940,5381,17559,17559,0,31,5268000.0
5268,5268999,20.928118799117556,38.37598802563372,0.08147356038927112,3502.157160758972,393.93031764030457,2781.942837715149,22946,5381,17565,17565,0,31,5269000.0
5269,5269999,20.926915271539418,38.37485984963828,0.08147339265512732,3502.8601920604706,393.9946963787079,2781.974148750305,22959,5385,17574,17574,0,31,5270000.0
5270,5270999,20.925699761484882,38.37306073326382,0.08147998354786457,3503.35431432724,394.0587248802185,2783.150357246399,22964,5387,17577,17577,0,31,5271000.0
5271,5271999,20.924826797808095,38.37158272588918,0.08147827822331377,3503.6580476760864,394.1238989830017,2785.3832292556763,22965,5387,17578,17578,0,31,5272000.0
5272,5272999,20.923633037950804,38.36929678740592,0.08148299986319651,3504.8192055225372,394.1921491622925,2783.331456184387,22977,5393,17584,17584,0,31,5273000.0
5273,5273999,20.922577050298806,38.36796664416145,0.08147996555857828,3505.604715824127,394.2606189250946,2783.149868965149,22979,5394,17585,17585,0,31,5274000.0
5274,5274999,20.921429050460105,38.36588813511073,0.0814875764893439,3506.2207403182983,394.32941365242004,2783.738881111145,22983,5396,17587,17587,0,31,5275000.0
5275,5275999,20.920324070819817,38.36375820826524,0.08149294668186124,3506.631371974945,394.39489340782166,2785.3901796340942,22983,5396,17587,17587,0,31,5276000.0
5276,5276999,20.91961066134395,38.36482272226499,0.08148231545387119,3507.167464494705,394.4648768901825,2786.4956789016724,22985,5397,17588,17588,0,31,5277000.0
5277,5277999,20.918590812029457,38.36273366073446,0.08147690691927634,3508.1123616695404,394.5308609008789,2785.285313606262,22989,5399,17590,17590,0,31,5278000.0
5278,5278999,20.918012581428005,38.361506256601345,0.08147889783036111,3508.6150591373444,394.59829592704773,2786.3647661209106,22991,5400,17591,17591,0,31,5279000.0
5279,5279999,20.91743358968154,38.36004324820985,0.0814774545949345,3509.2991049289703,394.6633086204529,2786.662533760071,22991,5400,17591,17591,0,31,5280000.0
5280,5280999,20.917288338638198,38.36144946292933,0.08146414755812226,3509.8982701301575,394.72888588905334,2787.2507066726685,22991,5400,17591,17591,0,31,5281000.0
5281,5281999,20.91712434573969,38.36082085518426,0.0814584675698875,3510.300750732422,394.7951056957245,2788.874264717102,22991,5400,17591,17591,0,31,5282000.0
5282,5282999,20.917110875593213,38.36020940127444,0.08145255992839096,3510.6979258060455,394.85975217819214,2790.450695991516,22993,5401,17592,17592,0,31,5283000.0
5283,5283999,20.917139143619178,38.36089551785815,0.08144223956642771,3511.766917705536,394.92932653427124,2788.9369707107544,22995,5402,17593,17593,0,31,5284000.0
5284,5284999,20.917188809510716,38.360098462109256,0.08143965394855757,3512.162799358368,394.9935336112976,2790.51003742218,22998,5403,17595,17595,0,31,5285000.0
5285,5285999,20.91720442846651,38.35916551613971,0.08142941075425358,3513.2829673290253,395.0597641468048,2788.557240486145,22998,5403,17595,17595,0,31,5286000.0
5286,5286999,20.917124281005993,38.35785572700989,0.08141917911124319,3514.085015773773,395.12755703926086,2788.0550050735474,23000,5404,17596,17596,0,31,5287000.0
5287,5287999,20.916828962198952,38.35631468447797,0.08141172269235619,3515.1063175201416,395.19665336608887,2786.5552339553833,23002,5405,17597,17597,0,31,5288000.0
5288,5288999,20.915577353352734,38.35471094060459,0.0814176537982586,3515.3725533485413,395.2627754211426,2789.0968294143677,23032,5405,17627,17627,0,31,5289000.0
5289,5289999,20.913980513987678,38.352478941033596,0.08143035536760213,3515.749781847,395.3258333206177,2791.0161333084106,23040,5405,17635,17635,0,31,5290000.0
5290,5290999,20.912403965723023,38.349981555326906,0.08144628383020236,3516.2802703380585,395.3911292552948,2792.154004096985,23073,5408,17665,17665,0,31,5291000.0
5291,5291999,20.911136854282276,38.34800274120814,0.08144904305441725,3516.6789922714233,395.4562509059906,2793.8350191116333,23078,5410,17668,17668,0,31,5292000.0
5292,5292999,20.909899747175164,38.345804493446174,0.08145653468172198,3517.547364473343,395.5226380825043,2793.224431037903,23086,5414,17672,17672,0,31,5293000.0
5293,5293999,20.90852289203092,38.34395775441192,0.08145663356757737,3518.0260167121887,395.58889842033386,2794.7351274490356,23087,5414,17673,17673,0,31,5294000.0
5294,5294999,20.907581956878012,38.34229821614244,0.08145724729685355,3518.849683046341,395.65444326400757,2794.3800706863403,23091,5416,17675,17675,0,31,5295000.0
5295,5295999,20.906638859717162,38.340464926218274,0.08145675176121092,3519.540241956711,395.7190742492676,2794.70356464386,23093,5417,17676,17676,0,31,5296000.0
5296,5296999,20.90569029246792,38.338446916379084,0.08145758957027316,3520.1773722171783,395.78431367874146,2795.015820503235,23095,5418,17677,17677,0,31,5297000.0
5297,5297999,20.905031382485912,38.33728899402911,0.08145392333530876,3520.739706993103,395.85253143310547,2796.1061220169067,23095,5418,17677,17677,0,31,5298000.0
5298,5298999,20.90464412341626,38.335992279455006,0.08145027868113186,3521.348023414612,395.9197533130646,2796.699948310852,23095,5418,17677,17677,0,31,5299000.0
5299,5299999,20.90390571945928,38.33429672121281,0.08145405976379538,3521.7496201992035,395.9844801425934,2798.2393159866333,23097,5419,17678,17678,0,31,5300000.0
5300,5300999,20.90355415783117,38.333739066579376,0.08145441852787394,3522.512753009796,396.05038833618164,2798.173596382141,23097,5419,17678,17678,0,31,5301000.0
5301,5301999,20.903133490329473,38.33255110755519,0.0814543872979534,3523.2179799079895,396.11480808258057,2798.216031074524,23097,5419,17678,17678,0,31,5302000.0
5302,5302999,20.90252355802823,38.3310442784767,0.08146145307316277,3523.9505212306976,396.18051648139954,2798.2673768997192,23097,5419,17678,17678,0,31,5303000.0
5303,5303999,20.901942450283173,38.32947988450612,0.08146939175846357,3524.665261745453,396.2464647293091,2798.194546699524,23101,5421,17680,17680,0,31,5304000.0
5304,5304999,20.901095637967963,38.3272175707741,0.08148212175971825,3525.5487310886383,396.3136467933655,2797.554799079895,23105,5423,17682,17682,0,31,5305000.0
5305,5305999,20.9000175860977,38.32690002270783,0.08147912741969365,3525.710683822632,396.38016748428345,2800.6243181228638,23135,5423,17712,17712,0,31,5306000.0
5306,5306999,20.898623671816672,38.32616960250618,0.08149102748203496,3526.2060945034027,396.44476795196533,2801.796513557434,23137,5423,17714,17714,0,31,5307000.0
5307,5307999,20.897127006980394,38.32360043387282,0.08151134568495999,3526.580114364624,396.507999420166,2803.6008501052856,23142,5424,17718,17718,0,31,5308000.0
5308,5308999,20.895745998629828,38.32205145885537,0.08153002105032325,3527.321687936783,396.579030752182,2803.511311531067,23153,5428,17725,17725,0,31,5309000.0
5309,5309999,20.894210739177502,38.31949152146325,0.08154959873391843,3527.830283164978,396.6452593803406,2804.6663789749146,23155,5429,17726,17726,0,31,5310000.0
5310,5310999,20.892624907654138,38.317323816836634,0.08156390960726068,3528.34881567955,396.71140813827515,2805.7914781570435,23159,5431,17728,17728,0,31,5311000.0
5311,5311999,20.89125276012249,38.315756849636344,0.08156477255801409,3529.1653170585632,396.77646017074585,2805.3449449539185,23163,5433,17730,17730,0,31,5312000.0
5312,5312999,20.889871145846257,38.31377606437951,0.08156606705211411,3529.6873240470886,396.8414509296417,2806.4113054275513,23169,5436,17733,17733,0,31,5313000.0
5313,5313999,20.888678904772426,38.3118587993439,0.08156770026033033,3530.180333375931,396.90911841392517,2807.6697130203247,23169,5436,17733,17733,0,31,5314000.0
5314,5314999,20.88768150794851,38.31039645437022,0.08156371238536386,3530.684914827347,396.974404335022,2808.810559272766,23169,5436,17733,17733,0,31,5315000.0
5315,5315999,20.886829449716558,38.309999828453535,0.0815548087131659,3531.4824130535126,397.0391676425934,2808.527813911438,23169,5436,17733,17733,0,31,5316000.0
5316,5316999,20.885992906769133,38.309409152671726,0.08154919006723038,3532.2686491012573,397.1036624908447,2808.414463996887,23171,5437,17734,17734,0,31,5317000.0
5317,5317999,20.885355079208633,38.30842993285128,0.08153366647144811,3532.869518518448,397.1686599254608,2808.958523750305,23173,5438,17735,17735,0,31,5318000.0
5318,5318999,20.884435111955057,38.3067218031585,0.08153213436520934,3533.362590789795,397.23285484313965,2810.081883430481,23173,5438,17735,17735,0,31,5319000.0
5319,5319999,20.883681941880766,38.305161931334105,0.08152257487906478,3534.183754682541,397.3000268936157,2809.6236085891724,23173,5438,17735,17735,0,31,5320000.0
5320,5320999,20.883305923355326,38.30439821925168,0.08150896531148244,3534.9853670597076,397.3647093772888,2809.3032960891724,23173,5438,17735,17735,0,31,5321000.0
5321,5321999,20.882850505639393,38.30341934482036,0.081496622888093,3535.6270179748535,397.4293546676636,2809.7528886795044,23175,5439,17736,17736,0,31,5322000.0
5322,5322999,20.882061207743785,38.30161455081689,0.0814888050208129,3536.2728927135468,397.49484634399414,2809.9737062454224,23179,5441,17738,17738,0,31,5323000.0
5323,5323999,20.881363437028064,38.30012360186516,0.08148070004602792,3536.6841514110565,397.560879945755,2811.5341386795044,23181,5442,17739,17739,0,31,5324000.0
5324,5324999,20.88031422596198,38.29845781672586,0.08147992481215138,3537.3824558258057,397.62737560272217,2811.9600496292114,23194,5442,17752,17752,0,31,5325000.0
5325,5325999,20.879108066172815,38.29761421224723,0.0814793003311155,3537.7370269298553,397.6906077861786,2813.886685371399,23207,5442,17765,17765,0,31,5326000.0
5326,5326999,20.87786858919619,38.29588234411927,0.08148312065847352,3538.1200330257416,397.7556986808777,2815.633900642395,23217,5443,17774,17774,0,31,5327000.0
5327,5327999,20.8765371035172,38.29396950660937,0.08148713641805261,3538.9477500915527,397.81976795196533,2815.1629762649536,23224,5446,17778,17778,0,31,5328000.0
5328,5328999,20.87539027766439,38.29215154096061,0.08149226312467595,3539.450726032257,397.88428139686584,2816.3752946853638,23228,5447,17781,17781,0,31,5329000.0
5329,5329999,20.874176306574594,38.29032800385214,0.08149524576030842,3540.0341880321503,397.9488322734833,2817.306782722473,23233,5449,17784,17784,0,31,5330000.0
5330,5330999,20.872912414927903,38.28792435620007,0.081501815559885,3540.950005054474,398.01464796066284,2816.3641862869263,23238,5451,17787,17787,0,31,5331000.0
5331,5331999,20.87158453191056,38.28610529770769,0.08150542293734919,3541.517699241638,398.07838773727417,2817.288701057434,23238,5451,17787,17787,0,31,5332000.0
5332,5332999,20.870267809734514,38.283817568009454,0.08150949551244446,3542.27006149292,398.1438817977905,2817.21902179718,23245,5454,17791,17791,0,31,5333000.0
5333,5333999,20.86913829099218,38.281536815402546,0.08151438478992312,3542.6624040603638,398.2081642150879,2818.8511934280396,23245,5454,17791,17791,0,31,5334000.0
5334,5334999,20.86810995299211,38.27974263330283,0.08151778421069067,3543.280435562134,398.2723481655121,2819.4446229934692,23276,5455,17821,17821,0,31,5335000.0
5335,5335999,20.86688270792043,38.277768467004705,0.08152178210916261,3544.2417962551117,398.33900713920593,2818.2040071487427,23278,5456,17822,17822,0,31,5336000.0
5336,5336999,20.866022017251765,38.27586565736544,0.08152404688159676,3544.6559681892395,398.4061167240143,2819.6525468826294,23280,5457,17823,17823,0,31,5337000.0
5337,5337999,20.864861449250256,38.27365156536625,0.0815288117484696,3545.4798793792725,398.4709138870239,2819.05219745636,23282,5458,17824,17824,0,31,5338000.0
5338,5338999,20.86412434264572,38.27242759558023,0.08152740232619882,3546.080465555191,398.536584854126,2819.606831550598,23290,5459,17831,17831,0,31,5339000.0
5339,5339999,20.863254716185132,38.27071403154913,0.08152555367325354,3546.376090526581,398.5999207496643,2821.6927309036255,23293,5460,17833,17833,0,31,5340000.0
5340,5340999,20.862753795278984,38.26946122075701,0.08152147049935632,3547.50447845459,398.66520619392395,2819.7267656326294,23293,5460,17833,17833,0,31,5341000.0
5341,5341999,20.86210134176595,38.26792051943789,0.08152179295163986,3548.1473503112793,398.73355627059937,2820.166172981262,23295,5461,17834,17834,0,31,5342000.0
5342,5342999,20.861986149332633,38.2685636560041,0.08150811871670727,3548.722277402878,398.7984368801117,2821.0074586868286,23297,5462,17835,17835,0,31,5343000.0
5343,5343999,20.861337811687225,38.2668587699745,0.08150636264031241,3549.5343136787415,398.86422896385193,2820.532910346985,23297,5462,17835,17835,0,31,5344000.0
5344,5344999,20.86014838139698,38.26439994111415,0.08151480192375571,3550.0592007637024,398.93209862709045,2821.5599641799927,23301,5464,17837,17837,0,31,5345000.0
5345,5345999,20.859114846063093,38.26218704877225,0.08152003036371869,3550.5614104270935,398.9982991218567,2822.890294075012,23322,5464,17858,17858,0,31,5346000.0
5346,5346999,20.85749517402864,38.260085232620725,0.081531251258677,3550.827439069748,399.0630121231079,2825.2845125198364,23337,5465,17872,17872,0,31,5347000.0
5347,5347999,20.855532190312967,38.25703565549477,0.08154498491090201,3551.2048139572144,399.1292049884796,2827.0829973220825,23341,5465,17876,17876,0,31,5348000.0
5348,5348999,20.853723868808558,38.25426274372921,0.08155941975178471,3551.695685148239,399.19356060028076,2828.237973213196,23346,5467,17879,17879,0,31,5349000.0
5349,5349999,20.85223756672109,38.25231975340363,0.08156398614917892,3552.494033575058,399.2625935077667,2828.37193775177,23352,5469,17883,17883,0,31,5350000.0
5350,5350999,20.85078498578537,38.25032375207679,0.08156864751486059,3553.2027819156647,399.32718110084534,2828.580632209778,23360,5473,17887,17887,0,31,5351000.0
5351,5351999,20.84949301412493,38.24802362867488,0.08157889366068183,3553.6937890052795,399.3916366100311,2829.721318244934,23363,5474,17889,17889,0,31,5352000.0
5352,5352999,20.84815548507396,38.24619855999572,0.08158525918700787,3554.316218137741,399.45655632019043,2830.1391801834106,23368,5476,17892,17892,0,31,5353000.0
5353,5353999,20.848525291495886,38.249268044020376,0.08155369416590974,3554.9098303318024,399.52235984802246,2830.811978340149,23372,5478,17894,17894,0,31,5354000.0
5354,5354999,20.848755558208452,38.25020168617695,0.0815380613722192,3555.4309628009796,399.5899670124054,2831.720181465149,23376,5480,17896,17896,0,31,5355000.0
5355,5355999,20.849195912333975,38.251546621346726,0.08151838964869818,3555.7520840168,399.6560249328613,2833.70836353302,23378,5481,17897,17897,0,31,5356000.0
5356,5356999,20.850173003840393,38.25362041511517,0.081499840527541,3556.643886089325,399.7220187187195,2833.0354204177856,23384,5483,17901,17901,0,31,5357000.0
5357,5357999,20.851401674187905,38.25616583092781,0.08147271002041911,3557.150302171707,399.7876777648926,2834.186161994934,23386,5484,17902,17902,0,31,5358000.0
5358,5358999,20.85327609404796,38.25966649606234,0.08143826185438863,3557.640025615692,399.8527009487152,2835.413098335266,23388,5485,17903,17903,0,31,5359000.0
5359,5359999,20.855256282232368,38.26352874898131,0.0813943672285733,3558.416602373123,399.9218237400055,2835.535870552063,23390,5486,17904,17904,0,31,5360000.0
5360,5360999,20.857032101607235,38.266234103552776,0.08137432722392202,3559.3568937778473,399.9899911880493,2834.4809160232544,23401,5491,17910,17910,0,31,5361000.0
5361,5361999,20.858617878973767,38.26888905147011,0.08135270091374969,3560.1682422161102,400.05695486068726,2833.994885444641,23407,5494,17913,17913,0,31,5362000.0
5362,5362999,20.860589491933485,38.27164908905959,0.08133184907576585,3560.357739686966,400.1236147880554,2836.717915534973,23407,5494,17913,17913,0,31,5363000.0
5363,5363999,20.86181710424232,38.27295304442027,0.08131996647746553,3561.3267743587494,400.1951370239258,2835.7153902053833,23411,5496,17915,17915,0,31,5364000.0
5364,5364999,20.86237493481032,38.2726512176359,0.08131084917824549,3562.040427684784,400.26019191741943,2835.7486543655396,23413,5497,17916,17916,0,31,5365000.0
5365,5365999,20.86183367561668,38.27107618284364,0.08130721992234136,3562.5852434635162,400.32617926597595,2836.9178895950317,23434,5497,17937,17937,0,31,5366000.0
5366,5366999,20.86016608560061,38.26888824159652,0.08131861176895339,3562.7645757198334,400.3935091495514,2839.7669343948364,23440,5497,17943,17943,0,31,5367000.0
5367,5367999,20.858601963741208,38.26653776152906,0.08132618422574633,3563.257548570633,400.45821738243103,2840.9094972610474,23447,5499,17948,17948,0,31,5368000.0
5368,5368999,20.85720040777771,38.26446563903867,0.08133695165852062,3563.6481709480286,400.52294087409973,2842.5924577713013,23450,5500,17950,17950,0,31,5369000.0
5369,5369999,20.855884723948343,38.26277400752869,0.08133625238795505,3564.133697271347,400.58711552619934,2843.8919038772583,23456,5502,17954,17954,0,31,5370000.0
5370,5370999,20.854634694923003,38.260557251913525,0.08133917741129482,3565.17640209198,400.6562569141388,2842.636731147766,23468,5507,17961,17961,0,31,5371000.0
5371,5371999,20.85324095201966,38.25827858452724,0.08134661487702577,3565.8853085041046,400.7226412296295,2842.738118171692,23473,5509,17964,17964,0,31,5372000.0
5372,5372999,20.851840177617756,38.25599822511852,0.08135472448791736,3566.6701085567474,400.7868046760559,2842.4898805618286,23475,5510,17965,17965,0,31,5373000.0
5373,5373999,20.85040604162754,38.25349886448091,0.08136334728846195,3567.1634299755096,400.8505861759186,2843.619786262512,23475,5510,17965,17965,0,31,5374000.0
5374,5374999,20.849247968055707,38.25196081189888,0.08136715151394391,3567.6106917858124,400.91576194763184,2844.9666872024536,23477,5511,17966,17966,0,31,5375000.0
5375,5375999,20.847889716443632,38.2496753725088,0.08137066668140958,3568.346576690674,400.9815557003021,2844.7614946365356,23479,5512,17967,17967,0,31,5376000.0
5376,5376999,20.846779290651522,38.24774203465565,0.08137180823129653,3568.960680246353,401.04741764068604,2845.3701601028442,23479,5512,17967,17967,0,31,5377000.0
5377,5377999,20.845863531490306,38.246281176008196,0.08136790039206554,3569.4645178318024,401.11162853240967,2846.4577989578247,23479,5512,17967,17967,0,31,5378000.0
5378,5378999,20.844817174000294,38.244290245182505,0.08136529607099219,3570.286150932312,401.17771434783936,2845.8385515213013,23484,5514,17970,17970,0,31,5379000.0
5379,5379999,20.843955941162527,38.24235136564749,0.0813596395238173,3570.7638459205627,401.2412066459656,2846.9431047439575,23484,5514,17970,17970,0,31,5380000.0
5380,5380999,20.84332014360971,38.24113815571973,0.08135226665080697,3571.595714330673,401.30915212631226,2846.494320869446,23493,5515,17978,17978,0,31,5381000.0
5381,5381999,20.842830242226828,38.24003742303633,0.08134212007851482,3572.1779642105103,401.3728311061859,2847.222020149231,23495,5516,17979,17979,0,31,5382000.0
5382,5382999,20.842504927242164,38.238893858350515,0.08133390903536752,3572.82053232193,401.44449639320374,2847.875386238098,23495,5516,17979,17979,0,31,5383000.0
5383,5383999,20.842257764993345,38.23758616558604,0.08132687913878067,3573.7206292152405,401.5117869377136,2847.0695848464966,23495,5516,17979,17979,0,31,5384000.0
5384,5384999,20.8420674640052,38.23658499838412,0.0813185218832998,3574.509580373764,401.57825922966003,2846.6716508865356,23495,5516,17979,17979,0,31,5385000.0
5385,5385999,20.841350494078434,38.234825744632126,0.08131932107822637,3575.1069345474243,401.6456036567688,2847.4636430740356,23517,5517,18000,18000,0,31,5386000.0
5386,5386999,20.839901380230334,38.23327750268571,0.08132357841823246,3575.465157032013,401.71095609664917,2849.455533027649,23528,5517,18011,18011,0,31,5387000.0
5387,5387999,20.838333596076634,38.23152855298541,0.08132567882215347,3575.745890378952,401.7741320133209,2851.7104387283325,23537,5518,18019,18019,0,31,5388000.0
5388,5388999,20.837308950484953,38.23460178740646,0.08130546405471395,3576.4349772930145,401.8398108482361,2852.0116624832153,23545,5521,18024,18024,0,31,5389000.0
5389,5389999,20.83583633150457,38.23226101740794,0.08131043095515855,3576.8153183460236,401.9058780670166,2853.83922290802,23550,5522,18028,18028,0,31,5390000.0
5390,5390999,20.834775712550755,38.23021469323253,0.08130540391787533,3577.7486550807953,401.9741487503052,2853.0028200149536,23561,5526,18035,18035,0,31,5391000.0
5391,5391999,20.833623638584992,38.2279740373102,0.08130642173543445,3578.4953439235687,402.0392150878906,2853.1716051101685,23561,5526,18035,18035,0,31,5392000.0
5392,5392999,20.832655623406595,38.22629860857016,0.08130033775686807,3578.891995191574,402.1031973361969,2854.7534761428833,23565,5528,18037,18037,0,31,5393000.0
5393,5393999,20.831688819923954,38.22436479294279,0.08129538512144097,3579.4174394607544,402.1680974960327,2855.723530769348,23570,5530,18040,18040,0,31,5394000.0
5394,5394999,20.830660298031198,38.22233027860094,0.08129266969613036,3579.93049287796,402.2334122657776,2856.859440803528,23570,5530,18040,18040,0,31,5395000.0
5395,5395999,20.830149598471834,38.22111470069318,0.08128435736886441,3580.943910598755,402.30183124542236,2855.459080696106,23572,5531,18041,18041,0,31,5396000.0
5396,5396999,20.829562053235268,38.22036329267177,0.08127373912798264,3581.63627743721,402.37125515937805,2855.571499824524,23576,5533,18043,18043,0,31,5397000.0
5397,5397999,20.829174698502545,38.21936692111754,0.08126330104972135,3582.146874666214,402.44007420539856,2856.7080965042114,23576,5533,18043,18043,0,31,5398000.0
5398,5398999,20.829053965501824,38.218403809942146,0.08125180885445249,3582.560316324234,402.50754404067993,2858.3253602981567,23584,5534,18050,18050,0,31,5399000.0
5399,5399999,20.82936659400854,38.21894496052562,0.08124017008067619,3583.5301942825317,402.57811093330383,2857.3533296585083,23586,5535,18051,18051,0,31,5400000.0
5400,5400999,20.830181633635167,38.22311546943567,0.08121283987579808,3584.533828496933,402.6442265510559,2856.203694343567,23589,5536,18053,18053,0,31,5401000.0
5401,5401999,20.832484071743043,38.23456183199352,0.08116517817393598,3585.0308470726013,402.7079017162323,2857.3201570510864,23589,5536,18053,18053,0,31,5402000.0
5402,5402999,20.83430540431653,38.23882633837906,0.08114158243012737,3585.833107471466,402.77385687828064,2856.894742012024,23589,5536,18053,18053,0,31,5403000.0
5403,5403999,20.83668989642773,38.24401663142993,0.08111693439588907,3586.448331594467,402.84095072746277,2857.4448976516724,23592,5537,18055,18055,0,31,5404000.0
5404,5404999,20.838519826399104,38.24666860890292,0.08110927088644126,3587.0157730579376,402.90678238868713,2858.4285249710083,23592,5537,18055,18055,0,31,5405000.0
5405,5405999,20.840300468115004,38.24922232124348,0.08109748505034498,3587.8297011852264,402.97544407844543,2858.131749153137,23594,5538,18056,18056,0,31,5406000.0
5406,5406999,20.840620425268096,38.25014920526131,0.08108545371058351,3588.4667205810547,403.0470983982086,2859.035725593567,23628,5540,18088,18088,0,31,5407000.0
5407,5407999,20.83905296821853,38.25411101687494,0.08106504781230095,3588.6225640773773,403.1130015850067,2861.940396308899,23634,5540,18094,18094,0,31,5408000.0
5408,5408999,20.837462747783952,38.252634253724864,0.08106841950534416,3589.0139729976654,403.1789495944977,2863.6246843338013,23637,5541,18096,18096,0,31,5409000.0
5409,5409999,20.835857021779322,38.2502012800496,0.08107805619575859,3589.4008734226227,403.2447168827057,2865.4480867385864,23640,5542,18098,18098,0,31,5410000.0
5410,5410999,20.834430685583612,38.248157839782934,0.0810792756623111,3589.9081366062164,403.31116557121277,2866.542317390442,23653,5545,18108,18108,0,31,5411000.0
5411,5411999,20.833015383167552,38.24592213884584,0.08108333090726694,3590.606415748596,403.38032388687134,2867.137364387512,23660,5548,18112,18112,0,31,5412000.0
5412,5412999,20.831409623515846,38.24328903592015,0.08108766647419463,3591.3980510234833,403.445663690567,2866.9326524734497,23667,5551,18116,18116,0,31,5413000.0
5413,5413999,20.830114939376543,38.241754190223375,0.08108471197770029,3591.9183197021484,403.51027488708496,2867.801251411438,23671,5553,18118,18118,0,31,5414000.0
5414,5414999,20.828918257923785,38.2400432808952,0.08108269930055234,3592.494137763977,403.5757007598877,2868.577389717102,23671,5553,18118,18118,0,31,5415000.0
5415,5415999,20.827667850784994,38.2378381172693,0.0810808139748953,3593.086294412613,403.63912987709045,2869.191372871399,23673,5554,18119,18119,0,31,5416000.0
5416,5416999,20.826644427950736,38.23620884748808,0.08107493825608125,3593.6329510211945,403.7060577869415,2870.496464729309,23673,5554,18119,18119,0,31,5417000.0
5417,5417999,20.82559470364914,38.23409300577902,0.08107278353000813,3594.2432243824005,403.77143716812134,2871.084584236145,23673,5554,18119,18119,0,31,5418000.0
5418,5418999,20.82469805072278,38.23230118534033,0.08106867594256395,3595.076565504074,403.8422646522522,2870.6374559402466,23675,5555,18120,18120,0,31,5419000.0
5419,5419999,20.82405283067274,38.231486543454054,0.08105767692017063,3595.6768980026245,403.9093744754791,2871.2070665359497,23675,5555,18120,18120,0,31,5420000.0
5420,5420999,20.823496521802294,38.2300819107475,0.08105035395869498,3596.2325944900513,403.9741144180298,2872.1629915237427,23675,5555,18120,18120,0,31,5421000.0
5421,5421999,20.82333691013678,38.23008370469679,0.08103621130451599,3597.2170855998993,404.04367232322693,2870.9096117019653,23688,5558,18130,18130,0,31,5422000.0
5422,5422999,20.82324073145178,38.229585354106305,0.08102005748199892,3597.82324886322,404.1100432872772,2871.4725847244263,23688,5558,18130,18130,0,31,5423000.0
5423,5423999,20.823418095953276,38.229440851450036,0.08100267772563496,3598.6420245170593,404.1780252456665,2870.964337348938,23693,5560,18133,18133,0,31,5424000.0
5424,5424999,20.823614139530253,38.228792223662865,0.08098938211517803,3599.3573133945465,404.2439434528351,2871.050389289856,23693,5560,18133,18133,0,31,5425000.0
5425,5425999,20.82415202506671,38.22877581124353,0.0809779820629114,3599.7544827461243,404.3078637123108,2872.639660835266,23693,5560,18133,18133,0,31,5426000.0
5426,5426999,20.823805849491634,38.227381924507014,0.08097302690590058,3600.6705663204193,404.37319922447205,2871.6942949295044,23699,5563,18136,18136,0,31,5427000.0
5427,5427999,20.822872071503244,38.2254830956011,0.08097638291864973,3600.941994905472,404.43910098075867,2874.155415534973,23723,5563,18160,18160,0,31,5428000.0
5428,5428999,20.821493797081697,38.2239884159687,0.08098272113156268,3601.2202785015106,404.5082333087921,2876.5987215042114,23741,5563,18178,18178,0,31,5429000.0
5429,5429999,20.81990682490539,38.221934427807675,0.08099685417466951,3601.633017539978,420.3996772766113,2878.254765510559,23747,5565,18182,18182,0,31,5430000.0
5430,5430999,20.81842310644045,38.21981013066314,0.08100932067352984,3602.150547027588,420.46635270118713,2879.417981147766,23779,5568,18211,18211,0,31,5431000.0
5431,5431999,20.817030406961024,38.21746061062177,0.08101659351601631,3602.6848623752594,420.53418588638306,2880.5381746292114,23781,5569,18212,18212,0,31,5432000.0
5432,5432999,20.815724709812304,38.21490348943572,0.08102367817737288,3603.474620819092,420.6025686264038,2880.671627998352,23781,5569,18212,18212,0,31,5433000.0
5433,5433999,20.814500543941115,38.21338834002852,0.08102750519437063,3603.985319375992,420.6667470932007,2881.7671937942505,23791,5571,18220,18220,0,31,5434000.0
5434,5434999,20.813238944784842,38.21111965025826,0.08103349836283302,3604.734615087509,420.73121190071106,2881.7419023513794,23797,5573,18224,18224,0,31,5435000.0
5435,5435999,20.812279388452087,38.2130793852171,0.08102206809961088,3605.297798395157,420.79618287086487,2882.7076692581177,23797,5573,18224,18224,0,31,5436000.0
5436,5436999,20.811079184952487,38.210905980367514,0.08102852421252693,3606.035680294037,420.86123991012573,2882.6378679275513,23801,5575,18226,18226,0,31,5437000.0
5437,5437999,20.810092573789447,38.208929500391555,0.08103239244554905,3606.7008254528046,420.9265947341919,2882.974057197571,23803,5576,18227,18227,0,31,5438000.0
5438,5438999,20.80890644792393,38.206514257371495,0.08104128126613463,3607.415180683136,420.9930782318115,2882.9613695144653,23805,5577,18228,18228,0,31,5439000.0
5439,5439999,20.80787295040584,38.204353146016764,0.08104974744583093,3607.8122301101685,421.0596179962158,2884.578381538391,23805,5577,18228,18228,0,31,5440000.0
5440,5440999,20.806782647094625,38.20210909158806,0.08106088419414537,3608.7287979125977,421.1288471221924,2883.533345222473,23807,5578,18229,18229,0,31,5441000.0
5441,5441999,20.805643302059444,38.19969254603066,0.08107355999123622,3609.121896982193,421.19220423698425,2885.1233339309692,23807,5578,18229,18229,0,31,5442000.0
5442,5442999,20.804417401455193,38.19713759765602,0.08108915461421462,3609.513024330139,421.2569189071655,2886.712658882141,23807,5578,18229,18229,0,31,5443000.0
5443,5443999,20.803199833217054,38.1947050509937,0.08110155367449712,3610.2223868370056,421.32343459129333,2886.7526445388794,23829,5579,18250,18250,0,31,5444000.0
5444,5444999,20.802135991823025,38.19297759793855,0.08110768126613366,3610.8316497802734,421.39157271385193,2887.685315132141,23856,5580,18276,18276,0,31,5445000.0
5445,5445999,20.800558807176085,38.19051787349272,0.08111964299087293,3610.981862306595,421.454452753067,2890.599263191223,23863,5580,18283,18283,0,31,5446000.0
5446,5446999,20.79914831762503,38.18872905488146,0.08113078435705245,3611.3444209098816,421.51845264434814,2892.512433052063,23866,5580,18286,18286,0,31,5447000.0
5447,5447999,20.798115359331696,38.19271956696864,0.08111646902451553,3612.020683526993,421.58242630958557,2892.8276948928833,23867,5580,18287,18287,0,31,5448000.0
5448,5448999,20.79713227494642,38.19222156851675,0.08111757616479232,3612.313189268112,421.6474721431732,2895.0078554153442,23869,5581,18288,18288,0,31,5449000.0
5449,5449999,20.795819040012503,38.18963248831874,0.08112494388027247,3613.2939054965973,421.7143921852112,2893.763081550598,23875,5584,18291,18291,0,31,5450000.0
5450,5450999,20.79446928101657,38.18743053067362,0.0811285804577444,3613.703464984894,421.78038263320923,2895.2576112747192,23879,5586,18293,18293,0,31,5451000.0
5451,5451999,20.793352025459892,38.1857424959195,0.0811291747475601,3614.420761346817,421.8491430282593,2895.2693338394165,23888,5590,18298,18298,0,31,5452000.0
5452,5452999,20.792183774330685,38.183558757169386,0.08112656137679652,3614.8459689617157,421.91436672210693,2896.930520057678,23890,5591,18299,18299,0,31,5453000.0
5453,5453999,20.791067300014664,38.18168586633981,0.08112304934761061,3615.3559324741364,421.97914719581604,2897.98526096344,23892,5592,18300,18300,0,31,5454000.0
5454,5454999,20.790246013128893,38.18017295831593,0.08112053854688728,3616.1918420791626,422.0464358329773,2897.4027795791626,23896,5594,18302,18302,0,31,5455000.0
5455,5455999,20.789641982104516,38.17870718094536,0.08111158930771611,3616.9460139274597,422.1172823905945,2897.3156061172485,23900,5596,18304,18304,0,31,5456000.0
5456,5456999,20.789028926746454,38.17719333804567,0.08110462947627384,3617.347489118576,422.183162689209,2898.8852548599243,23905,5597,18308,18308,0,31,5457000.0
5457,5457999,20.788364485034922,38.17586366045848,0.08109617304616579,3617.96204328537,422.2497384548187,2899.4473428726196,23911,5599,18312,18312,0,31,5458000.0
5458,5458999,20.7881781465414,38.176465950583605,0.08109481498174753,3618.55237364769,422.31519508361816,2900.0597620010376,23911,5599,18312,18312,0,31,5459000.0
5459,5459999,20.787817214626223,38.17695912042714,0.08108490031402571,3619.280183315277,422.3815321922302,2900.245499610901,23911,5599,18312,18312,0,31,5460000.0
5460,5460999,20.78765188598057,38.17671491427782,0.08107295629624023,3620.1015214920044,422.4466829299927,2899.7031869888306,23913,5600,18313,18313,0,31,5461000.0
5461,5461999,20.787542065954327,38.175933557464894,0.0810732575812031,3620.715165376663,422.5134904384613,2900.292862892151,23913,5600,18313,18313,0,31,5462000.0
5462,5462999,20.787222597235843,38.17487699162028,0.08105892751432897,3621.3225598335266,422.57886719703674,2900.788186073303,23915,5601,18314,18314,0,31,5463000.0
5463,5463999,20.786752505602557,38.173759281443125,0.08104698072598715,3622.4131433963776,422.6462655067444,2899.0504007339478,23917,5602,18315,18315,0,31,5464000.0
5464,5464999,20.785869916536086,38.17493790872599,0.08104280801239117,3622.6785798072815,422.7402377128601,2901.686005592346,23929,5602,18327,18327,0,31,5465000.0
5465,5465999,20.784147197226062,38.17270054634871,0.08104991686290053,3623.251499414444,422.8014626502991,2902.533959388733,23936,5603,18333,18333,0,31,5466000.0
5466,5466999,20.782645520924287,38.17062457974397,0.081051927148166,3623.6174437999725,422.8613631725311,2904.2711114883423,23940,5603,18337,18337,0,31,5467000.0
5467,5467999,20.781373128309465,38.16928148535441,0.0810529125767755,3624.2800765037537,422.9220325946808,2904.544960975647,23946,5603,18343,18343,0,31,5468000.0
5468,5468999,20.779892233007455,38.16674726132778,0.0810588660806073,3624.8757181167603,422.9837372303009,2905.115258216858,23953,5605,18348,18348,0,31,5469000.0
5469,5469999,20.77866847719791,38.164729981378564,0.08105829591084934,3625.7012317180634,423.04643297195435,2904.518578529358,23963,5608,18355,18355,0,31,5470000.0
5470,5470999,20.77752076409562,38.1628597472373,0.0810564428841326,3626.2967026233673,423.10765624046326,2905.0127725601196,23966,5609,18357,18357,0,31,5471000.0
5471,5471999,20.776320917015042,38.16067437211961,0.08105769989215161,3626.6758053302765,423.1688106060028,2906.7127771377563,23968,5609,18359,18359,0,31,5472000.0
5472,5472999,20.77518525374005,38.15866391073747,0.08105671130276582,3627.361015319824,423.2300543785095,2906.752297401428,23971,5610,18361,18361,0,31,5473000.0
5473,5473999,20.774226819586126,38.15697808354008,0.08105566470723014,3628.138480901718,423.2924427986145,2906.5846643447876,23979,5611,18368,18368,0,31,5474000.0
5474,5474999,20.77306034537943,38.15468821787357,0.08105655780323573,3628.94473361969,423.35465145111084,2906.108811378479,23981,5612,18369,18369,0,31,5475000.0
5475,5475999,20.77231812096969,38.152909092218266,0.08105400093170645,3629.640243768692,423.4176256656647,2906.314652442932,23982,5612,18370,18370,0,31,5476000.0
5476,5476999,20.771296009384766,38.15087445268896,0.08105820111390216,3630.2544157505035,423.48046588897705,2906.869408607483,23982,5612,18370,18370,0,31,5477000.0
5477,5477999,20.770505593054285,38.149950821669854,0.08105394328771576,3631.0359468460083,423.5446672439575,2906.6231775283813,23983,5613,18370,18370,0,31,5478000.0
5478,5478999,20.76964664857783,38.14795856750489,0.08105785716514347,3631.653898715973,423.60940170288086,2907.113610267639,23984,5614,18370,18370,0,31,5479000.0
5479,5479999,20.768667127503804,38.14615713376521,0.08106038534471849,3632.3180203437805,423.67449402809143,2907.4813623428345,23984,5614,18370,18370,0,31,5480000.0
5480,5480999,20.767790684875205,38.144294576584734,0.08106231470864111,3633.1756434440613,423.738454580307,2906.716546058655,23986,5615,18371,18371,0,31,5481000.0
5481,5481999,20.766762826706366,38.14212191719343,0.08106976289991907,3633.7867410182953,423.8018972873688,2907.268738746643,23986,5615,18371,18371,0,31,5482000.0
5482,5482999,20.765819799468566,38.1403004171719,0.08107254066524727,3634.404556751251,423.8656425476074,2907.810975074768,23986,5615,18371,18371,0,31,5483000.0
5483,5483999,20.764553156133875,38.13793575036285,0.08107997661059607,3635.0198979377747,423.93368673324585,2908.2241525650024,23987,5616,18371,18371,0,31,5484000.0
5484,5484999,20.76316731644533,38.135361403476125,0.08108737468188076,3635.720234632492,423.99932193756104,2908.2952432632446,23987,5616,18371,18371,0,31,5485000.0
5485,5485999,20.762159127246104,38.133608118255644,0.08109220960743857,3636.308956861496,424.0646150112152,2908.9477548599243,23997,5617,18380,18380,0,31,5486000.0
5486,5486999,20.760373788375723,38.130878841722094,0.0811056523795054,3636.792101621628,424.1310350894928,2910.169144630432,24004,5617,18387,18387,0,31,5487000.0
5487,5487999,20.759119241102667,38.13138344529731,0.0810968613117331,3637.2974002361298,424.19781160354614,2911.334107398987,24007,5617,18390,18390,0,31,5488000.0
5488,5488999,20.757727165362176,38.129043168724515,0.08110663786100136,3637.7770385742188,424.2627160549164,2912.674683570862,24024,5618,18406,18406,0,31,5489000.0
5489,5489999,20.756734748336907,38.12741137354603,0.0811055285538177,3638.350641489029,424.3278033733368,2913.544182777405,24029,5620,18409,18409,0,31,5490000.0
5490,5490999,20.756092046151934,38.12653414197062,0.08109942299791151,3638.9207096099854,424.3946874141693,2914.461884498596,24032,5621,18411,18411,0,31,5491000.0
5491,5491999,20.755066924458784,38.12439499269055,0.08110254709711695,3639.2141919136047,424.4599938392639,2916.6807794570923,24033,5621,18412,18412,0,31,5492000.0
5492,5492999,20.754294648195764,38.1229405616074,0.08110440813660891,3639.818465948105,424.52584433555603,2917.2610483169556,24036,5622,18414,18414,0,31,5493000.0
5493,5493999,20.753485448265067,38.12113126663289,0.08110700400600379,3640.4956431388855,424.59053778648376,2917.3587045669556,24036,5622,18414,18414,0,31,5494000.0
5494,5494999,20.75291108957927,38.11948354670915,0.08110833539556017,3640.8832819461823,424.65526509284973,2918.9871377944946,24036,5622,18414,18414,0,31,5495000.0
5495,5495999,20.752300345110772,38.11812697802017,0.08110777721457041,3641.798458337784,424.7211742401123,2917.784951210022,24040,5624,18416,18416,0,31,5496000.0
5496,5496999,20.752066988092157,38.11720926597924,0.08110483415289405,3642.7159628868103,424.7891240119934,2916.8385858535767,24049,5625,18424,18424,0,31,5497000.0
5497,5497999,20.751604875845043,38.11598408031282,0.08110157991798261,3643.757384300232,424.857106924057,2915.0524682998657,24051,5626,18425,18425,0,31,5498000.0
5498,5498999,20.751076094023578,38.11464613972983,0.08110196020442795,3644.2640419006348,424.9241716861725,2916.113366127014,24053,5627,18426,18426,0,31,5499000.0
5499,5499999,20.7509038944874,38.116488458770526,0.0810911008848727,3644.859184026718,424.9896342754364,2916.7090158462524,24053,5627,18426,18426,0,31,5500000.0
5500,5500999,20.750678338125358,38.12265807414417,0.08106817489831752,3645.371740102768,425.05660605430603,2917.781937599182,24053,5627,18426,18426,0,31,5501000.0
5501,5501999,20.750097122072766,38.12134240183122,0.08106700136831346,3646.1667108535767,425.1245803833008,2917.385521888733,24053,5627,18426,18426,0,31,5502000.0
5502,5502999,20.74964071553504,38.119762325173525,0.08106793946473623,3646.576293706894,425.19191551208496,2918.8664331436157,24055,5628,18427,18427,0,31,5503000.0
5503,5503999,20.748959099590653,38.11794342151662,0.08106324825210132,3647.504329442978,425.26141810417175,2917.7787714004517,24059,5630,18429,18429,0,31,5504000.0
5504,5504999,20.748138349362495,38.115732752837125,0.08106609244348306,3648.007920742035,425.3282525539398,2918.829712867737,24061,5631,18430,18430,0,31,5505000.0
5505,5505999,20.747248558547508,38.11367065862386,0.08106896296529786,3648.7127039432526,425.39499044418335,2919.036591529846,24070,5631,18439,18439,0,31,5506000.0
5506,5506999,20.745803243602982,38.11166153424713,0.08107046473494717,3648.8857278823853,425.46281719207764,2921.7881021499634,24075,5631,18444,18444,0,31,5507000.0
5507,5507999,20.74450245026789,38.11005850756042,0.08106461044475055,3649.584475517273,425.5282623767853,2922.0945978164673,24078,5632,18446,18446,0,31,5508000.0
5508,5508999,20.743272769307243,38.10798921862401,0.08107100934920519,3650.396646261215,425.5943727493286,2921.689423561096,24079,5632,18447,18447,0,31,5509000.0
5509,5509999,20.742060845882165,38.105848028283596,0.08107612631654415,3650.788748025894,425.66012835502625,2923.318932533264,24081,5632,18449,18449,0,31,5510000.0
5510,5510999,20.740633553953423,38.103220096305485,0.0810829308547617,3651.4859251976013,425.7265625,2923.603569984436,24085,5634,18451,18451,0,31,5511000.0
5511,5511999,20.739210437929735,38.10063764302446,0.08108948751175493,3652.094876766205,425.79267168045044,2924.1897592544556,24085,5634,18451,18451,0,31,5512000.0
5512,5512999,20.73791479190022,38.09852400461616,0.0810931673164853,3653.1129653453827,425.8589611053467,2922.766457557678,24094,5635,18459,18459,0,31,5513000.0
5513,5513999,20.736525457016302,38.09598977184442,0.08109812199339506,3653.6278495788574,425.9268090724945,2923.7972803115845,24096,5636,18460,18460,0,31,5514000.0
5514,5514999,20.735247568781983,38.09339857042988,0.08110614601477772,3654.253697156906,425.99288988113403,2924.255539894104,24098,5637,18461,18461,0,31,5515000.0
5515,5515999,20.734803273319077,38.107785913834675,0.08103533713646938,3654.939532995224,426.0591371059418,2924.6270608901978,24098,5637,18461,18461,0,31,5516000.0
5516,5516999,20.73377714639036,38.10552491544977,0.08103700143813175,3655.4761028289795,426.12727546691895,2925.6440286636353,24098,5637,18461,18461,0,31,5517000.0
5517,5517999,20.732896264140177,38.10352721812912,0.08103522734498092,3656.079704761505,426.1953854560852,2926.190957069397,24100,5638,18462,18462,0,31,5518000.0
5518,5518999,20.7317459627343,38.10133545383728,0.08103696301568186,3656.6927371025085,426.2620711326599,2926.743752479553,24100,5638,18462,18462,0,31,5519000.0
5519,5519999,20.73092813191998,38.10103004647229,0.08102801289753936,3657.2945144176483,426.3288903236389,2927.260910987854,24102,5639,18463,18463,0,31,5520000.0
5520,5520999,20.730340365908276,38.09990963872474,0.08101795334016904,3658.4051711559296,426.39666056632996,2925.412079811096,24102,5639,18463,18463,0,31,5521000.0
5521,5521999,20.729752505144038,38.098918850209635,0.08101187325393822,3658.9916174411774,426.4652473926544,2926.2240381240845,24102,5639,18463,18463,0,31,5522000.0
5522,5522999,20.72905356126708,38.09731773519163,0.0810080841394083,3659.500574827194,426.5332775115967,2927.1825952529907,24106,5641,18465,18465,0,31,5523000.0
5523,5523999,20.72850172775506,38.09594363873461,0.08100301333514759,3660.3234720230103,426.60198616981506,2926.737763404846,24106,5641,18465,18465,0,31,5524000.0
5524,5524999,20.727720531445705,38.094288416326755,0.08100088246806314,3660.9354588985443,426.67258310317993,2927.259644508362,24108,5642,18466,18466,0,31,5525000.0
5525,5525999,20.7267307271797,38.09212585539616,0.08100259247700758,3661.575700521469,426.7412917613983,2928.0786447525024,24174,5644,18530,18530,0,31,5526000.0
5526,5526999,20.725782552663325,38.09031810947665,0.08100044223399594,3662.326080799103,426.80704975128174,2928.205864906311,24186,5645,18541,18541,0,31,5527000.0
5527,5527999,20.72477325770536,38.088313832668845,0.08099488508783592,3662.9128272533417,426.87369894981384,2928.968071937561,24194,5645,18549,18549,0,31,5528000.0
5528,5528999,20.723892434171912,38.08659646223173,0.08099171195907784,3663.634016752243,426.94020771980286,2929.0769357681274,24198,5646,18552,18552,0,31,5529000.0
5529,5529999,20.723151708328746,38.08476925749419,0.08098777828548542,3664.022569656372,427.00698804855347,2930.747254371643,24200,5646,18554,18554,0,31,5530000.0
5530,5530999,20.72244753062681,38.084736392837165,0.08097433834327283,3664.7440111637115,427.0749521255493,2930.8475885391235,24202,5646,18556,18556,0,31,5531000.0
5531,5531999,20.72152011054187,38.08272033274064,0.08097333013418428,3665.5538458824158,427.1419508457184,2930.498772621155,24202,5646,18556,18556,0,31,5532000.0
5532,5532999,20.7204453396415,38.08049404806885,0.08097348149016026,3665.9543521404266,427.2088978290558,2932.0272150039673,24205,5647,18558,18558,0,31,5533000.0
5533,5533999,20.71943363979774,38.07856586834435,0.08097538545023708,3666.6100130081177,427.2781729698181,2932.505700111389,24205,5647,18558,18558,0,31,5534000.0
5534,5534999,20.71833724455332,38.07630139909169,0.08097731196015745,3667.3286242485046,427.34517073631287,2932.520157814026,24208,5648,18560,18560,0,31,5535000.0
5535,5535999,20.71762249886177,38.07449675748515,0.080975114487156,3667.6288158893585,427.41195845603943,2934.6380548477173,24208,5648,18560,18560,0,31,5536000.0
5536,5536999,20.716868651565726,38.072749483539724,0.0809751965272768,3668.8496918678284,427.48037028312683,2932.2724466323853,24210,5649,18561,18561,0,31,5537000.0
5537,5537999,20.715999167995236,38.0708177271504,0.08097453550106182,3669.2456364631653,427.54645013809204,2933.8660593032837,24210,5649,18561,18561,0,31,5538000.0
5538,5538999,20.71538343554468,38.069345976472945,0.08096843972396806,3669.847372531891,427.6150770187378,2934.4160776138306,24210,5649,18561,18561,0,31,5539000.0
5539,5539999,20.71462945667349,38.06789885817624,0.08096548275898141,3670.5512442588806,427.6826117038727,2934.4338006973267,24212,5650,18562,18562,0,31,5540000.0
5540,5540999,20.714160771414306,38.06692231477345,0.0809581484448082,3671.1538977622986,427.7535855770111,2935.025475502014,24221,5651,18570,18570,0,31,5541000.0
5541,5541999,20.713522811078764,38.06540466310778,0.08095447585636117,3671.8721590042114,427.8219881057739,2935.052834510803,24221,5651,18570,18570,0,31,5542000.0
5542,5542999,20.712988676117728,38.06387642533109,0.08095065068725604,3672.7633724212646,427.89520931243896,2934.3001108169556,24221,5651,18570,18570,0,31,5543000.0
5543,5543999,20.71281703826821,38.062772789134904,0.08094035524038357,3673.170892238617,427.96715474128723,2935.8629693984985,24221,5651,18570,18570,0,31,5544000.0
5544,5544999,20.71235036341054,38.06149849100109,0.08093189307195503,3673.67578792572,428.0366654396057,2936.894310951233,24221,5651,18570,18570,0,31,5545000.0
5545,5545999,20.711799233686744,38.0599512271542,0.08092408015930985,3674.5116941928864,428.1068251132965,2936.3171167373657,24221,5651,18570,18570,0,31,5546000.0
5546,5546999,20.711031066952007,38.058169923919934,0.08091916476173622,3675.3482184410095,428.1766276359558,2935.6174936294556,24223,5652,18571,18571,0,31,5547000.0
5547,5547999,20.710186017851132,38.056238229212866,0.08091530251913748,3676.3443746566772,428.2432463169098,2934.3424768447876,24229,5652,18577,18577,0,31,5548000.0
5548,5548999,20.709202902867805,38.05526332811356,0.08090626474041529,3676.967318534851,428.3146393299103,2935.007561683655,24233,5652,18581,18581,0,31,5549000.0
5549,5549999,20.708280848999348,38.053190778240335,0.08090086851593559,3677.6743364334106,428.3833200931549,2935.365693092346,24234,5652,18582,18582,0,31,5550000.0
5550,5550999,20.70739621554266,38.05105718530164,0.08089674000929115,3678.16889500618,428.45082354545593,2936.688286781311,24237,5653,18584,18584,0,31,5551000.0
5551,5551999,20.706572398094757,38.04911172101465,0.0808910697908245,3678.790032148361,428.5198485851288,2937.286316871643,24238,5653,18585,18585,0,31,5552000.0
5552,5552999,20.705600837652614,38.04683845827723,0.08088948751139424,3679.5615339279175,428.5893316268921,2937.0313425064087,24242,5655,18587,18587,0,31,5553000.0
5553,5553999,20.704675923033125,38.04476492188687,0.08088680043071195,3680.2069466114044,428.6578414440155,2937.4048776626587,24244,5656,18588,18588,0,31,5554000.0
5554,5554999,20.703781941868176,38.042851826669,0.08088429627589555,3680.847897052765,428.72768568992615,2938.000542640686,24244,5656,18588,18588,0,31,5555000.0
5555,5555999,20.70289597048796,38.04074084236766,0.08088239595941438,3681.356921672821,428.7945673465729,2939.092942237854,24244,5656,18588,18588,0,31,5556000.0
5556,5556999,20.702300643771657,38.03912262713405,0.08087707514814979,3681.9661774635315,428.86191058158875,2939.659447669983,24244,5656,18588,18588,0,31,5557000.0
5557,5557999,20.701885407572828,38.03796383841324,0.0808690469108313,3682.6996154785156,428.93013739585876,2939.6821603775024,24246,5657,18589,18589,0,31,5558000.0
5558,5558999,20.70196096494936,38.038201707103134,0.08085324381529924,3683.4321920871735,429.0002534389496,2939.740014076233,24246,5657,18589,18589,0,31,5559000.0
5559,5559999,20.701927997946996,38.0372371941699,0.08084100156910157,3684.28338265419,429.07410526275635,2939.1786584854126,24249,5658,18591,18591,0,31,5560000.0
5560,5560999,20.70175150516087,38.036374985783766,0.08082996235031747,3684.897627592087,429.14312648773193,2939.735321998596,24249,5658,18591,18591,0,31,5561000.0
5561,5561999,20.702035238687863,38.03654603332892,0.08081332912137429,3685.5382719039917,429.21220779418945,2940.0853509902954,24252,5659,18593,18593,0,31,5562000.0
5562,5562999,20.702722213451388,38.03728264756924,0.08079689334521423,3686.0493943691254,429.28443598747253,2941.14883518219,24252,5659,18593,18593,0,31,5563000.0
5563,5563999,20.703117940694668,38.037059879505264,0.08078261621721294,3686.870698928833,429.3523678779602,2940.679902076721,24252,5659,18593,18593,0,31,5564000.0
5564,5564999,20.70383784407649,38.03740362702724,0.0807665137629141,3687.5794048309326,429.42312836647034,2940.699372291565,24252,5659,18593,18593,0,31,5565000.0
5565,5565999,20.704199613725862,38.036982092449335,0.08075505218421763,3687.9907264709473,429.49444246292114,2942.2550592422485,24252,5659,18593,18593,0,31,5566000.0
5566,5566999,20.704437372734002,38.03639249517328,0.08074365676601292,3688.8261590003967,429.5671682357788,2941.7751092910767,24252,5659,18593,18593,0,31,5567000.0
5567,5567999,20.704429220269823,38.035262609275634,0.08073568938156317,3689.748722076416,429.63685846328735,2940.7637186050415,24261,5660,18601,18601,0,31,5568000.0
5568,5568999,20.703625267731304,38.03343259104836,0.0807386439835649,3690.1534864902496,429.70824098587036,2942.5276498794556,24280,5661,18619,18619,0,31,5569000.0
5569,5569999,20.702691689078527,38.03192000567928,0.08073563413327378,3690.538665533066,429.77616572380066,2944.3745889663696,24292,5661,18631,18631,0,31,5570000.0
5570,5570999,20.701547069544226,38.02985655106609,0.08074209295214041,3691.016763448715,429.8456144332886,2945.7189798355103,24297,5662,18635,18635,0,31,5571000.0
5571,5571999,20.700800157632184,38.02835456722461,0.08074409696192553,3691.6207373142242,429.91307520866394,2946.405716896057,24300,5663,18637,18637,0,31,5572000.0
5572,5572999,20.700009554066874,38.02658961177658,0.08074562137815755,3692.0204696655273,429.98091316223145,2948.1111001968384,24300,5663,18637,18637,0,31,5573000.0
5573,5573999,20.699069767440566,38.024843045487835,0.0807474944595814,3692.6639029979706,430.04864597320557,2948.488778114319,24304,5665,18639,18639,0,31,5574000.0
5574,5574999,20.697975234251853,38.022869471694335,0.08075148314360792,3693.3799068927765,430.11967062950134,2948.544045448303,24306,5666,18640,18640,0,31,5575000.0
5575,5575999,20.69698139988613,38.02092977047652,0.08075102311170712,3693.8710227012634,430.1871728897095,2949.677124977112,24306,5666,18640,18640,0,31,5576000.0
5576,5576999,20.695947801109376,38.01875798075347,0.08075612721656833,3694.4814524650574,430.2556736469269,2950.2591638565063,24315,5667,18648,18648,0,31,5577000.0
5577,5577999,20.694942127613295,38.01687200398317,0.08075646692462235,3695.2136058807373,430.3251407146454,2950.397599220276,24315,5667,18648,18648,0,31,5578000.0
5578,5578999,20.69429430392814,38.017277891726614,0.08074805555007791,3695.7320926189423,430.392370223999,2951.4955377578735,24315,5667,18648,18648,0,31,5579000.0
5579,5579999,20.69322704006161,38.014938726280256,0.08075270315491101,3696.8467195034027,430.4619164466858,2949.641251564026,24317,5668,18649,18649,0,31,5580000.0
5580,5580999,20.692422586640905,38.013141115395435,0.08075502985423855,3697.453719854355,430.5305759906769,2950.220803260803,24317,5668,18649,18649,0,31,5581000.0
5581,5581999,20.691708953707366,38.01102908942321,0.08075966071911644,3698.3842685222626,430.60147166252136,2949.2127923965454,24317,5668,18649,18649,0,31,5582000.0
5582,5582999,20.69125234813419,38.009834871462076,0.08076300660953617,3698.999223470688,430.6720073223114,2949.7086038589478,24321,5669,18652,18652,0,31,5583000.0
5583,5583999,20.690334186109755,38.00754945179127,0.08077446913156305,3699.6131994724274,430.74210929870605,2950.2582788467407,24321,5669,18652,18652,0,31,5584000.0
5584,5584999,20.689389720446034,38.005306794235565,0.08078159506638882,3700.3364503383636,430.8110547065735,2950.19766330719,24326,5670,18656,18656,0,31,5585000.0
5585,5585999,20.688468931707018,38.00391411923234,0.08078446207055123,3700.7273104190826,430.87988328933716,2952.0091485977173,24344,5671,18673,18673,0,31,5586000.0
5586,5586999,20.687516648217784,38.00292508792875,0.08078590013105436,3700.9951972961426,430.9463095664978,2954.3123483657837,24346,5671,18675,18675,0,31,5587000.0
5587,5587999,20.686465012136637,38.00099264756211,0.08079868324721806,3701.4901881217957,431.0157687664032,2955.707489967346,24351,5672,18679,18679,0,31,5588000.0
5588,5588999,20.685264751329225,37.998883718640556,0.0808123780560488,3701.786068677902,431.08478021621704,2957.929841041565,24352,5672,18680,18680,0,31,5589000.0
5589,5589999,20.684332500391015,37.997321822989335,0.08081683982529408,3702.398918390274,431.15351915359497,2958.547532081604,24354,5673,18681,18681,0,31,5590000.0
5590,5590999,20.683143926480334,37.99557377523666,0.08082119836654755,3703.422003507614,431.22464394569397,2957.135598182678,24358,5675,18683,18683,0,31,5591000.0
5591,5591999,20.68207900339346,37.99352106353494,0.08082596898030292,3703.931202173233,431.2911174297333,2958.2115182876587,24362,5677,18685,18685,0,31,5592000.0
5592,5592999,20.680996790418515,37.99151651810323,0.08082638424199562,3704.475801706314,431.3663010597229,2959.272271156311,24368,5678,18690,18690,0,31,5593000.0
5593,5593999,20.68001528630701,37.98956555732317,0.08082730474858102,3704.9915647506714,431.4374165534973,2960.4177103042603,24368,5678,18690,18690,0,31,5594000.0
5594,5594999,20.67935436334996,37.988637397740824,0.08081951207462323,3705.726269721985,431.50575613975525,2960.38036441803,24370,5679,18691,18691,0,31,5595000.0
5595,5595999,20.678596642333634,37.98684235283489,0.08081506115509696,3706.5733835697174,431.57570576667786,2959.923035621643,24372,5680,18692,18692,0,31,5596000.0
5596,5596999,20.677879134716175,37.98554350562823,0.0808077171131113,3707.069626569748,431.64348340034485,2961.033585548401,24372,5680,18692,18692,0,31,5597000.0
5597,5597999,20.677370914309325,37.98458220788537,0.08079558920456609,3707.6780552864075,431.71073722839355,2961.611023902893,24372,5680,18692,18692,0,31,5598000.0
5598,5598999,20.67696488387727,37.983239366617276,0.08078507315471462,3708.896699666977,431.78007316589355,2959.08682346344,24374,5681,18693,18693,0,31,5599000.0
5599,5599999,20.676375964263382,37.982064788330014,0.0807747641384966,3709.501562356949,431.8469831943512,2959.7598428726196,24374,5681,18693,18693,0,31,5600000.0
5600,5600999,20.67593874687471,37.980788933807624,0.08076402524639514,3710.0006506443024,431.91548466682434,2960.83340549469,24374,5681,18693,18693,0,31,5601000.0
5601,5601999,20.675860488130816,37.98135124640782,0.08074405921222905,3710.818056821823,431.9848141670227,2960.3319025039673,24374,5681,18693,18693,0,31,5602000.0
5602,5602999,20.675361716225026,37.97983344137432,0.08073472449897534,3711.3141350746155,432.0574505329132,2961.4933862686157,24374,5681,18693,18693,0,31,5603000.0
5603,5603999,20.674882877921256,37.97835714487536,0.08072585907743313,3711.7218511104584,432.13000988960266,2963.056908607483,24374,5681,18693,18693,0,31,5604000.0
5604,5604999,20.674503568357782,37.977122334531,0.08071361047245995,3712.3953540325165,432.1980314254761,2963.3984231948853,24374,5681,18693,18693,0,31,5605000.0
5605,5605999,20.673867323442547,37.977480452377584,0.08067593222647063,3712.9990134239197,432.26749181747437,2964.0167779922485,24387,5682,18705,18705,0,31,5606000.0
5606,5606999,20.672662937996602,37.975843612371605,0.08067558343155101,3713.3908236026764,432.3337228298187,2965.822030067444,24392,5682,18710,18710,0,31,5607000.0
5607,5607999,20.67166624306825,37.97424012326521,0.0806813993405483,3713.975549697876,432.40141248703003,2966.558922767639,24395,5683,18712,18712,0,31,5608000.0
5608,5608999,20.670670485532064,37.97234870112942,0.08068621766611916,3714.456314086914,432.4673697948456,2967.8600854873657,24397,5683,18714,18714,0,31,5609000.0
5609,5609999,20.669868223695577,37.97064770143873,0.08068680150669483,3715.1657903194427,432.53401827812195,2968.0216302871704,24400,5684,18716,18716,0,31,5610000.0
5610,5610999,20.669174137297446,37.96915470445876,0.08068619644450481,3716.0086581707,432.60467767715454,2967.373703956604,24404,5686,18718,18718,0,31,5611000.0
5611,5611999,20.66845579460827,37.96756142409933,0.08068445749876307,3716.7478630542755,432.6734969615936,2967.320321083069,24413,5690,18723,18723,0,31,5612000.0
5612,5612999,20.667816336064117,37.96619936735209,0.08068759306093021,3717.2645881175995,432.7453181743622,2968.4914026260376,24413,5690,18723,18723,0,31,5613000.0
5613,5613999,20.66740265582567,37.965217936426114,0.08068832594968367,3717.9906647205353,432.81264424324036,2968.5317163467407,24420,5691,18729,18729,0,31,5614000.0
5614,5614999,20.667108202196836,37.96423052057136,0.0806880396106231,3718.3935005664825,432.8793535232544,2970.2392740249634,24420,5691,18729,18729,0,31,5615000.0
5615,5615999,20.666684830068814,37.96291840059457,0.08068897340861947,3719.0154321193695,432.94887804985046,2970.8119974136353,24422,5692,18730,18730,0,31,5616000.0
5616,5616999,20.66642147809247,37.96243322178664,0.08069117678085069,3719.723682641983,433.0153453350067,2970.894013404846,24422,5692,18730,18730,0,31,5617000.0
5617,5617999,20.666321873132308,37.96388147872116,0.0806759081804419,3720.453408718109,433.08557510375977,2970.974076271057,24422,5692,18730,18730,0,31,5618000.0
5618,5618999,20.66669408422866,37.96493281343767,0.08066873067212588,3721.397394657135,433.15462017059326,2969.7763986587524,24424,5693,18731,18731,0,31,5619000.0
5619,5619999,20.666873490266937,37.96460760801211,0.08066287164110286,3721.8038790225983,433.22119402885437,2971.381302833557,24424,5693,18731,18731,0,31,5620000.0
5620,5620999,20.66738270888824,37.96427600176589,0.0806523248594887,3722.4106035232544,433.29156255722046,2971.934250831604,24424,5693,18731,18731,0,31,5621000.0
5621,5621999,20.668001595865974,37.96434944504946,0.08064911599135949,3722.9150738716125,433.3614344596863,2973.081986427307,24424,5693,18731,18731,0,31,5622000.0
5622,5622999,20.668646189965873,37.964479348260284,0.08063970622619121,3723.78271317482,433.43409848213196,2972.8058862686157,24497,5696,18801,18801,0,31,5623000.0
5623,5623999,20.66905553905218,37.96415614343793,0.0806296191626017,3724.1785593032837,433.5018355846405,2974.5759286880493,24497,5696,18801,18801,0,31,5624000.0
5624,5624999,20.669412802181185,37.96352130166541,0.0806300138697067,3724.6845564842224,433.57062244415283,2975.661217689514,24501,5698,18803,18803,0,31,5625000.0
5625,5625999,20.668872459834375,37.961676100806265,0.08062453709032447,3725.4990487098694,433.63782930374146,2975.2242975234985,24501,5698,18803,18803,0,31,5626000.0
5626,5626999,20.667629618061838,37.96050495425322,0.08062993134963103,3725.8785603046417,433.70564889907837,2977.201371192932,24521,5699,18822,18822,0,31,5627000.0
5627,5627999,20.66619172614905,37.95804229676071,0.08063566236817232,3726.049801826477,433.772057056427,2979.9925088882446,24525,5699,18826,18826,0,31,5628000.0
5628,5628999,20.66497272601612,37.956421648700015,0.08064238695110049,3726.7551045417786,433.84000635147095,2980.5127267837524,24592,5700,18892,18892,0,31,5629000.0
5629,5629999,20.663600675452532,37.95391788462619,0.080655948918538,3727.146022081375,433.9070568084717,2982.259118080139,24602,5701,18901,18901,0,31,5630000.0
5630,5630999,20.662396954819954,37.952150615882836,0.08065971233837732,3727.550744533539,433.97435545921326,2983.9565286636353,24605,5702,18903,18903,0,31,5631000.0
5631,5631999,20.661129672876072,37.94981526795976,0.08066807977286028,3728.3261675834656,434.04314374923706,2983.9059686660767,24605,5702,18903,18903,0,31,5632000.0
5632,5632999,20.659668624755007,37.94717774230802,0.08067735559312672,3728.9997022151947,434.1110415458679,2984.396737098694,24606,5702,18904,18904,0,31,5633000.0
5633,5633999,20.658303984950496,37.94459103663463,0.08068586868045113,3729.8092923164368,434.1786596775055,2984.167550086975,24672,5705,18967,18967,0,31,5634000.0
5634,5634999,20.657338304378012,37.94276451877268,0.08068683297363832,3730.4032685756683,434.2473599910736,2984.8358697891235,24672,5705,18967,18967,0,31,5635000.0
5635,5635999,20.65692086781655,37.94214146773702,0.08068235800426948,3731.0756709575653,434.32275223731995,2985.414734840393,24672,5705,18967,18967,0,31,5636000.0
5636,5636999,20.65697456439263,37.94319990981291,0.08066900386678555,3731.9443938732147,434.3909924030304,2984.8688287734985,24672,5705,18967,18967,0,31,5637000.0
5637,5637999,20.657170694500646,37.94391161856256,0.08065117863730376,3732.622368812561,434.46500396728516,2985.047371864319,24674,5706,18968,18968,0,31,5638000.0
5638,5638999,20.658242578698726,37.94895424822541,0.0806160545932817,3733.133705854416,434.5335683822632,2986.132668495178,24676,5707,18969,18969,0,31,5639000.0
5639,5639999,20.660195330824944,37.956293133764554,0.08056870362752,3733.527337551117,434.60255432128906,2987.748261451721,24676,5707,18969,18969,0,31,5640000.0
5640,5640999,20.662205163140804,37.963658234210314,0.08052921793662315,3734.238174200058,434.6717667579651,2988.140206336975,24676,5707,18969,18969,0,31,5641000.0
5641,5641999,20.66411683243062,37.969255378256655,0.08049588848708211,3734.979711532593,434.7458357810974,2988.198655128479,24676,5707,18969,18969,0,31,5642000.0
5642,5642999,20.667303757891585,37.97961394995349,0.08044726690299997,3735.5902915000916,434.8188614845276,2988.634476661682,24678,5708,18970,18970,0,31,5643000.0
5643,5643999,20.669682262168514,37.986927804837514,0.08041476122005997,3736.0992588996887,434.8876042366028,2989.691529273987,24678,5708,18970,18970,0,31,5644000.0
5644,5644999,20.67178277655417,37.99192541155894,0.08040620925366482,3736.7058386802673,434.9577307701111,2990.2180795669556,24680,5709,18971,18971,0,31,5645000.0
5645,5645999,20.67285486450983,37.994189060677776,0.08039598740677845,3737.518784046173,435.02528500556946,2989.8539667129517,24680,5709,18971,18971,0,31,5646000.0
5646,5646999,20.6721454969711,37.99404481776025,0.08039845575261229,3737.7824976444244,435.0937831401825,2992.3412942886353,24698,5710,18988,18988,0,31,5647000.0
5647,5647999,20.670874918054725,37.992919089038324,0.08040078139868789,3738.271106004715,435.1617178916931,2993.6576013565063,24703,5710,18993,18993,0,31,5648000.0
5648,5648999,20.66955979447572,37.9912395508325,0.08040862309230645,3738.766918897629,435.2296380996704,2994.857705116272,24712,5711,19001,19001,0,31,5649000.0
5649,5649999,20.668167754043136,37.98902392125763,0.08041729762434979,3739.2587826251984,435.29653310775757,2996.009362220764,24715,5712,19003,19003,0,31,5650000.0
5650,5650999,20.666915603121208,37.98752332831979,0.08041955879118468,3739.7546832561493,435.36445212364197,2997.169518470764,24716,5712,19004,19004,0,31,5651000.0
5651,5651999,20.66556966212002,37.98545552905795,0.08042371342396226,3740.5603494644165,435.431880235672,2996.7538080215454,24718,5713,19005,19005,0,31,5652000.0
5652,5652999,20.66429923903547,37.98716061017049,0.08041377294510865,3741.0406165122986,435.4963159561157,2997.859429359436,24718,5713,19005,19005,0,31,5653000.0
5653,5653999,20.66310036797639,37.984952256435385,0.08041863671971228,3741.7496888637543,435.5648386478424,2997.926407814026,24720,5714,19006,19006,0,31,5654000.0
5654,5654999,20.661966229314174,37.98287330623965,0.08042329712682217,3742.256145954132,435.63192558288574,2999.0169916152954,24722,5715,19007,19007,0,31,5655000.0
5655,5655999,20.661070072632697,37.98113333409982,0.08042334702257048,3742.9591739177704,435.7003827095032,2999.0823831558228,24722,5715,19007,19007,0,31,5656000.0
5656,5656999,20.660429111356347,37.98012373691041,0.08041856171670647,3743.8776071071625,435.767498254776,2998.139328956604,24732,5716,19016,19016,0,31,5657000.0
5657,5657999,20.659646758692237,37.97843073579235,0.08042022754748956,3744.424456834793,435.8388829231262,2998.9665002822876,24734,5717,19017,19017,0,31,5658000.0
5658,5658999,20.658867368876166,37.97670454927976,0.08041587077140955,3745.0305364131927,435.9059863090515,2999.538353919983,24734,5717,19017,19017,0,31,5659000.0
5659,5659999,20.65851834302182,37.975613965572535,0.08040588986335895,3745.837459087372,435.9791946411133,2999.046486854553,24734,5717,19017,19017,0,31,5660000.0
5660,5660999,20.658257065690883,37.97459028632458,0.08039514167615303,3746.6278717517853,436.0504789352417,2998.8759393692017,24743,5718,19025,19025,0,31,5661000.0
5661,5661999,20.658043724531037,37.973612497641206,0.0803834987920381,3747.2213940620422,436.11979126930237,2999.580750465393,24745,5719,19026,19026,0,31,5662000.0
5662,5662999,20.65824261176663,37.97490106049194,0.0803603449080087,3748.1118080615997,436.19085478782654,2998.7708597183228,24745,5719,19026,19026,0,31,5663000.0
5663,5663999,20.658467381433585,37.97483202643893,0.08034447776222264,3748.9329748153687,436.2610197067261,2998.272210121155,24745,5719,19026,19026,0,31,5664000.0
5664,5664999,20.658370066602494,37.9739023594645,0.08033258658020159,3749.4306695461273,436.32985615730286,2999.3214960098267,24745,5719,19026,19026,0,31,5665000.0
5665,5665999,20.65847682518695,37.9733415913685,0.08031992393961407,3750.2489042282104,436.40236234664917,2998.942650794983,24811,5721,19090,19090,0,31,5666000.0
5666,5666999,20.6575799105386,37.97158821288081,0.08031940404483051,3751.080101251602,436.47242164611816,2998.857621192932,24819,5721,19098,19098,0,31,5667000.0
5667,5667999,20.656525797866717,37.96971308785993,0.0803154386160344,3751.251292705536,436.54277324676514,3001.6748971939087,24826,5721,19105,19105,0,31,5668000.0
5668,5668999,20.65514266844912,37.96710281216835,0.0803183209068985,3751.6643834114075,436.6102614402771,3003.308922767639,24826,5721,19105,19105,0,31,5669000.0
5669,5669999,20.653947548819787,37.96473532550788,0.08032299424883627,3752.280015230179,436.68009090423584,3003.903046607971,24832,5723,19109,19109,0,31,5670000.0
5670,5670999,20.652882353503763,37.963314354358374,0.08032539298270192,3752.717780351639,436.75421476364136,3005.5836420059204,24846,5724,19122,19122,0,31,5671000.0
5671,5671999,20.651554355273085,37.960852910098524,0.08032864261151251,3753.424434185028,436.8238070011139,3005.810799598694,24847,5724,19123,19123,0,31,5672000.0
5672,5672999,20.650215253814157,37.95843889698798,0.0803332343224672,3754.4126818180084,436.9000737667084,3004.5556116104126,24853,5727,19126,19126,0,31,5673000.0
5673,5673999,20.64911108987457,37.95661060367184,0.08033437800016185,3755.0251920223236,436.96974897384644,3005.0852670669556,24855,5728,19127,19127,0,31,5674000.0
5674,5674999,20.648267667988964,37.95560009565876,0.08032980248167731,3755.6624505519867,437.0407612323761,3005.6456003189087,24859,5730,19129,19129,0,31,5675000.0
5675,5675999,20.647866445889598,37.95619626065671,0.0803161036297666,3755.9543187618256,437.1071627140045,3007.7799615859985,24859,5730,19129,19129,0,31,5676000.0
5676,5676999,20.648137177345887,37.958468710230655,0.08029730326666151,3756.928112745285,437.177437543869,3006.6522302627563,24859,5730,19129,19129,0,31,5677000.0
5677,5677999,20.648626961659264,37.961145057484806,0.08027866088225777,3757.652529478073,437.24558186531067,3006.721978187561,24859,5730,19129,19129,0,31,5678000.0
5678,5678999,20.64924445627456,37.96330097412274,0.08026628547539483,3758.3848056793213,437.31352496147156,3006.580292701721,24861,5731,19130,19130,0,31,5679000.0
5679,5679999,20.649874642897412,37.96574738243071,0.08024699369606936,3759.209607362747,437.3849892616272,3006.0668954849243,24863,5732,19131,19131,0,31,5680000.0
5680,5680999,20.650826296600233,37.969167675309514,0.08022559799675533,3760.0411117076874,437.45591378211975,3005.559983253479,24867,5734,19133,19133,0,31,5681000.0
5681,5681999,20.651903011207757,37.972899006849154,0.08021292608487529,3760.45072221756,437.53224992752075,3007.168007850647,24869,5735,19134,19134,0,31,5682000.0
5682,5682999,20.652648806968593,37.97502010466113,0.08021310511435786,3761.164039373398,437.6018121242523,3007.2288522720337,24869,5735,19134,19134,0,31,5683000.0
5683,5683999,20.654032325031125,37.978238472696994,0.08021005012669424,3762.2088878154755,437.6697220802307,3005.6362314224243,24884,5740,19144,19144,0,31,5684000.0
5684,5684999,20.65530136415915,37.98123323922994,0.08021848027732881,3762.922929048538,437.7411091327667,3005.731225013733,24884,5740,19144,19144,0,31,5685000.0
5685,5685999,20.656732758677737,37.98661125900345,0.08018704988867242,3763.535192012787,437.81070828437805,3006.2711420059204,24886,5741,19145,19145,0,31,5686000.0
5686,5686999,20.657404518869495,37.98756219374079,0.08019152006295893,3764.284546136856,437.88219356536865,3006.187050819397,24888,5742,19146,19146,0,31,5687000.0
5687,5687999,20.65730439632461,37.98764497393766,0.08019044492965877,3764.6675651073456,437.9499843120575,3008.0427713394165,24896,5742,19154,19154,0,31,5688000.0
5688,5688999,20.65672669607746,37.985974971216415,0.08017275668871315,3765.1615421772003,438.01882910728455,3009.23819065094,24905,5743,19162,19162,0,31,5689000.0
5689,5689999,20.655845485683205,37.98431546568632,0.08016249541793785,3765.552839756012,438.0879077911377,3010.928292274475,24907,5744,19163,19163,0,31,5690000.0
5690,5690999,20.655052750976303,37.98280311586673,0.08015375974021521,3766.1632511615753,438.1568343639374,3011.5578775405884,24910,5745,19165,19165,0,31,5691000.0
5691,5691999,20.654411088892996,37.98127478729416,0.08014164715802896,3766.7141909599304,438.2314643859863,3012.6280450820923,24926,5747,19179,19179,0,31,5692000.0
5692,5692999,20.653750076208823,37.97977422274977,0.08013039270362221,3767.553047657013,438.3053207397461,3012.170853614807,24928,5748,19180,19180,0,31,5693000.0
5693,5693999,20.652964024350815,37.978072723027395,0.08012304788245372,3768.163058757782,438.3752977848053,3012.849160194397,24928,5748,19180,19180,0,31,5694000.0
5694,5694999,20.652608828900753,37.97701662613954,0.08011195587007947,3768.7921283245087,438.445675611496,3013.348526954651,24932,5750,19182,19182,0,31,5695000.0
5695,5695999,20.652086637495113,37.975981150998436,0.0801042096308765,3769.3098378181458,454.9898543357849,3014.4769983291626,24934,5751,19183,19183,0,31,5696000.0
5696,5696999,20.65187994230613,37.97519677459425,0.08010429769864058,3770.0743992328644,455.0609276294708,3014.53270816803,24956,5754,19202,19202,0,31,5697000.0
5697,5697999,20.651683762616525,37.97491843420329,0.08010187966186921,3770.8073127269745,455.1296694278717,3014.6309366226196,24956,5754,19202,19202,0,31,5698000.0
5698,5698999,20.65151358483869,37.97414511770733,0.0800922671191725,3771.345309495926,455.2003493309021,3015.6951379776,24958,5755,19203,19203,0,31,5699000.0
5699,5699999,20.651510477166966,37.976212578620704,0.0801032475853104,3772.086441040039,455.27122592926025,3015.747155189514,24967,5756,19211,19211,0,31,5700000.0
5700,5700999,20.65148951017942,37.97584353106881,0.08009936064697887,3772.7094633579254,455.34060978889465,3016.284546852112,24991,5758,19233,19233,0,31,5701000.0
5701,5701999,20.651625543385105,37.97554340051749,0.08011432087039738,3773.4677064418793,455.40991711616516,3016.17569065094,24995,5760,19235,19235,0,31,5702000.0
5702,5702999,20.651555792491045,37.97462087012624,0.08012435256534434,3774.32368183136,455.4789123535156,3015.6132669448853,25007,5762,19245,19245,0,31,5703000.0
5703,5703999,20.651531152290385,37.97396793177695,0.08013753347226538,3775.0332820415497,455.54849314689636,3015.8329858779907,25007,5762,19245,19245,0,31,5704000.0
5704,5704999,20.651714364146816,37.973189579769596,0.08014887970887763,3775.931195497513,455.61735939979553,3015.062958717346,25007,5762,19245,19245,0,31,5705000.0
5705,5705999,20.651860035942576,37.97406185295067,0.080137082891517,3776.556765794754,455.68784379959106,3015.595742225647,25015,5763,19252,19252,0,31,5706000.0
5706,5706999,20.651970676171356,37.97343596023936,0.0801367697601506,3777.5078325271606,455.7595925331116,3014.6772470474243,25015,5763,19252,19252,0,31,5707000.0
5707,5707999,20.652049790779433,37.97263802920048,0.0801267700319902,3778.1356201171875,455.83486223220825,3015.404908180237,25015,5763,19252,19252,0,31,5708000.0
5708,5708999,20.651367231813193,37.97097938345297,0.08012492605918153,3778.5199298858643,455.9039385318756,3017.250946998596,25026,5763,19263,19263,0,31,5709000.0
5709,5709999,20.650216562218294,37.96943465488022,0.08012920872232066,3778.9165160655975,455.97447514533997,3018.9750604629517,25045,5764,19281,19281,0,31,5710000.0
5710,5710999,20.649133005608967,37.96878380047025,0.08013070065224026,3779.726657152176,456.0452058315277,3018.6679697036743,25048,5764,19284,19284,0,31,5711000.0
5711,5711999,20.648260922113323,37.96754099631746,0.08012939438152644,3780.2496559619904,456.1170172691345,3019.8128595352173,25058,5765,19293,19293,0,31,5712000.0
5712,5712999,20.64722736179418,37.96611257822952,0.08013265977845829,3780.6563374996185,456.1871454715729,3021.480912208557,25058,5765,19293,19293,0,31,5713000.0
5713,5713999,20.645809477162175,37.96355624235065,0.08014391450623626,3781.269146680832,456.25664710998535,3022.100708961487,25058,5765,19293,19293,0,31,5714000.0
5714,5714999,20.644628623082234,37.961432516317814,0.08015188706416732,3781.6778769493103,456.325630903244,3023.735619544983,25058,5765,19293,19293,0,31,5715000.0
5715,5715999,20.643645131102485,37.959959855686726,0.08015446907281243,3782.2973799705505,456.393230676651,3024.2626276016235,25060,5766,19294,19294,0,31,5716000.0
5716,5716999,20.64240688161134,37.957953506224825,0.0801650529233986,3783.406740665436,456.4645154476166,3022.539406776428,25086,5768,19318,19318,0,31,5717000.0
5717,5717999,20.641195090595396,37.95561067292386,0.08017708851341854,3783.7259867191315,456.53410291671753,3024.6552057266235,25086,5768,19318,19318,0,31,5718000.0
5718,5718999,20.63996541158857,37.9532305844419,0.08018605508688281,3784.538069963455,456.6030352115631,3024.387848854065,25088,5769,19319,19319,0,31,5719000.0
5719,5719999,20.638920495292293,37.95133379805622,0.08019527789986491,3785.1650247573853,456.67219400405884,3025.0320291519165,25088,5769,19319,19319,0,31,5720000.0
5720,5720999,20.63800003216555,37.9493962025215,0.08020435492826716,3785.7662212848663,456.74348425865173,3025.5949182510376,25088,5769,19319,19319,0,31,5721000.0
5721,5721999,20.637223561247787,37.94763416931576,0.08021348496167124,3786.5014634132385,456.8159236907959,3025.6217737197876,25088,5769,19319,19319,0,31,5722000.0
5722,5722999,20.636399842045627,37.94573058692967,0.08022409073896364,3787.092394590378,456.8901472091675,3026.42723941803,25088,5769,19319,19319,0,31,5723000.0
5723,5723999,20.635677197815316,37.9438496687418,0.08023668689953245,3787.5002110004425,456.9599130153656,3027.997529029846,25088,5769,19319,19319,0,31,5724000.0
5724,5724999,20.63451360636949,37.941354401237696,0.08025529240530249,3788.1429595947266,457.0339093208313,3028.5228357315063,25090,5770,19320,19320,0,31,5725000.0
5725,5725999,20.633770836356724,37.940431545386524,0.08025600423632495,3788.9931285381317,457.1048231124878,3027.9127054214478,25103,5771,19332,19332,0,31,5726000.0
5726,5726999,20.63283960498331,37.93855970454308,0.08025301612099622,3789.2973012924194,457.18169713020325,3030.19668674469,25108,5771,19337,19337,0,31,5727000.0
5727,5727999,20.6322647337041,37.938184128499095,0.08024185074282619,3790.012462615967,457.24933075904846,3030.25528049469,25114,5773,19341,19341,0,31,5728000.0
5728,5728999,20.631563651140397,37.93810156112017,0.08023371498825227,3790.3008291721344,457.3185086250305,3032.4473810195923,25115,5773,19342,19342,0,31,5729000.0
5729,5729999,20.630869548558735,37.93683588696561,0.08023149674720986,3790.8266866207123,457.3880352973938,3033.55117893219,25118,5774,19344,19344,0,31,5730000.0
5730,5730999,20.630374950614154,37.93639481426298,0.08022259962569234,3791.7170419692993,457.46055459976196,3032.910325050354,25130,5777,19353,19353,0,31,5731000.0
5731,5731999,20.629756673188165,37.935036756192105,0.08022170151912889,3792.0123448371887,457.52596139907837,3035.0541620254517,25130,5777,19353,19353,0,31,5732000.0
5732,5732999,20.62889141730322,37.9332276408116,0.08021868942917754,3793.1807758808136,457.5973801612854,3032.933472633362,25138,5781,19357,19357,0,31,5733000.0
5733,5733999,20.62810165878831,37.93141430498519,0.08021604007665328,3793.804916858673,457.67091131210327,3033.5814599990845,25142,5783,19359,19359,0,31,5734000.0
5734,5734999,20.627755841457052,37.93117677121653,0.08020340872403076,3794.4445288181305,457.7397081851959,3034.1196603775024,25159,5786,19373,19373,0,31,5735000.0
5735,5735999,20.627255776999064,37.92992036251534,0.08019682093865643,3795.3801720142365,457.8112533092499,3033.2530069351196,25161,5787,19374,19374,0,31,5736000.0
5736,5736999,20.62666985320222,37.92860447380328,0.08019065532325087,3795.7868435382843,457.88136196136475,3034.9000787734985,25161,5787,19374,19374,0,31,5737000.0
5737,5737999,20.626103744433113,37.927166139818695,0.08018221715095264,3796.306354045868,457.9495928287506,3035.937310218811,25163,5788,19375,19375,0,31,5738000.0
5738,5738999,20.625965003816074,37.92701164703141,0.08016912975718804,3796.9321813583374,458.020272731781,3036.4967737197876,25165,5789,19376,19376,0,31,5739000.0
5739,5739999,20.625925382114954,37.92718794481997,0.08015184948804077,3797.7898499965668,458.0899338722229,3035.853051185608,25195,5791,19404,19404,0,31,5740000.0
5740,5740999,20.625508975482777,37.92576016971768,0.08014114951670437,3798.7052648067474,458.1589574813843,3034.902840614319,25204,5792,19412,19412,0,31,5741000.0
5741,5741999,20.625527847424955,37.92500534636412,0.08012826255931105,3799.399660587311,458.22776889801025,3035.194046974182,25204,5792,19412,19412,0,31,5742000.0
5742,5742999,20.62574241829696,37.924660545437206,0.08011262687835596,3800.121041059494,458.29852962493896,3035.239411354065,25204,5792,19412,19412,0,31,5743000.0
5743,5743999,20.62599771088799,37.92418246169928,0.080098305884994,3800.9031167030334,458.3672926425934,3035.016900062561,25204,5792,19412,19412,0,31,5744000.0
5744,5744999,20.62617525846739,37.925960296764586,0.08007926937541732,3801.3070797920227,458.43639302253723,3036.590958595276,25204,5792,19412,19412,0,31,5745000.0
5745,5745999,20.625816910977633,37.9243822635053,0.08006089486396084,3801.6958661079407,458.5039806365967,3038.375344276428,25216,5792,19424,19424,0,31,5746000.0
5746,5746999,20.626137886942633,37.925099670397636,0.08005813675858664,3802.4856243133545,458.5730781555176,3038.1106271743774,25225,5793,19432,19432,0,31,5747000.0
5747,5747999,20.626695388411523,37.926563972577775,0.08005095049521749,3803.1891679763794,458.64353609085083,3038.1867151260376,25238,5794,19444,19444,0,31,5748000.0
5748,5748999,20.627271006549503,37.926779714932565,0.08004253869312583,3803.5963876247406,458.7103044986725,3039.7389612197876,25239,5794,19445,19445,0,31,5749000.0
5749,5749999,20.627626448581342,37.92694284585456,0.0800444041730447,3804.0182411670685,458.7777900695801,3041.314965248108,25243,5795,19448,19448,0,31,5750000.0
5750,5750999,20.627684198402793,37.92617925933916,0.08004130869359405,3804.839611053467,458.84781527519226,3041.03115940094,25247,5797,19450,19450,0,31,5751000.0
5751,5751999,20.62767498930583,37.92554122798399,0.08004633284028506,3805.4502279758453,458.9147746562958,3041.5899896621704,25250,5798,19452,19452,0,31,5752000.0
5752,5752999,20.62796969506268,37.92586017362375,0.08006359673357999,3806.2845220565796,458.9830815792084,3041.0790185928345,25254,5800,19454,19454,0,31,5753000.0
5753,5753999,20.628014321496014,37.92509889005995,0.08007174637971837,3806.6883020401,459.0513582229614,3042.6687173843384,25256,5801,19455,19455,0,31,5754000.0
5754,5754999,20.62840328749932,37.92518372826709,0.08009692294732762,3807.2038571834564,459.12102222442627,3043.8847131729126,25256,5801,19455,19455,0,31,5755000.0
5755,5755999,20.628742157722545,37.92604061872411,0.08010423843649739,3808.0472667217255,459.18885254859924,3043.2038736343384,25258,5802,19456,19456,0,31,5756000.0
5756,5756999,20.62962432455685,37.927097726749764,0.08011676784584354,3808.5664682388306,459.2582108974457,3044.2830209732056,25258,5802,19456,19456,0,31,5757000.0
5757,5757999,20.630802180267878,37.93003130828711,0.08012287873072776,3809.28430724144,459.3261671066284,3044.56240940094,25322,5803,19519,19519,0,31,5758000.0
5758,5758999,20.632036340025078,37.932666591071815,0.08014404462485691,3809.6858518123627,459.3936560153961,3046.3114709854126,25322,5803,19519,19519,0,31,5759000.0
5759,5759999,20.633805910081744,37.93772416814129,0.08014694162088098,3810.3141226768494,459.4634461402893,3046.8364725112915,25326,5805,19521,19521,0,31,5760000.0
5760,5760999,20.635326323353485,37.941191321023425,0.0801646209914002,3811.038955450058,459.5316104888916,3046.911286354065,25328,5806,19522,19522,0,31,5761000.0
5761,5761999,20.637493055621388,37.94829377249147,0.08016661886013399,3811.7402353286743,459.5997941493988,3047.089409828186,25328,5806,19522,19522,0,31,5762000.0
5762,5762999,20.63941352678877,37.95219445666928,0.08019276378679985,3812.3445308208466,459.6682291030884,3047.758599281311,25337,5807,19530,19530,0,31,5763000.0
5763,5763999,20.640583327813378,37.9540440475398,0.08021573000394233,3812.9850227832794,459.7405250072479,3048.2957162857056,25339,5808,19531,19531,0,31,5764000.0
5764,5764999,20.64123039915823,37.95412091317155,0.08022385640695773,3813.4674680233,459.8096127510071,3049.61750125885,25341,5809,19532,19532,0,31,5765000.0
5765,5765999,20.64166960334177,37.95422708901419,0.08023394222304725,3814.3793115615845,459.8794617652893,3048.744439125061,25349,5809,19540,19540,0,31,5766000.0
5766,5766999,20.641145840208264,37.95399316293093,0.0802175576342733,3814.784470319748,459.94955039024353,3050.415856361389,25361,5810,19551,19551,0,31,5767000.0
5767,5767999,20.64056542841543,37.95278949431929,0.08020675514207098,3815.3917820453644,460.01840138435364,3051.096001625061,25364,5810,19554,19554,0,31,5768000.0
5768,5768999,20.63978604048099,37.950959253483774,0.08020437572225936,3815.872983455658,460.08365631103516,3052.239281654358,25365,5810,19555,19555,0,31,5769000.0
5769,5769999,20.639280298956088,37.949609229987,0.08019656612185155,3816.413316965103,460.15313172340393,3053.257508277893,25365,5810,19555,19555,0,31,5770000.0
5770,5770999,20.63846981454883,37.947832401447556,0.08019425596794394,3817.148600101471,460.2234437465668,3053.2479333877563,25368,5811,19557,19557,0,31,5771000.0
5771,5771999,20.637659817972274,37.9460186275392,0.08019249460741129,3817.4587099552155,460.29260087013245,3055.2130365371704,25370,5812,19558,19558,0,31,5772000.0
5772,5772999,20.63687900541957,37.94411459540313,0.08019033934105269,3817.9596507549286,460.36008071899414,3056.3199014663696,25371,5812,19559,19559,0,31,5773000.0
5773,5773999,20.63605822899353,37.942096841351436,0.08019057994675838,3818.5102965831757,460.4285671710968,3057.300980567932,25377,5815,19562,19562,0,31,5774000.0
5774,5774999,20.635326154277813,37.94025294495337,0.08018606120238803,3819.1208760738373,460.4961562156677,3057.840416908264,25381,5817,19564,19564,0,31,5775000.0
5775,5775999,20.634570806916102,37.93825054837208,0.08018405235153436,3820.063466310501,460.5662143230438,3056.8425302505493,25381,5817,19564,19564,0,31,5776000.0
5776,5776999,20.634007873786494,37.93655466853849,0.08018080326277421,3820.7864003181458,460.63514590263367,3056.895531654358,25383,5818,19565,19565,0,31,5777000.0
5777,5777999,20.63344658902402,37.93494768852963,0.08017551557066638,3821.5288031101227,460.7053828239441,3056.9080514907837,25399,5820,19579,19579,0,31,5778000.0
5778,5778999,20.63298485798903,37.93351060552089,0.08017314304116963,3822.0340163707733,460.77278184890747,3057.9951639175415,25399,5820,19579,19579,0,31,5779000.0
5779,5779999,20.632673065179436,37.93256009935555,0.08016782447625148,3822.7567808628082,460.84107875823975,3058.158646583557,25403,5822,19581,19581,0,31,5780000.0
5780,5780999,20.6321595082845,37.93103009391176,0.08017031589807322,3823.50333571434,460.91078448295593,3058.1259546279907,25417,5825,19592,19592,0,31,5781000.0
5781,5781999,20.631786332122108,37.9296174084843,0.08016964134647075,3824.323180437088,460.97889399528503,3057.68798160553,25417,5825,19592,19592,0,31,5782000.0
5782,5782999,20.631459565678213,37.92829507193043,0.08017141446007592,3824.7405383586884,461.04952788352966,3059.280831336975,25417,5825,19592,19592,0,31,5783000.0
5783,5783999,20.630929167912345,37.92669824103022,0.0801746611599542,3825.6631791591644,461.1181387901306,3058.2901315689087,25419,5826,19593,19593,0,31,5784000.0
5784,5784999,20.630261143475202,37.92482056646098,0.08018001806477348,3826.0616133213043,461.187283039093,3059.8666849136353,25419,5826,19593,19593,0,31,5785000.0
5785,5785999,20.629684202633573,37.92358229870296,0.0801794722275243,3826.6739778518677,461.2553782463074,3060.447319984436,25420,5826,19594,19594,0,31,5786000.0
5786,5786999,20.62855011188634,37.92122976513905,0.0801787978479106,3827.1649532318115,461.3242859840393,3061.568772315979,25434,5827,19607,19607,0,31,5787000.0
5787,5787999,20.627515644171687,37.9194268668882,0.08017026384434545,3827.651432275772,461.3912672996521,3062.7922525405884,25443,5827,19616,19616,0,31,5788000.0
5788,5788999,20.626582220256413,37.917431099615456,0.08015905464034834,3828.157961130142,461.458722114563,3063.866494178772,25446,5828,19618,19618,0,31,5789000.0
5789,5789999,20.625657841231437,37.91638001215753,0.08015169107851416,3828.884603023529,461.5287208557129,3063.953698158264,25455,5829,19626,19626,0,31,5790000.0
5790,5790999,20.62470940972355,37.91508280470056,0.08014262302494457,3829.6212174892426,461.5966966152191,3063.961922645569,25458,5830,19628,19628,0,31,5791000.0
5791,5791999,20.623720553016213,37.91323111813722,0.08013656808522496,3830.1112158298492,461.6650593280792,3065.2528924942017,25458,5830,19628,19628,0,31,5792000.0
5792,5792999,20.622876787819187,37.911230780896034,0.08012864678153919,3830.7335410118103,461.7351679801941,3065.830689430237,25459,5830,19629,19629,0,31,5793000.0
5793,5793999,20.622179165354382,37.90997790005778,0.08011793513881349,3831.56552028656,461.8046236038208,3065.398819923401,25472,5834,19638,19638,0,31,5794000.0
5794,5794999,20.62157617245142,37.90831296065654,0.0801109436050339,3832.2812283039093,461.87061500549316,3065.391053199768,25474,5835,19639,19639,0,31,5795000.0
5795,5795999,20.620985289900354,37.907346566298486,0.08010186175569833,3832.9543464183807,461.94923067092896,3065.9926385879517,25474,5835,19639,19639,0,31,5796000.0
5796,5796999,20.62038748021611,37.905679808597135,0.08009569868934752,3833.690119743347,462.0177562236786,3066.0010843276978,25539,5837,19702,19702,0,31,5797000.0
5797,5797999,20.620271193236384,37.90522733107422,0.08008421083050177,3834.41446185112,462.0859327316284,3066.1678857803345,25541,5838,19703,19703,0,31,5798000.0
5798,5798999,20.619945221873824,37.90424839966625,0.0800733683896343,3834.9346084594727,462.1564109325409,3067.385018348694,25543,5839,19704,19704,0,31,5799000.0
5799,5799999,20.619940122925698,37.90364433974607,0.0800627703770701,3835.5372059345245,462.22702288627625,3068.305993080139,25543,5839,19704,19704,0,31,5800000.0
5800,5800999,20.6194511962385,37.90218233913508,0.0800574317512901,3836.072132587433,462.2978219985962,3069.4328088760376,25543,5839,19704,19704,0,31,5801000.0
5801,5801999,20.619299790793395,37.901309506957695,0.08004785227908218,3836.9205691814423,462.3716068267822,3068.9745111465454,25543,5839,19704,19704,0,31,5802000.0
5802,5802999,20.61909040148978,37.90013911777074,0.08004056333695497,3837.736550092697,462.4410698413849,3068.503762245178,25552,5840,19712,19712,0,31,5803000.0
5803,5803999,20.619051510147248,37.89940489110593,0.080029233098868,3838.272030353546,462.51335644721985,3069.5275506973267,25556,5842,19714,19714,0,31,5804000.0
5804,5804999,20.618684733749927,37.89796534692046,0.08002281915745946,3838.56791973114,462.5835671424866,3071.6293954849243,25556,5842,19714,19714,0,31,5805000.0
5805,5805999,20.61803880044097,37.89597964190502,0.08001921236165666,3839.3680169582367,462.6529664993286,3071.1899576187134,25556,5842,19714,19714,0,31,5806000.0
5806,5806999,20.617094932702194,37.893738956402224,0.08001970514023304,3839.9578585624695,462.72105526924133,3071.927689552307,25567,5842,19725,19725,0,31,5807000.0
5807,5807999,20.616156767692384,37.892584815755676,0.08000851761679406,3840.363819360733,462.7924437522888,3073.650719642639,25586,5844,19742,19742,0,31,5808000.0
5808,5808999,20.615388709190448,37.89163871364504,0.07999918416551732,3840.7504811286926,462.86125230789185,3075.3725061416626,25588,5844,19744,19744,0,31,5809000.0
5809,5809999,20.614710397343366,37.89015421227508,0.07999942074782995,3841.6681275367737,462.92990350723267,3074.594193458557,25593,5846,19747,19747,0,31,5810000.0
5810,5810999,20.613982797459652,37.88862555554378,0.07999827685199701,3842.0882470607758,462.99754881858826,3076.216980934143,25597,5847,19750,19750,0,31,5811000.0
5811,5811999,20.61323969024482,37.88757037710149,0.07998908877876032,3842.728518486023,463.0680727958679,3076.823327064514,25599,5848,19751,19751,0,31,5812000.0
5812,5812999,20.612665834161692,37.886629809349444,0.07998024584268248,3843.3903126716614,463.1380994319916,3077.261200904846,25603,5850,19753,19753,0,31,5813000.0
5813,5813999,20.612038334691814,37.88517639076201,0.07997708938615078,3843.806594133377,463.20724081993103,3078.8655939102173,25605,5851,19754,19754,0,31,5814000.0
5814,5814999,20.611666536985982,37.88414011692317,0.07996854497239447,3844.411495447159,463.2763423919678,3079.5373392105103,25607,5852,19755,19755,0,31,5815000.0
5815,5815999,20.611172187197162,37.88312439374261,0.07996348953713106,3845.0195429325104,463.34512400627136,3080.138367652893,25607,5852,19755,19755,0,31,5816000.0
5816,5816999,20.611269679865206,37.882782251501396,0.07995115247662521,3845.6325390338898,463.4155662059784,3080.697709083557,25609,5853,19756,19756,0,31,5817000.0
5817,5817999,20.611693892235124,37.883620708836595,0.07993954612069787,3846.465865135193,463.4855098724365,3080.1990442276,25611,5854,19757,19757,0,31,5818000.0
5818,5818999,20.612050741447746,37.88395978946081,0.07993814090143514,3847.2022621631622,463.5582346916199,3080.239624977112,25613,5855,19758,19758,0,31,5819000.0
5819,5819999,20.61274111441663,37.88517623271733,0.07993840876269842,3847.600059747696,463.6262378692627,3081.8341760635376,25613,5855,19758,19758,0,31,5820000.0
5820,5820999,20.61358803207733,37.887086959372624,0.07996061576909641,3848.776737689972,463.6991288661957,3079.762780189514,25623,5860,19763,19763,0,31,5821000.0
5821,5821999,20.61484531226902,37.88960254637442,0.07998104693702168,3849.1956844329834,463.7672462463379,3081.2906045913696,25627,5862,19765,19765,0,31,5822000.0
5822,5822999,20.616108502563566,37.892238705648346,0.08002175415488433,3850.0238032341003,463.8377516269684,3080.7466440200806,25629,5863,19766,19766,0,31,5823000.0
5823,5823999,20.61848618596858,37.89731261622257,0.08006019925219043,3850.829525232315,463.90879821777344,3080.400086402893,25629,5863,19766,19766,0,31,5824000.0
5824,5824999,20.62095736032827,37.90428656617635,0.08008359951907418,3851.233738183975,463.9766252040863,3081.99852848053,25631,5864,19767,19767,0,31,5825000.0
5825,5825999,20.623497223881635,37.91094091006321,0.0801017707683177,3852.046314716339,464.0476961135864,3081.58918094635,25633,5865,19768,19768,0,31,5826000.0
5826,5826999,20.625306737598198,37.913905889933176,0.08013767443473396,3852.240921974182,464.1172385215759,3084.2183389663696,25633,5865,19768,19768,0,31,5827000.0
5827,5827999,20.625001546319623,37.91319598759764,0.08012474277850723,3852.834907770157,464.18616771698,3085.0568628311157,25647,5865,19782,19782,0,31,5828000.0
5828,5828999,20.62388477798411,37.91190581508333,0.08012194771975589,3853.325210094452,464.2556576728821,3086.477562904358,25663,5866,19797,19797,0,31,5829000.0
5829,5829999,20.623017323720777,37.91110101008963,0.08011447116451176,3853.8378171920776,464.324346780777,3087.6130228042603,25668,5867,19801,19801,0,31,5830000.0
5830,5830999,20.622092086801135,37.90945131385451,0.08011260969986234,3854.55770611763,464.39441871643066,3087.759476661682,25672,5868,19804,19804,0,31,5831000.0
5831,5831999,20.621412830029062,37.90801551454073,0.0801051077972641,3855.083195209503,464.4637017250061,3088.845383644104,25674,5869,19805,19805,0,31,5832000.0
5832,5832999,20.620675341577552,37.906756079675375,0.08009901275164832,3855.797123670578,464.53213763237,3088.933793067932,25674,5869,19805,19805,0,31,5833000.0
5833,5833999,20.620036876256798,37.905229196251994,0.0800925426337622,3856.218793153763,464.6030042171478,3090.5984201431274,25674,5869,19805,19805,0,31,5834000.0
5834,5834999,20.619710276831835,37.90431019370172,0.08008596526256262,3856.8139662742615,464.6705250740051,3091.467698097229,25674,5869,19805,19805,0,31,5835000.0
5835,5835999,20.619998202424483,37.90730857898742,0.08006380037514371,3857.4520213603973,464.74105525016785,3091.9990091323853,25692,5871,19821,19821,0,31,5836000.0
5836,5836999,20.620571980145392,37.90832441305726,0.08005437552556993,3858.4913461208344,464.81260323524475,3090.6714181900024,25694,5872,19822,19822,0,31,5837000.0
5837,5837999,20.62168311547367,37.90996813072935,0.08005742184619258,3859.460301876068,464.88374042510986,3089.368805885315,25696,5873,19823,19823,0,31,5838000.0
5838,5838999,20.62309638447571,37.9123418762781,0.08006668349424928,3859.9783942699432,464.9522051811218,3090.3995218276978,25699,5874,19825,19825,0,31,5839000.0
5839,5839999,20.624277957500684,37.91376671900277,0.08007974548377894,3860.7474660873413,465.0253212451935,3090.239769935608,25701,5875,19826,19826,0,31,5840000.0
5840,5840999,20.62581300576709,37.91565430610935,0.08008957884635848,3861.284914493561,465.0963056087494,3091.238434791565,25703,5876,19827,19827,0,31,5841000.0
5841,5841999,20.627669075629523,37.92032814989969,0.08010291051142449,3861.769802570343,465.164368391037,3092.6557779312134,25705,5877,19828,19828,0,31,5842000.0
5842,5842999,20.629867966535443,37.925713957208565,0.08013209070247329,3862.8649129867554,465.2370595932007,3090.855591773987,25718,5880,19838,19838,0,31,5843000.0
5843,5843999,20.63176053510949,37.928338924364986,0.08016333323579183,3863.4937109947205,465.3060917854309,3091.3763132095337,25720,5881,19839,19839,0,31,5844000.0
5844,5844999,20.634412492008956,37.93472838163427,0.08019061289763652,3864.009795188904,465.3780300617218,3092.476761817932,25720,5881,19839,19839,0,31,5845000.0
5845,5845999,20.63662340209469,37.938561984994706,0.08022056502550512,3865.1489350795746,465.4512038230896,3090.5603036880493,25722,5882,19840,19840,0,31,5846000.0
5846,5846999,20.639594380340107,37.94353388612715,0.08025628377023386,3865.794729948044,465.5244474411011,3091.2261209487915,25788,5885,19903,19903,0,31,5847000.0
5847,5847999,20.64088680841574,37.944679896812254,0.08027241399638396,3866.195981025696,465.59420442581177,3093.0383920669556,25798,5885,19913,19913,0,31,5848000.0
5848,5848999,20.640000114360838,37.94482930890568,0.0802617353575168,3866.7871141433716,465.66481614112854,3093.8885202407837,25823,5886,19937,19937,0,31,5849000.0
5849,5849999,20.638966528446424,37.94370233427431,0.0802640192648858,3867.1851077079773,465.7381236553192,3095.625901222229,25825,5886,19939,19939,0,31,5850000.0
5850,5850999,20.637931198031602,37.9419487823585,0.08026754793846591,3867.603413105011,465.80778908729553,3097.1726083755493,25838,5887,19951,19951,0,31,5851000.0
5851,5851999,20.636922430606422,37.9400723235073,0.08026940411728345,3868.4500381946564,465.87758898735046,3096.6342554092407,25845,5890,19955,19955,0,31,5852000.0
5852,5852999,20.635933230989036,37.94166402534343,0.08025652766794833,3869.129529953003,465.94950222969055,3097.129921913147,25845,5890,19955,19955,0,31,5853000.0
5853,5853999,20.634793815510562,37.93951077621456,0.08026226944236492,3869.532800912857,466.017863035202,3098.7689142227173,25846,5890,19956,19956,0,31,5854000.0
5854,5854999,20.633583370344834,37.93722180098833,0.08026957836285975,3870.1509687900543,466.087030172348,3099.3074502944946,25848,5891,19957,19957,0,31,5855000.0
5855,5855999,20.63237613077547,37.9353735939307,0.0802748270417789,3870.9474518299103,466.15686297416687,3099.2000207901,25850,5892,19958,19958,0,31,5856000.0
5856,5856999,20.631237425069287,37.9333888352584,0.08027909551834178,3871.277273416519,466.22696352005005,3101.319718360901,25850,5892,19958,19958,0,31,5857000.0
5857,5857999,20.63023528872839,37.931643907537364,0.08028211856113932,3872.2520813941956,466.29658007621765,3099.9147577285767,25854,5894,19960,19960,0,31,5858000.0
5858,5858999,20.629329045834353,37.92998399461488,0.08028398135330783,3872.7657132148743,466.3662097454071,3101.0210123062134,25854,5894,19960,19960,0,31,5859000.0
5859,5859999,20.628222181899435,37.92782729500919,0.080293414727037,3873.27077293396,466.43350076675415,3102.1161432266235,25854,5894,19960,19960,0,31,5860000.0
5860,5860999,20.62737603830739,37.92607133561044,0.08029744075212353,3873.8889389038086,466.5060524940491,3102.613350868225,25866,5896,19970,19970,0,31,5861000.0
5861,5861999,20.62649046974478,37.924603034173884,0.0803017475010922,3874.515121459961,466.57663345336914,3103.1452264785767,25868,5897,19971,19971,0,31,5862000.0
5862,5862999,20.625579596702757,37.92258987860336,0.08031112106141503,3874.9260506629944,466.6442985534668,3104.7211923599243,25870,5898,19972,19972,0,31,5863000.0
5863,5863999,20.624780793924856,37.920826850473745,0.08031518841699792,3875.963498353958,466.7140893936157,3103.21190738678,25874,5900,19974,19974,0,31,5864000.0
5864,5864999,20.623791299246317,37.91872268246493,0.08032395561497052,3876.618682861328,466.78297901153564,3103.432801246643,25883,5902,19981,19981,0,31,5865000.0
5865,5865999,20.623501628317516,37.91829557173226,0.08027825111206666,3877.218164920807,466.85472774505615,3104.280358314514,25896,5902,19994,19994,0,31,5866000.0
5866,5866999,20.623443434287847,37.91866734965176,0.0802318931001409,3877.720116376877,466.92432022094727,3105.537926673889,25900,5902,19998,19998,0,31,5867000.0
5867,5867999,20.623245338090744,37.917442567124134,0.0801931757826505,3878.2151918411255,466.993595123291,3106.885277748108,25905,5904,20001,20001,0,31,5868000.0
5868,5868999,20.623158187945805,37.9178646176312,0.08015887848439807,3878.496572494507,467.0623285770416,3109.2374505996704,25905,5904,20001,20001,0,31,5869000.0
5869,5869999,20.62295382728465,37.91741042675719,0.0801372148989068,3878.8885083198547,467.13263845443726,3111.1454553604126,25905,5904,20001,20001,0,31,5870000.0
5870,5870999,20.622456714264207,37.915884258605125,0.0801272606772635,3879.395927429199,467.2087879180908,3112.3809671401978,25910,5906,20004,20004,0,31,5871000.0
5871,5871999,20.62199557959967,37.91608485510553,0.08011161028853087,3880.2544000148773,467.27889347076416,3111.8513879776,25918,5910,20008,20008,0,31,5872000.0
5872,5872999,20.6212466108842,37.91461286851419,0.0801082852778815,3881.0421180725098,467.34965443611145,3111.7904596328735,25929,5915,20014,20014,0,31,5873000.0
5873,5873999,20.62054437044866,37.91324288261385,0.08010463788706446,3881.961298942566,467.4204068183899,3110.9855737686157,25935,5918,20017,20017,0,31,5874000.0
5874,5874999,20.6200144161017,37.91221841424231,0.08009600710573583,3882.497591972351,467.49129128456116,3112.2598810195923,25937,5919,20018,20018,0,31,5875000.0
5875,5875999,20.619522425949505,37.911027356128095,0.08009022769335505,3883.205377101898,467.5610806941986,3112.558449745178,25939,5920,20019,20019,0,31,5876000.0
5876,5876999,20.619162146548973,37.91044754932711,0.0800785344468321,3883.819103240967,467.63020396232605,3113.178360939026,25939,5920,20019,20019,0,31,5877000.0
5877,5877999,20.61919127897031,37.90993539970881,0.08006335931391462,3884.4555718898773,467.70233511924744,3113.659737586975,25941,5921,20020,20020,0,31,5878000.0
5878,5878999,20.619195849864425,37.909756894632395,0.08005164275486198,3885.077454805374,467.7728407382965,3114.2508478164673,25941,5921,20020,20020,0,31,5879000.0
5879,5879999,20.619360655239923,37.909366052075505,0.08003604322855562,3885.6091651916504,467.8421890735626,3115.2781381607056,25956,5923,20033,20033,0,31,5880000.0
5880,5880999,20.61994234647095,37.909833694959694,0.08001917472572595,3886.179666519165,467.9151849746704,3116.1333780288696,25958,5924,20034,20034,0,31,5881000.0
5881,5881999,20.620265845981397,37.90937602106243,0.08000529741989804,3887.015630722046,467.985431432724,3115.787980079651,25958,5924,20034,20034,0,31,5882000.0
5882,5882999,20.62050466625777,37.90879870579373,0.07999566733850827,3887.8618335723877,468.0568871498108,3115.357605934143,25961,5925,20036,20036,0,31,5883000.0
5883,5883999,20.6207924438721,37.909196535051336,0.0799845097130838,3888.6950390338898,468.1277494430542,3114.887505531311,25961,5925,20036,20036,0,31,5884000.0
5884,5884999,20.620727701232216,37.910009854304384,0.07996211467724279,3889.2024233341217,468.1970102787018,3116.092385292053,25972,5925,20047,20047,0,31,5885000.0
5885,5885999,20.61991878940504,37.90792227679857,0.07994658482791817,3889.4959897994995,468.26792192459106,3118.359742164612,25980,5925,20055,20055,0,31,5886000.0
5886,5886999,20.619415552816143,37.90637457564899,0.07992534155106268,3889.8849449157715,468.3357071876526,3120.0331659317017,25982,5925,20057,20057,0,31,5887000.0
5887,5887999,20.618833264557324,37.90476746607982,0.07991033210493881,3890.5991637706757,468.40314388275146,3120.041382789612,25985,5926,20059,20059,0,31,5888000.0
5888,5888999,20.618372398271074,37.90358815092887,0.07989602931074657,3890.8961799144745,468.47048354148865,3122.1972284317017,25986,5926,20060,20060,0,31,5889000.0
5889,5889999,20.618122480294378,37.90254703777394,0.0798881113361366,3891.4319067001343,468.5407164096832,3123.2273569107056,25987,5926,20061,20061,0,31,5890000.0
5890,5890999,20.618193450450484,37.905494527714666,0.07986659549217934,3892.291388988495,468.6103448867798,3122.7373666763306,25990,5927,20063,20063,0,31,5891000.0
5891,5891999,20.61785249417812,37.90424897480726,0.07985696255581665,3893.035389661789,468.6784100532532,3122.6304330825806,25995,5929,20066,20066,0,31,5892000.0
5892,5892999,20.61760150378151,37.903146718396975,0.07985077314548295,3893.8196878433228,468.74944376945496,3122.3854303359985,26008,5933,20075,20075,0,31,5893000.0
5893,5893999,20.617487149459198,37.902084710258805,0.07985004334423573,3894.4297680854797,468.8216667175293,3122.9797677993774,26008,5933,20075,20075,0,31,5894000.0
5894,5894999,20.617452467372278,37.900957723774816,0.07984831176552665,3895.08518075943,468.89368653297424,3123.4826669692993,26012,5935,20077,20077,0,31,5895000.0
5895,5895999,20.61711598772513,37.89936850251718,0.0798465618029428,3895.835993528366,468.9659068584442,3123.547860145569,26014,5936,20078,20078,0,31,5896000.0
5896,5896999,20.61732149640662,37.89899665908492,0.07984542631205682,3896.26323056221,469.03404784202576,3125.054787635803,26019,5938,20081,20081,0,31,5897000.0
5897,5897999,20.617585315443336,37.90132147998966,0.07984612230476729,3896.9025218486786,469.104953289032,3125.504952430725,26021,5939,20082,20082,0,31,5898000.0
5898,5898999,20.617746551323165,37.900906609872024,0.07985345367330365,3897.7052948474884,469.17362117767334,3125.046181678772,26023,5940,20083,20083,0,31,5899000.0
5899,5899999,20.617988941271676,37.90023127357386,0.07985651812005123,3898.4564685821533,469.24440813064575,3124.979989051819,26034,5942,20092,20092,0,31,5900000.0
5900,5900999,20.61935448447931,37.90171838144114,0.07987631097837844,3899.194585800171,469.31614780426025,3124.991539955139,26036,5943,20093,20093,0,31,5901000.0
5901,5901999,20.620282255340452,37.902241837226846,0.07987961234667762,3899.766812324524,469.38596630096436,3125.9497995376587,26036,5943,20093,20093,0,31,5902000.0
5902,5902999,20.620928383306,37.9017580939229,0.07989801666927243,3900.378557920456,469.45847392082214,3126.5174112319946,26036,5943,20093,20093,0,31,5903000.0
5903,5903999,20.621486675515914,37.90161487025567,0.07989019470382974,3901.0873165130615,469.5299406051636,3126.5529947280884,26036,5943,20093,20093,0,31,5904000.0
5904,5904999,20.622050806182877,37.90129516719665,0.07989366022918454,3901.4949283599854,469.60269498825073,3128.122826576233,26036,5943,20093,20093,0,31,5905000.0
5905,5905999,20.621489622635227,37.89963556157307,0.07989951629147363,3901.968368768692,469.67249298095703,3129.4813470840454,26056,5943,20113,20113,0,31,5906000.0
5906,5906999,20.620089270018553,37.898282610092075,0.0799000774630968,3902.430519580841,469.73969173431396,3130.790337562561,26064,5943,20121,20121,0,31,5907000.0
5907,5907999,20.618929374580222,37.896589663247916,0.07989974055272397,3903.11821436882,469.80549359321594,3130.9382638931274,26070,5944,20126,20126,0,31,5908000.0
5908,5908999,20.61804395587415,37.89561109793203,0.07989918263450513,3903.465440750122,469.87047576904297,3132.9094018936157,26070,5944,20126,20126,0,31,5909000.0
5909,5909999,20.616938147207172,37.893609065472326,0.07989994920080656,3903.848133325577,469.93752336502075,3134.5604104995728,26071,5944,20127,20127,0,31,5910000.0
5910,5910999,20.616003552666363,37.891573278909405,0.07990024261632944,3904.48278093338,470.00513195991516,3134.948006629944,26075,5946,20129,20129,0,31,5911000.0
5911,5911999,20.614861547192934,37.88942887474508,0.07990359499961808,3905.104194164276,470.0732891559601,3135.544816017151,26078,5947,20131,20131,0,31,5912000.0
5912,5912999,20.61412739007769,37.887986391322016,0.07989999064307829,3905.290808916092,470.139906167984,3138.211060523987,26078,5947,20131,20131,0,31,5913000.0
5913,5913999,20.61323976699304,37.88624428994827,0.07989916433137567,3906.367707014084,470.2076394557953,3136.477219581604,26082,5949,20133,20133,0,31,5914000.0
5914,5914999,20.612696511071714,37.88738121902172,0.07988549012327228,3906.9103996753693,470.27507162094116,3137.3252267837524,26091,5951,20140,20140,0,31,5915000.0
5915,5915999,20.61200697852173,37.88613541476816,0.07988966512309781,3907.201167345047,470.34239506721497,3139.445450782776,26091,5951,20140,20140,0,31,5916000.0
5916,5916999,20.611602468244136,37.88535303536498,0.07989198170376755,3907.6934480667114,470.4090459346771,3140.532868385315,26091,5951,20140,20140,0,31,5917000.0
5917,5917999,20.61127447220876,37.88426831764573,0.07989100079888856,3908.1982192993164,470.4754407405853,3141.5877923965454,26093,5952,20141,20141,0,31,5918000.0
5918,5918999,20.611098277825892,37.88390709320022,0.07989969851239886,3908.920086145401,470.54222774505615,3141.4402017593384,26097,5954,20143,20143,0,31,5919000.0
5919,5919999,20.61117216234138,37.88520024123882,0.07989619895979039,3909.6149682998657,470.6106333732605,3141.4767847061157,26099,5955,20144,20144,0,31,5920000.0
5920,5920999,20.611470333709846,37.88508517675799,0.07990847069995122,3910.530663251877,470.68082094192505,3140.718102455139,26103,5956,20147,20147,0,31,5921000.0
5921,5921999,20.61190395691145,37.88513456372779,0.07992101097832593,3910.836571931839,470.74830627441406,3142.657151222229,26105,5957,20148,20148,0,31,5922000.0
5922,5922999,20.61220764196294,37.8848286059479,0.07993595876870108,3911.4462475776672,470.817480802536,3143.0607767105103,26107,5958,20149,20149,0,31,5923000.0
5923,5923999,20.612196939258926,37.88435396750741,0.07995175330589976,3912.264174938202,470.8852617740631,3142.4411249160767,26109,5959,20150,20150,0,31,5924000.0
5924,5924999,20.612363387770383,37.883911753922014,0.07994981590993533,3912.9773647785187,470.95465207099915,3142.4713373184204,26117,5960,20157,20157,0,31,5925000.0
5925,5925999,20.611916594619014,37.88246810559493,0.0799612352049478,3913.764924287796,471.0228500366211,3142.2289056777954,26132,5960,20172,20172,0,31,5926000.0
5926,5926999,20.610322739857427,37.87998117764553,0.07996939869517228,3914.351383447647,471.0900847911835,3143.0294427871704,26142,5960,20182,20182,0,31,5927000.0
5927,5927999,20.609140401198527,37.878236127892286,0.07996928688259564,3914.7311465740204,471.15468168258667,3144.721718788147,26144,5960,20184,20184,0,31,5928000.0
5928,5928999,20.60799428810003,37.876503592473824,0.07997081416799068,3915.209007501602,471.220294713974,3146.068543434143,26146,5961,20185,20185,0,31,5929000.0
5929,5929999,20.607089376029972,37.875813564587325,0.07996717466973335,3915.701649904251,471.28567337989807,3147.1664209365845,26149,5962,20187,20187,0,31,5930000.0
5930,5930999,20.60626497027408,37.87408079645447,0.07996103729588366,3916.2144174575806,471.3520665168762,3148.2838068008423,26149,5962,20187,20187,0,31,5931000.0
5931,5931999,20.605268843838036,37.872162365596665,0.0799603570029559,3916.9119029045105,471.42206287384033,3148.3636178970337,26151,5963,20188,20188,0,31,5932000.0
5932,5932999,20.60447164575594,37.870699938097445,0.0799559711568496,3917.7215502262115,471.4892954826355,3147.84325504303,26154,5964,20190,20190,0,31,5933000.0
5933,5933999,20.603610865428113,37.868805336784874,0.07995363351522089,3918.6784822940826,471.5586745738983,3146.4547662734985,26162,5968,20194,20194,0,31,5934000.0
5934,5934999,20.603153058635947,37.86765307783937,0.07994825649861659,3919.2769827842712,471.62642455101013,3146.975350379944,26165,5969,20196,20196,0,31,5935000.0
5935,5935999,20.60311348324842,37.867073593528936,0.07994513266066094,3919.667720079422,471.69230341911316,3148.637360572815,26165,5969,20196,20196,0,31,5936000.0
5936,5936999,20.60337426839811,37.86743986785735,0.07994402362101538,3920.0718955993652,471.75892996788025,3150.185326576233,26167,5970,20197,20197,0,31,5937000.0
5937,5937999,20.60395923005987,37.86793205783013,0.07993740462324928,3920.5919995307922,471.826655626297,3151.303978919983,26167,5970,20197,20197,0,31,5938000.0
5938,5938999,20.60445674001026,37.8681590865918,0.07993959232728065,3921.5394110679626,471.8976137638092,3150.240616798401,26184,5974,20210,20210,0,31,5939000.0
5939,5939999,20.604924310057203,37.86832685220438,0.07994798457479746,3922.4555900096893,471.9666187763214,3149.1866006851196,26191,5977,20214,20214,0,31,5940000.0
5940,5940999,20.605674325607325,37.86887607389917,0.07995661694143252,3922.736044406891,472.0319674015045,3151.3616342544556,26191,5977,20214,20214,0,31,5941000.0
5941,5941999,20.60672731316169,37.869701567077314,0.07997332846610927,3923.2314722537994,472.09913873672485,3152.457459449768,26191,5977,20214,20214,0,31,5942000.0
5942,5942999,20.6075749218445,37.870177625626525,0.07997795651902695,3923.8423874378204,472.1657192707062,3152.918251991272,26193,5978,20215,20215,0,31,5943000.0
5943,5943999,20.608166473314327,37.87025902064961,0.07998129936678822,3924.455685377121,472.2339737415314,3153.4561471939087,26195,5979,20216,20216,0,31,5944000.0
5944,5944999,20.608721092541625,37.870162489947504,0.07998386990236206,3925.3546051979065,472.3021230697632,3152.4354333877563,26197,5980,20217,20217,0,31,5945000.0
5945,5945999,20.60900309798173,37.86947059537853,0.07998997195274393,3926.220461130142,472.3709363937378,3151.8808908462524,26199,5981,20218,20218,0,31,5946000.0
5946,5946999,20.60815913246831,37.86786841467439,0.07998573567743839,3926.604439020157,472.44590401649475,3153.817261695862,26218,5981,20237,20237,0,31,5947000.0
5947,5947999,20.60704365534116,37.86617575398527,0.07998571676481436,3926.774596452713,472.5112352371216,3156.629906654358,26225,5981,20244,20244,0,31,5948000.0
5948,5948999,20.606286828092653,37.86519491035919,0.07998371962267614,3927.7412168979645,472.5778138637543,3155.418984413147,26227,5981,20246,20246,0,31,5949000.0
5949,5949999,20.605463663051662,37.86342604373871,0.07998730598935322,3928.0408391952515,472.6457395553589,3157.6061639785767,26230,5982,20248,20248,0,31,5950000.0
5950,5950999,20.604698730094526,37.86165397745138,0.0799873102877462,3928.7604982852936,472.7127811908722,3157.639039039612,26235,5984,20251,20251,0,31,5951000.0
5951,5951999,20.604204827924956,37.86123959359867,0.07998169166760094,3929.5014460086823,472.782169342041,3157.4355096817017,26242,5987,20255,20255,0,31,5952000.0
5952,5952999,20.603244137831283,37.85952656989899,0.07997982156145633,3930.1917266845703,472.8529407978058,3157.8080377578735,26245,5988,20257,20257,0,31,5953000.0
5953,5953999,20.6025471031085,37.85793610051649,0.0799779425262217,3930.4632053375244,472.92154026031494,3160.12930393219,26245,5988,20257,20257,0,31,5954000.0
5954,5954999,20.602134780345544,37.85720396475145,0.07997475915829366,3931.132033586502,472.9896035194397,3160.4073038101196,26245,5988,20257,20257,0,31,5955000.0
5955,5955999,20.60175332111206,37.855982654361895,0.07997266142018755,3931.6710970401764,473.05744767189026,3161.3693323135376,26245,5988,20257,20257,0,31,5956000.0
5956,5956999,20.60124549180421,37.854888497771725,0.07997504083524032,3932.4763717651367,473.12726044654846,3160.876908302307,26247,5989,20258,20258,0,31,5957000.0
5957,5957999,20.601119863776432,37.8538556456357,0.07997440331105898,3932.896507501602,473.1957492828369,3162.461838722229,26264,5990,20274,20274,0,31,5958000.0
5958,5958999,20.601062746275304,37.853877786763796,0.07997260529257999,3933.6029319763184,473.26223063468933,3162.5882425308228,26264,5990,20274,20274,0,31,5959000.0
5959,5959999,20.601337819761245,37.85412313558076,0.07996894682900257,3933.7914555072784,473.32973313331604,3165.2047510147095,26264,5990,20274,20274,0,31,5960000.0
5960,5960999,20.601289862226917,37.85346145840748,0.07996804126653956,3934.8245067596436,473.3970148563385,3163.537163734436,26271,5993,20278,20278,0,31,5961000.0
5961,5961999,20.601744740128645,37.85400305837622,0.07997038413426372,3935.6040551662445,473.4652638435364,3163.3900003433228,26271,5993,20278,20278,0,31,5962000.0
5962,5962999,20.601901332088577,37.85352469684171,0.07997492467175771,3936.4266934394836,473.53346157073975,3162.709313392639,26275,5995,20280,20280,0,31,5963000.0
5963,5963999,20.602022413770012,37.85284606458957,0.07998146409410278,3936.9164147377014,473.59958004951477,3163.8634424209595,26277,5996,20281,20281,0,31,5964000.0
5964,5964999,20.602223478042472,37.85251583996659,0.07997480565500426,3937.718158006668,473.66958022117615,3163.8649530410767,26303,5998,20305,20305,0,31,5965000.0
5965,5965999,20.60280009727295,37.85235971517295,0.07997140669396119,3938.4212198257446,473.73644828796387,3163.8931589126587,26305,5999,20306,20306,0,31,5966000.0
5966,5966999,20.602474564395678,37.85105541492129,0.07996539285994408,3938.9161381721497,473.8040544986725,3164.9570932388306,26305,5999,20306,20306,0,31,5967000.0
5967,5967999,20.602039328237105,37.85088159685799,0.07993938267431999,3939.181885957718,473.8708920478821,3167.420044898987,26325,5999,20326,20326,0,31,5968000.0
5968,5968999,20.600951302707024,37.84870849246523,0.07994186258685354,3939.862725496292,473.9391837120056,3167.7167749404907,26334,6000,20334,20334,0,31,5969000.0
5969,5969999,20.59988898652533,37.84661866756866,0.07994314462747898,3957.3287694454193,474.00827622413635,3168.8156213760376,26341,6002,20339,20339,0,31,5970000.0
5970,5970999,20.59924930862976,37.84518784426255,0.0799411471810213,3957.6276552677155,474.0751984119415,3171.028290748596,26345,6003,20342,20342,0,31,5971000.0
5971,5971999,20.598578640224417,37.843980143073125,0.07993793831091844,3958.3738045692444,474.14380288124084,3171.101761817932,26355,6007,20348,20348,0,31,5972000.0
5972,5972999,20.598067289564117,37.84294403718228,0.0799293776137533,3959.296486377716,474.2126522064209,3170.1564722061157,26359,6009,20350,20350,0,31,5973000.0
5973,5973999,20.5975571741059,37.844567364110645,0.07991992925240421,3959.8891620635986,474.28190541267395,3170.8975687026978,26364,6011,20353,20353,0,31,5974000.0
5974,5974999,20.59687911615298,37.84292751195566,0.07991854397104148,3960.273336648941,474.34978675842285,3172.6902475357056,26364,6011,20353,20353,0,31,5975000.0
5975,5975999,20.596589982205817,37.841889389360524,0.07991012332565794,3960.980374097824,474.4189133644104,3172.763306617737,26368,6013,20355,20355,0,31,5976000.0
5976,5976999,20.596586901394172,37.84184359261303,0.07990154137237715,3961.518448114395,474.48786973953247,3173.5823221206665,26370,6014,20356,20356,0,31,5977000.0
5977,5977999,20.596803761734943,37.84238342608651,0.07990813834477906,3962.209279537201,474.55656576156616,3173.695466041565,26370,6014,20356,20356,0,31,5978000.0
5978,5978999,20.59705298033615,37.84433013920514,0.0799090045848192,3962.8327119350433,474.625417470932,3174.0929956436157,26372,6015,20357,20357,0,31,5979000.0
5979,5979999,20.597492933461314,37.84496576470635,0.07990405722251404,3963.337100982666,474.6949598789215,3175.214150428772,26372,6015,20357,20357,0,31,5980000.0
5980,5980999,20.598214631086115,37.84671157822148,0.07989869808084837,3963.9736037254333,474.76462507247925,3175.93008518219,26405,6017,20388,20388,0,31,5981000.0
5981,5981999,20.598877436481587,37.84764350751662,0.07989166268397208,3964.78830242157,474.8365123271942,3175.4820642471313,26415,6020,20395,20395,0,31,5982000.0
5982,5982999,20.599684178660585,37.84896330011105,0.07990128868788537,3965.3059747219086,474.9152865409851,3176.8807764053345,26415,6020,20395,20395,0,31,5983000.0
5983,5983999,20.60053968994015,37.850114430701595,0.0798977685759521,3966.4118020534515,474.9851813316345,3174.998131752014,26417,6021,20396,20396,0,31,5984000.0
5984,5984999,20.601414163746583,37.85125964054927,0.07990777221405176,3966.8096346855164,475.05483984947205,3176.597664833069,26417,6021,20396,20396,0,31,5985000.0
5985,5985999,20.602607978577613,37.85297463670161,0.0799008545653297,3967.4418132305145,475.1330952644348,3177.070450782776,26419,6022,20397,20397,0,31,5986000.0
5986,5986999,20.604128485352952,37.85553981220287,0.07989473953563986,3967.9748034477234,475.2035937309265,3177.934205055237,26421,6023,20398,20398,0,31,5987000.0
5987,5987999,20.604430468234295,37.855409347033245,0.07988912753526434,3968.370221376419,475.2740709781647,3179.584687232971,26421,6023,20398,20398,0,31,5988000.0
5988,5988999,20.603330868288005,37.85386181941918,0.07988649876514253,3969.0240454673767,475.34367275238037,3180.169632911682,26449,6023,20426,20426,0,31,5989000.0
5989,5989999,20.601869328633743,37.85201600999118,0.0798924521795783,3969.4077699184418,475.4107663631439,3181.9739847183228,26455,6023,20432,20432,0,31,5990000.0
5990,5990999,20.600691925942595,37.85078458790144,0.07989486119203804,3969.9094800949097,475.47871255874634,3183.09325504303,26463,6025,20438,20438,0,31,5991000.0
5991,5991999,20.59956250521632,37.84894349520785,0.07989997189109632,3970.4023394584656,475.5452735424042,3184.4146661758423,26468,6026,20442,20442,0,31,5992000.0
5992,5992999,20.59847956772085,37.84724644472528,0.07990030034545936,3970.823976993561,475.61332297325134,3186.2187814712524,26469,6026,20443,20443,0,31,5993000.0
5993,5993999,20.597276741028857,37.845236003061174,0.07990551662783696,3971.750261068344,475.68173909187317,3185.18358707428,26484,6029,20455,20455,0,31,5994000.0
5994,5994999,20.596102930140695,37.843068913960394,0.07991015986954686,3972.5820741653442,475.75172662734985,3184.890664100647,26487,6030,20457,20457,0,31,5995000.0
5995,5995999,20.59544894886737,37.84226023964647,0.07990650925702936,3973.0453972816467,475.8173668384552,3186.300042152405,26489,6031,20458,20458,0,31,5996000.0
5996,5996999,20.59457621389587,37.84096597367855,0.07990948907516426,3973.517426252365,475.8850917816162,3187.347626686096,26491,6032,20459,20459,0,31,5997000.0
5997,5997999,20.593938662878273,37.839899735439126,0.07991456227147975,3973.912961244583,475.9515688419342,3188.991364479065,26491,6032,20459,20459,0,31,5998000.0
5998,5998999,20.593282896215566,37.83868968301105,0.07992588206870044,3974.796954393387,476.0217390060425,3188.3070154190063,26493,6033,20460,20460,0,31,5999000.0
5999,5999999,20.592595894333286,37.83761689933139,0.079932455929979,3975.2868247032166,476.0882639884949,3189.396653175354,26493,6033,20460,20460,0,31,6000000.0
6000,6000999,20.59217688148222,37.83685779173392,0.07993565481414666,3975.77894115448,476.15601348876953,3190.4783487319946,26512,6034,20478,20478,0,31,6001000.0
6001,6001999,20.591552553934868,37.83552300189694,0.07994276931061661,3976.6671011447906,476.2243387699127,3189.6274042129517,26514,6035,20479,20479,0,31,6002000.0
6002,6002999,20.590678184181886,37.83358096061531,0.07995465360631038,3977.278619289398,476.293963432312,3190.1923151016235,26514,6035,20479,20479,0,31,6003000.0
6003,6003999,20.589787272446493,37.8317817573548,0.07996629887834483,3977.851390838623,476.36207842826843,3191.1182718276978,26516,6036,20480,20480,0,31,6004000.0
6004,6004999,20.588687663618675,37.829543666637285,0.07997857719130341,3978.697211265564,476.43229722976685,3190.244278907776,26521,6038,20483,20483,0,31,6005000.0
6005,6005999,20.587763170028566,37.82827134387722,0.07998213749403538,3979.0788803100586,476.49993324279785,3192.128846168518,26553,6039,20514,20514,0,31,6006000.0
6006,6006999,20.586496391738706,37.82657496772132,0.07999281212503251,3979.3072533607483,476.5691349506378,3194.8917932510376,26557,6039,20518,20518,0,31,6007000.0
6007,6007999,20.58580801828878,37.833013853516874,0.07996299300828313,3979.9084758758545,476.6350781917572,3195.483353614807,26561,6041,20520,20520,0,31,6008000.0
6008,6008999,20.585325332112237,37.835526937420035,0.07995670299758806,3980.3206973075867,476.70486640930176,3197.1127557754517,26570,6042,20528,20528,0,31,6009000.0
6009,6009999,20.584312549462467,37.83375626767972,0.0799607762547705,3980.5970256328583,476.77164101600647,3199.431191444397,26570,6042,20528,20528,0,31,6010000.0
6010,6010999,20.58329849175673,37.83206071112076,0.07996339420531784,3981.3908953666687,476.8415026664734,3199.10839176178,26584,6044,20540,20540,0,31,6011000.0
6011,6011999,20.582217840445885,37.83012716946166,0.07996817693739888,3982.117619752884,476.9117774963379,3199.234025001526,26592,6048,20544,20544,0,31,6012000.0
6012,6012999,20.58134343357266,37.82866894982193,0.07996992655650181,3982.7633907794952,476.98221135139465,3199.7213373184204,26601,6052,20549,20549,0,31,6013000.0
6013,6013999,20.580691387685274,37.82736805940493,0.07997043343506272,3983.679008960724,477.0530939102173,3198.9881830215454,26605,6054,20551,20551,0,31,6014000.0
6014,6014999,20.579983130108612,37.82604214586642,0.07997101661332096,3984.4158532619476,477.1215789318085,3198.9947900772095,26609,6056,20553,20553,0,31,6015000.0
6015,6015999,20.579192974070832,37.824675734739934,0.07997172853286127,3985.253926515579,477.19169425964355,3198.403420448303,26613,6058,20555,20555,0,31,6016000.0
6016,6016999,20.57845305898186,37.82307107045309,0.07997165566900355,3985.7781212329865,477.2619698047638,3199.339066505432,26619,6060,20559,20559,0,31,6017000.0
6017,6017999,20.57800239525971,37.822109446759534,0.07997110654737927,3986.1685485839844,477.3293266296387,3200.992714881897,26619,6060,20559,20559,0,31,6018000.0
6018,6018999,20.5776421909377,37.82259615701113,0.07996356928074844,3986.864672899246,477.39885449409485,3201.0688104629517,26619,6060,20559,20559,0,31,6019000.0
6019,6019999,20.57720167591367,37.8213392041489,0.07996702766356278,3987.564537525177,477.46953797340393,3201.1050729751587,26621,6061,20560,20560,0,31,6020000.0
6020,6020999,20.577092331219138,37.820974767539624,0.07996520159878351,3987.8622493743896,477.5421447753906,3203.223084449768,26621,6061,20560,20560,0,31,6021000.0
6021,6021999,20.57679443858895,37.82029109224849,0.07995845615205821,3988.2698307037354,477.6119236946106,3204.8256845474243,26621,6061,20560,20560,0,31,6022000.0
6022,6022999,20.576230511041704,37.81882562648845,0.07996456032467814,3989.420821905136,477.68055415153503,3202.440644264221,26625,6063,20562,20562,0,31,6023000.0
6023,6023999,20.57565700989421,37.817139453528924,0.07996276317210971,3990.1177926063538,477.74958086013794,3202.4742136001587,26625,6063,20562,20562,0,31,6024000.0
6024,6024999,20.57493524214507,37.81559466583326,0.07996033564739602,3990.512603521347,477.81745314598083,3204.261124610901,26644,6064,20580,20580,0,31,6025000.0
6025,6025999,20.574274760579016,37.81536650847193,0.07993990504448734,3991.2874369621277,477.88732743263245,3204.015236854553,26662,6065,20597,20597,0,31,6026000.0
6026,6026999,20.573119871919943,37.81318165295926,0.079936715366825,3991.5630326271057,477.95548725128174,3206.2501611709595,26664,6065,20599,20599,0,31,6027000.0
6027,6027999,20.572015520449927,37.81165503242338,0.07993314041704047,3992.3312578201294,478.0244040489197,3206.1712350845337,26665,6065,20600,20600,0,31,6028000.0
6028,6028999,20.57106531733013,37.80974772333497,0.079929789967643,3992.746358156204,478.09331369400024,3207.7818536758423,26676,6067,20609,20609,0,31,6029000.0
6029,6029999,20.570118071442444,37.80815706896964,0.07992428851070066,3993.551729440689,478.16155076026917,3207.3321619033813,26678,6068,20610,20610,0,31,6030000.0
6030,6030999,20.56930656836369,37.80735321900572,0.07991680639937282,3994.1361236572266,478.2300794124603,3208.056580543518,26686,6071,20615,20615,0,31,6031000.0
6031,6031999,20.568401894561042,37.80545536363319,0.07991464257330583,3994.4313366413116,478.2978706359863,3210.224549293518,26686,6071,20615,20615,0,31,6032000.0
6032,6032999,20.56743112276362,37.803402885835375,0.07991275166873124,3995.1888241767883,478.3680582046509,3210.451294898987,26688,6072,20616,20616,0,31,6033000.0
6033,6033999,20.56677015722996,37.80180975729265,0.07990722349767965,3995.8078949451447,478.43639159202576,3211.289216041565,26753,6074,20679,20679,0,31,6034000.0
6034,6034999,20.56613390067856,37.8005001246824,0.07990119607718249,3996.6093230247498,478.50867772102356,3211.2941675186157,26755,6075,20680,20680,0,31,6035000.0
6035,6035999,20.565351079407055,37.79876396208251,0.0799014996982308,3997.0173785686493,478.5759189128876,3212.972237586975,26757,6076,20681,20681,0,31,6036000.0
6036,6036999,20.564897582660183,37.79736492240439,0.07989922901569413,3997.704423427582,478.64639544487,3213.119019508362,26757,6076,20681,20681,0,31,6037000.0
6037,6037999,20.564414266038536,37.796307162205736,0.07989384180864667,3998.2215921878815,478.7143349647522,3214.178925514221,26759,6077,20682,20682,0,31,6038000.0
6038,6038999,20.563939845313477,37.7949133481288,0.07989137238739019,3998.625850915909,478.7833881378174,3215.7290048599243,26761,6078,20683,20683,0,31,6039000.0
6039,6039999,20.5632548939543,37.793281476363234,0.07989688485519675,3999.527982711792,478.85171341896057,3214.882447242737,26763,6079,20684,20684,0,31,6040000.0
6040,6040999,20.56251504022454,37.79151230089377,0.0799012677151727,4000.069244623184,478.91900157928467,3215.938370704651,26765,6080,20685,20685,0,31,6041000.0
6041,6041999,20.562115218264207,37.79025339444473,0.07989950298102788,4000.6303095817566,478.98742508888245,3216.6371698379517,26767,6081,20686,20686,0,31,6042000.0
6042,6042999,20.561446182979036,37.788482438198585,0.07990302591235254,4001.565525531769,479.0582537651062,3215.621590614319,26773,6083,20690,20690,0,31,6043000.0
6043,6043999,20.560705203987347,37.78674728530853,0.07990994760842274,4002.3079981803894,479.1274154186249,3215.6736307144165,26805,6085,20720,20720,0,31,6044000.0
6044,6044999,20.560023642226124,37.78502360487259,0.07991798821523999,4003.0248560905457,479.196729183197,3215.626229286194,26807,6086,20721,20721,0,31,6045000.0
6045,6045999,20.558914058611574,37.782733064791515,0.07993363791520303,4003.516310930252,479.26457595825195,3216.8406457901,26822,6087,20735,20735,0,31,6046000.0
6046,6046999,20.55752858305465,37.78174438712894,0.07994260169883427,4003.882886171341,479.3313615322113,3218.7351388931274,26836,6087,20749,20749,0,31,6047000.0
6047,6047999,20.556109053231463,37.78018972344945,0.07995094567838357,4004.3720049858093,479.4007477760315,3219.9856424331665,26840,6087,20753,20753,0,31,6048000.0
6048,6048999,20.554625431597724,37.77784023931952,0.07996439122842247,4004.9553933143616,479.46733570098877,3220.734948158264,26844,6089,20755,20755,0,31,6049000.0
6049,6049999,20.553294740226594,37.77581948163748,0.0799751573136046,4005.1434075832367,479.5335850715637,3223.4645776748657,26845,6089,20756,20756,0,31,6050000.0
6050,6050999,20.552020773510815,37.77347929886135,0.0799840013709534,4005.621877193451,479.60160279273987,3224.7487421035767,26845,6089,20756,20756,0,31,6051000.0
6051,6051999,20.550625654210997,37.77124440587133,0.08000028268120873,4006.6337735652924,479.66955852508545,3223.387001991272,26853,6092,20761,20761,0,31,6052000.0
6052,6052999,20.54925068373791,37.76888447145394,0.08001696469541442,4007.155906200409,479.7415657043457,3224.448365211487,26859,6094,20765,20765,0,31,6053000.0
6053,6053999,20.547865223970067,37.76664757596891,0.08002829913881504,4008.1654813289642,479.8110349178314,3223.095513343811,26865,6097,20768,20768,0,31,6054000.0
6054,6054999,20.546674242970404,37.76458867093058,0.08004223645542996,4008.5529413223267,479.8804700374603,3224.8738260269165,26865,6097,20768,20768,0,31,6055000.0
6055,6055999,20.545396776835698,37.76243434979891,0.08005704182287787,4008.8529913425446,479.9475495815277,3227.0184869766235,26865,6097,20768,20768,0,31,6056000.0
6056,6056999,20.544067645984978,37.76027715588312,0.08007142402851042,4009.5479125976562,480.01558232307434,3227.0990076065063,26865,6097,20768,20768,0,31,6057000.0
6057,6057999,20.542828353811114,37.75821337260962,0.08008400597269894,4010.4606006145477,480.08485317230225,3226.2246561050415,26869,6099,20770,20770,0,31,6058000.0
6058,6058999,20.54136529893643,37.75577114008797,0.08010072586929118,4010.7567899227142,480.1506600379944,3228.3554162979126,26870,6099,20771,20771,0,31,6059000.0
6059,6059999,20.540073942023312,37.753876738478006,0.0801133074511009,4011.7665510177612,480.2196168899536,3226.966187477112,26876,6101,20775,20775,0,31,6060000.0
6060,6060999,20.53897285912423,37.75221906668004,0.08012422377846651,4012.189986228943,480.28652572631836,3228.418206214905,26878,6102,20776,20776,0,31,6061000.0
6061,6061999,20.537901308520354,37.75025920826788,0.08013071249663595,4012.9060831069946,480.35362243652344,3228.58975315094,26882,6103,20779,20779,0,31,6062000.0
6062,6062999,20.537184214467068,37.749186270709835,0.08013397046366422,4013.3876163959503,480.4215602874756,3229.7641077041626,26882,6103,20779,20779,0,31,6063000.0
6063,6063999,20.53631338305205,37.74797286656123,0.08013914491928054,4013.880091190338,480.490549325943,3230.839898109436,26882,6103,20779,20779,0,31,6064000.0
6064,6064999,20.53538192143746,37.74640806498021,0.08015026418134574,4014.2810559272766,480.5595004558563,3232.405999183655,26882,6103,20779,20779,0,31,6065000.0
6065,6065999,20.53416776702082,37.74420514632449,0.08016358714059668,4015.391301870346,480.6291353702545,3230.393151283264,26884,6104,20780,20780,0,31,6066000.0
6066,6066999,20.532995671472154,37.742032896031745,0.08017274470441937,4015.7652752399445,480.69750714302063,3232.26268863678,26904,6105,20799,20799,0,31,6067000.0
6067,6067999,20.53154094646913,37.73968055972463,0.08018350170331257,4016.399726867676,480.76342582702637,3232.6478662490845,26911,6107,20804,20804,0,31,6068000.0
6068,6068999,20.53041638392181,37.738035982598014,0.08018866858177065,4017.038046836853,480.8311471939087,3233.2147607803345,26917,6110,20807,20807,0,31,6069000.0
6069,6069999,20.529263225823858,37.7359701543194,0.0801973940001881,4017.667795419693,480.90280508995056,3233.95555973053,26920,6111,20809,20809,0,31,6070000.0
6070,6070999,20.52826043969097,37.734301875402984,0.08020525809926715,4018.2935905456543,480.9698226451874,3234.559426307678,26924,6113,20811,20811,0,31,6071000.0
6071,6071999,20.527021693956666,37.73220939078334,0.0802153547410499,4018.975672721863,481.04040336608887,3234.90331363678,26924,6113,20811,20811,0,31,6072000.0
6072,6072999,20.52596806663622,37.73048751273505,0.08022251316082507,4019.577889919281,481.10653829574585,3235.4756021499634,26926,6114,20812,20812,0,31,6073000.0
6073,6073999,20.524991574710263,37.72877456455371,0.08022971192490036,4020.288230895996,481.1740691661835,3235.7779626846313,26936,6116,20820,20820,0,31,6074000.0
6074,6074999,20.524218100531282,37.72735647047764,0.08023564341481904,4021.053480863571,481.2433304786682,3235.653443336487,26944,6120,20824,20824,0,31,6075000.0
6075,6075999,20.523267157926124,37.72593739495531,0.08024541612496983,4021.7532045841217,481.3122749328613,3235.778260231018,26944,6120,20824,20824,0,31,6076000.0
6076,6076999,20.522264850259226,37.724198414560064,0.08025301216359948,4022.4146270751953,481.380234003067,3236.0400247573853,26948,6122,20826,20826,0,31,6077000.0
6077,6077999,20.52131376523473,37.72233884613971,0.08026354859760887,4023.230197906494,481.44822430610657,3235.6910104751587,26954,6124,20830,20830,0,31,6078000.0
6078,6078999,20.52024658045765,37.72035358245397,0.08027750625942787,4023.6196925640106,481.51659083366394,3237.3570642471313,26954,6124,20830,20830,0,31,6079000.0
6079,6079999,20.51912062132016,37.71836359926339,0.0802908684213055,4024.3338906764984,481.5840404033661,3237.446053504944,26962,6126,20836,20836,0,31,6080000.0
6080,6080999,20.51819341380882,37.71647434592242,0.08030442933516402,4024.828679561615,481.65358090400696,3238.5561990737915,26962,6126,20836,20836,0,31,6081000.0
6081,6081999,20.51706484894452,37.71434943459414,0.08031811629132646,4025.569727420807,481.7257192134857,3238.521767616272,26966,6128,20838,20838,0,31,6082000.0
6082,6082999,20.515972058979504,37.71235527491597,0.0803339773735594,4026.3005497455597,481.7930750846863,3238.3168115615845,26968,6129,20839,20839,0,31,6083000.0
6083,6083999,20.515071993157544,37.71132175643229,0.0803419380273781,4027.0445623397827,481.86108326911926,3238.2327127456665,26973,6131,20842,20842,0,31,6084000.0
6084,6084999,20.513930177633675,37.70924333829617,0.08035691436115233,4027.7854373455048,481.9289493560791,3238.092728614807,26975,6132,20843,20843,0,31,6085000.0
6085,6085999,20.512614972501105,37.70700686164118,0.08037260002024993,4028.0773293972015,481.9987781047821,3240.2219095230103,26975,6132,20843,20843,0,31,6086000.0
6086,6086999,20.511292731165486,37.70482775961296,0.08038266280669282,4028.4356331825256,482.0803666114807,3242.041199684143,26987,6133,20854,20854,0,31,6087000.0
6087,6087999,20.509703401743625,37.70258687474556,0.08038828395497155,4028.892087459564,482.140013217926,3243.262459754944,26990,6133,20857,20857,0,31,6088000.0
6088,6088999,20.508176745233666,37.70094812231513,0.08039010833336668,4029.2637991905212,482.1990854740143,3244.9544076919556,27008,6134,20874,20874,0,31,6089000.0
6089,6089999,20.506928486598568,37.699163694082785,0.08039411719908962,4029.7525334358215,482.2612895965576,3246.170350074768,27025,6137,20888,20888,0,31,6090000.0
6090,6090999,20.505612810248063,37.69694862763203,0.08039821437293848,4030.2326209545135,482.3218262195587,3247.453713417053,27032,6139,20893,20893,0,31,6091000.0
6091,6091999,20.504204714158682,37.694709876638896,0.08040357918896368,4030.715440273285,482.3839478492737,3248.6813821792603,27037,6140,20897,20897,0,31,6092000.0
6092,6092999,20.502877103350055,37.69387886484844,0.08040330138409835,4031.415927171707,482.4452636241913,3248.6719827651978,27042,6141,20901,20901,0,31,6093000.0
6093,6093999,20.501779659570694,37.69203663949605,0.08040528786782408,4031.99151968956,482.50738167762756,3249.322838783264,27044,6141,20903,20903,0,31,6094000.0
6094,6094999,20.50057825781761,37.68988166596622,0.0804086545544429,4032.486501455307,482.5698997974396,3250.410035133362,27047,6142,20905,20905,0,31,6095000.0
6095,6095999,20.499614454992628,37.68807236256569,0.08040880004194662,4033.285725593567,482.63318371772766,3249.95343875885,27056,6143,20913,20913,0,31,6096000.0
6096,6096999,20.498622830112897,37.686205691772024,0.08040997067916633,4033.8598799705505,482.69482231140137,3250.555916786194,27057,6143,20914,20914,0,31,6097000.0
6097,6097999,20.49754952467188,37.684119033224405,0.08041776111400367,4034.6640174388885,482.75643944740295,3250.060212135315,27061,6145,20916,20916,0,31,6098000.0
6098,6098999,20.496455567596087,37.68237980726413,0.08042521225422605,4035.2594842910767,482.8199653625488,3250.6558237075806,27061,6145,20916,20916,0,31,6099000.0
6099,6099999,20.495456586171418,37.680782048851675,0.08042810339951256,4035.741486787796,482.88072633743286,3251.7418298721313,27063,6146,20917,20917,0,31,6100000.0
6100,6100999,20.494415730597535,37.67891163015433,0.08042992917360214,4036.2216398715973,482.943368434906,3252.901291847229,27063,6146,20917,20917,0,31,6101000.0
6101,6101999,20.493493053124805,37.67702069025197,0.08043858092771616,4037.208348274231,483.0074198246002,3251.386315345764,27065,6147,20918,20918,0,31,6102000.0
6102,6102999,20.492480005323536,37.67509161294183,0.08044262898511889,4037.69171500206,483.0690541267395,3252.442147254944,27067,6148,20919,20919,0,31,6103000.0
6103,6103999,20.491803167272327,37.67371264355352,0.0804435735266632,4038.4844539165497,483.1314289569855,3251.967728614807,27070,6149,20921,20921,0,31,6104000.0
6104,6104999,20.490864568951793,37.6729344564364,0.08044123130648395,4039.070945739746,483.19615483283997,3252.4929780960083,27073,6150,20923,20923,0,31,6105000.0
6105,6105999,20.489910538031168,37.67098402049301,0.08044338127498407,4039.6582214832306,483.2599575519562,3253.111050605774,27078,6152,20926,20926,0,31,6106000.0
6106,6106999,20.488912088828332,37.669021198500445,0.08044721078135486,4040.4567379951477,483.32222986221313,3252.5600938796997,27087,6153,20934,20934,0,31,6107000.0
6107,6107999,20.487974447054707,37.66749883774915,0.08044660128162118,4041.010712146759,483.38546562194824,3253.3352403640747,27096,6153,20943,20943,0,31,6108000.0
6108,6108999,20.4870659915047,37.66652676900419,0.08043448585254265,4041.4834926128387,483.44702792167664,3254.5068407058716,27098,6153,20945,20945,0,31,6109000.0
6109,6109999,20.485797541531426,37.66435532638882,0.08043664327550304,4041.961117744446,483.50848364830017,3255.692639350891,27102,6154,20948,20948,0,31,6110000.0
6110,6110999,20.48472598255788,37.66217621839038,0.08044095142864727,4042.5757069587708,483.570965051651,3256.247410774231,27106,6155,20951,20951,0,31,6111000.0
6111,6111999,20.48382335846197,37.66062818352051,0.08043732330402187,4043.1904497146606,483.63493299484253,3256.852749824524,27108,6156,20952,20952,0,31,6112000.0
6112,6112999,20.482973003924478,37.65910978748991,0.08043285263096112,4043.8981642723083,483.69785237312317,3256.8644075393677,27112,6158,20954,20954,0,31,6113000.0
6113,6113999,20.482161327316327,37.657544561434676,0.08042915977757747,4044.62420797348,483.76188373565674,3256.875096321106,27114,6159,20955,20955,0,31,6114000.0
6114,6114999,20.481159413487333,37.655655022207625,0.08043172019783229,4045.386922121048,483.8257689476013,3256.79665851593,27117,6160,20957,20957,0,31,6115000.0
6115,6115999,20.480154424196147,37.653654993439766,0.08043421147400842,4045.6784648895264,483.8880956172943,3258.912190437317,27117,6160,20957,20957,0,31,6116000.0
6116,6116999,20.479434423516206,37.65230906749281,0.08043187893092563,4046.447473526001,483.95232629776,3258.72789478302,27126,6162,20964,20964,0,31,6117000.0
6117,6117999,20.478519894092386,37.65048256383065,0.08043322229275818,4047.0455243587494,484.0140914916992,3259.3209657669067,27126,6162,20964,20964,0,31,6118000.0
6118,6118999,20.47780447901692,37.64894914404264,0.08043007989468309,4047.8432173728943,484.0761196613312,3259.038510322571,27128,6163,20965,20965,0,31,6119000.0
6119,6119999,20.477006409964904,37.647512866355065,0.08042992781643021,4048.555499792099,484.13765597343445,3259.0790910720825,27140,6165,20975,20975,0,31,6120000.0
6120,6120999,20.47630239956026,37.645984822573084,0.0804245806161692,4049.3741240501404,484.20182490348816,3258.6460313796997,27143,6166,20977,20977,0,31,6121000.0
6121,6121999,20.475724598299486,37.64476957091384,0.08041961567084543,4049.7737908363342,484.26404905319214,3260.2406435012817,27143,6166,20977,20977,0,31,6122000.0
6122,6122999,20.474960217122693,37.64347095377644,0.08041841835656438,4050.562956094742,484.3277521133423,3259.769513130188,27143,6166,20977,20977,0,31,6123000.0
6123,6123999,20.474379794963284,37.642162762360904,0.08041475588390634,4051.294247865677,484.3914985656738,3259.4547624588013,27145,6167,20978,20978,0,31,6124000.0
6124,6124999,20.473805239010876,37.64078330556166,0.0804129465809389,4051.7007410526276,484.4582779407501,3260.9189500808716,27147,6168,20979,20979,0,31,6125000.0
6125,6125999,20.473154924088167,37.63922619401369,0.08041293709352615,4052.310451030731,484.51960492134094,3261.419415473938,27149,6169,20980,20980,0,31,6126000.0
6126,6126999,20.472617648929628,37.637823447609684,0.08040870638276565,4052.707503795624,484.581179857254,3263.00328540802,27151,6170,20981,20981,0,31,6127000.0
6127,6127999,20.471892002708515,37.63658032532009,0.08040614654022837,4053.5969183444977,484.64502930641174,3262.1575441360474,27157,6173,20984,20984,0,31,6128000.0
6128,6128999,20.471046155353278,37.634853771841044,0.08040924760618007,4054.313553571701,484.7073497772217,3262.2403841018677,27171,6174,20997,20997,0,31,6129000.0
6129,6129999,20.470032399256382,37.63316095240044,0.08041272554663548,4055.0365674495697,484.77323961257935,3262.276021003723,27175,6175,21000,21000,0,31,6130000.0
6130,6130999,20.46899651969721,37.63101288900613,0.08041974778250782,4055.529584646225,484.83766055107117,3263.3969621658325,27180,6176,21004,21004,0,31,6131000.0
6131,6131999,20.468280100184042,37.62999674216481,0.08041660523157756,4056.0348942279816,484.90272879600525,3264.4989137649536,27184,6177,21007,21007,0,31,6132000.0
6132,6132999,20.467328184720223,37.62861562458141,0.08041913833291436,4056.8330793380737,484.9655900001526,3264.0607957839966,27184,6177,21007,21007,0,31,6133000.0
6133,6133999,20.46622928137195,37.626533606230076,0.0804271301811067,4057.3099415302277,485.02967834472656,3265.3190965652466,27184,6177,21007,21007,0,31,6134000.0
6134,6134999,20.46528695214305,37.62495413709112,0.08043053517524512,4057.9484944343567,485.09265303611755,3265.709439277649,27193,6178,21015,21015,0,31,6135000.0
6135,6135999,20.46422763623783,37.62272890236042,0.0804392675750677,4058.643785238266,485.155944108963,3265.751347541809,27193,6178,21015,21015,0,31,6136000.0
6136,6136999,20.463143171131414,37.62052632121661,0.08044754051765457,4059.3465502262115,485.2194571495056,3265.7516984939575,27195,6179,21016,21016,0,31,6137000.0
6137,6137999,20.462172157194683,37.61844607083448,0.08045661382950375,4059.816780567169,485.2821636199951,3267.123860359192,27195,6179,21016,21016,0,31,6138000.0
6138,6138999,20.461357258434766,37.616658507261405,0.08046412735296848,4060.8262701034546,485.3487961292267,3265.839539527893,27202,6181,21021,21021,0,31,6139000.0
6139,6139999,20.46031933510494,37.6146115153846,0.08047276683725124,4061.3654680252075,485.41190552711487,3266.5787210464478,27204,6182,21022,21022,0,31,6140000.0
6140,6140999,20.45935609144048,37.61246256473048,0.08048757996270783,4061.860213279724,485.4741008281708,3267.6397638320923,27204,6182,21022,21022,0,31,6141000.0
6141,6141999,20.45844900770579,37.61049052282214,0.08050356986736551,4062.6916546821594,485.5362882614136,3266.9797983169556,27204,6182,21022,21022,0,31,6142000.0
6142,6142999,20.457393604045997,37.608359548847936,0.08051790348930443,4063.422068119049,485.60051560401917,3266.8961725234985,27210,6185,21025,21025,0,31,6143000.0
6143,6143999,20.45633312493041,37.60617739850577,0.08052985277390257,4063.9147210121155,485.66199946403503,3267.9766550064087,27210,6185,21025,21025,0,31,6144000.0
6144,6144999,20.45551567916056,37.60592316396739,0.08053213216152721,4064.787035226822,485.72413516044617,3267.0699701309204,27223,6189,21034,21034,0,31,6145000.0
6145,6145999,20.454293116175172,37.60416255466573,0.08054474759205199,4065.2553799152374,485.78488779067993,3268.408616065979,27234,6189,21045,21045,0,31,6146000.0
6146,6146999,20.453025338980048,37.6023967268935,0.08056120295324365,4065.734801530838,485.84641337394714,3269.605927467346,27239,6189,21050,21050,0,31,6147000.0
6147,6147999,20.452011693185074,37.60110668625739,0.08056906579325152,4066.441792488098,485.90823459625244,3269.6299142837524,27241,6190,21051,21051,0,31,6148000.0
6148,6148999,20.450906689035673,37.59917335018281,0.08058109289543225,4067.0848965644836,485.97111654281616,3270.328850746155,27241,6190,21051,21051,0,31,6149000.0
6149,6149999,20.449782405785548,37.59732305985437,0.0805915425076047,4067.4743757247925,486.03338623046875,3271.936890602112,27241,6190,21051,21051,0,31,6150000.0
6150,6150999,20.44860755063666,37.59525399481121,0.08060096175945564,4068.149696111679,486.0971932411194,3272.295250892639,27241,6190,21051,21051,0,31,6151000.0
6151,6151999,20.44740744823633,37.59310093740296,0.08061085458707273,4069.089893102646,486.1609516143799,3271.2049493789673,27246,6192,21054,21054,0,31,6152000.0
6152,6152999,20.44644924448708,37.592029734893686,0.08061381746045926,4069.5839161872864,486.22434878349304,3272.2820901870728,27246,6192,21054,21054,0,31,6153000.0
6153,6153999,20.445299754112398,37.5899792653022,0.08062068187614391,4070.037047147751,486.2865996360779,3273.5046167373657,27250,6194,21056,21056,0,31,6154000.0
6154,6154999,20.444539316149196,37.588878797566466,0.08062185011538381,4070.5432317256927,486.3524763584137,3274.654725074768,27250,6194,21056,21056,0,31,6155000.0
6155,6155999,20.44355018891697,37.58728911792899,0.08062558657941044,4071.403411388397,486.41506695747375,3273.9163675308228,27264,6197,21067,21067,0,31,6156000.0
6156,6156999,20.442330737747056,37.58509942058196,0.0806324175770815,4072.1446611881256,486.4778525829315,3273.961754798889,27264,6197,21067,21067,0,31,6157000.0
6157,6157999,20.44155099998508,37.58360794486137,0.08063462397614096,4072.9252626895905,486.5405099391937,3273.8116998672485,27266,6198,21068,21068,0,31,6158000.0
6158,6158999,20.44077893633902,37.58208177492526,0.08063499422904474,4073.5207068920135,486.6029095649719,3274.3799295425415,27266,6198,21068,21068,0,31,6159000.0
6159,6159999,20.439973190944308,37.580476674659195,0.08063481463507405,4074.2225415706635,486.6694264411926,3274.403275489807,27276,6199,21077,21077,0,31,6160000.0
6160,6160999,20.439366699912764,37.57914784642052,0.08063377916696468,4075.185234069824,486.73537373542786,3273.337327003479,27284,6202,21082,21082,0,31,6161000.0
6161,6161999,20.438606371956592,37.577441726479314,0.08063184892714004,4075.4768068790436,486.7986617088318,3275.443070411682,27284,6202,21082,21082,0,31,6162000.0
6162,6162999,20.437865540559063,37.57586601163016,0.08063236960739695,4076.0294160842896,486.86299562454224,3276.076729774475,27286,6203,21083,21083,0,31,6163000.0
6163,6163999,20.43702106697587,37.57410034910125,0.08063499919427164,4077.049844264984,486.9325258731842,3274.5672159194946,27286,6203,21083,21083,0,31,6164000.0
6164,6164999,20.436037296394606,37.571940108755655,0.08064141647583989,4077.7355575561523,486.9967465400696,3274.6849451065063,27293,6203,21090,21090,0,31,6165000.0
6165,6165999,20.434874294111097,37.571248060369996,0.08064570976945906,4077.991917848587,487.05655169487,3276.940758705139,27297,6203,21094,21094,0,31,6166000.0
6166,6166999,20.433706237083676,37.56942714447445,0.08065327846283354,4078.2880227565765,487.11818623542786,3279.115471839905,27301,6204,21097,21097,0,31,6167000.0
6167,6167999,20.432415666279738,37.56737263695239,0.08066143374024226,4079.0287120342255,487.17968344688416,3279.143563270569,27310,6208,21102,21102,0,31,6168000.0
6168,6168999,20.43146326634469,37.56580211957141,0.08066222115642441,4079.5452127456665,487.24210500717163,3280.2493295669556,27314,6210,21104,21104,0,31,6169000.0
6169,6169999,20.430454630883197,37.56450591178889,0.08066392122650645,4080.661522626877,487.30604362487793,3278.4496545791626,27321,6213,21108,21108,0,31,6170000.0
6170,6170999,20.429215889699574,37.562385467913856,0.08067285224477871,4081.0656883716583,487.36843061447144,3280.0390100479126,27326,6214,21112,21112,0,31,6171000.0
6171,6171999,20.42807936613569,37.56052448182566,0.08067870032718061,4081.449946641922,487.4310805797577,3281.6711053848267,27326,6214,21112,21112,0,31,6172000.0
6172,6172999,20.426977517643344,37.55866257250746,0.08068416233255338,4082.2844920158386,487.4964323043823,3281.0684747695923,27328,6215,21113,21113,0,31,6173000.0
6173,6173999,20.425733316415634,37.556492922693096,0.08068879288758612,4083.042343378067,487.560528755188,3280.869683265686,27340,6217,21123,21123,0,31,6174000.0
6174,6174999,20.42492363798316,37.55729081082631,0.08067773606109585,4083.741453886032,487.62447142601013,3280.9443674087524,27340,6217,21123,21123,0,31,6175000.0
6175,6175999,20.423929462551495,37.555448845286044,0.08068088588061151,4084.6802501678467,487.6881844997406,3279.8785486221313,27344,6219,21125,21125,0,31,6176000.0
6176,6176999,20.423279602962793,37.55428315076791,0.08067682446055258,4085.465911626816,487.75018763542175,3279.510338783264,27344,6219,21125,21125,0,31,6177000.0
6177,6177999,20.42248733013832,37.55290062042784,0.08067235924181526,4085.7757799625397,487.8148412704468,3281.595185279846,27346,6220,21126,21126,0,31,6178000.0
6178,6178999,20.422481309268232,37.55259879750633,0.08065638862928604,4086.467673063278,487.8777949810028,3281.76300907135,27348,6221,21127,21127,0,31,6179000.0
6179,6179999,20.422291316591195,37.55209537952004,0.08064610359231816,4087.149564266205,487.94135761260986,3281.96141910553,27348,6221,21127,21127,0,31,6180000.0
6180,6180999,20.42226785471651,37.551881005302796,0.08063627746393753,4087.8604764938354,488.0053210258484,3281.928475379944,27353,6222,21131,21131,0,31,6181000.0
6181,6181999,20.422624556211954,37.55252461829536,0.08061724124088332,4088.4702718257904,488.0715436935425,3282.442635536194,27353,6222,21131,21131,0,31,6182000.0
6182,6182999,20.422797495812418,37.55250218129566,0.08061026280570716,4088.879520177841,488.13312911987305,3283.9104318618774,27355,6223,21132,21132,0,31,6183000.0
6183,6183999,20.42261605421869,37.55155012595876,0.0806043523075991,4089.6178131103516,488.1960287094116,3283.913140296936,27357,6224,21133,21133,0,31,6184000.0
6184,6184999,20.422244332640094,37.55035628889388,0.08059892919273948,4090.2094633579254,488.25883865356445,3284.4705286026,27357,6224,21133,21133,0,31,6185000.0
6185,6185999,20.421482994315593,37.548673620223035,0.08060100556894556,4091.018219947815,488.3246567249298,3284.171715736389,27372,6225,21147,21147,0,31,6186000.0
6186,6186999,20.41998125322285,37.54629123757715,0.08061116899473397,4091.383948326111,488.38663721084595,3286.0315866470337,27381,6226,21155,21155,0,31,6187000.0
6187,6187999,20.418793438759195,37.54496250192452,0.08060989452404776,4091.7659747600555,488.4487817287445,3287.765908241272,27383,6226,21157,21157,0,31,6188000.0
6188,6188999,20.417641526632583,37.54363094615358,0.08060999189176099,4092.416481733322,488.5131883621216,3288.3401651382446,27385,6227,21158,21158,0,31,6189000.0
6189,6189999,20.416414129668837,37.54137119881734,0.08061566417358879,4093.164379835129,488.5760233402252,3288.3496713638306,27386,6227,21159,21159,0,31,6190000.0
6190,6190999,20.415238541369696,37.53930586413604,0.08061742255685378,4093.7225465774536,488.6378309726715,3289.2096338272095,27393,6230,21163,21163,0,31,6191000.0
6191,6191999,20.414039952510983,37.53724832526789,0.08062196558471113,4094.8136792182922,488.706196308136,3287.496247291565,27410,6235,21175,21175,0,31,6192000.0
6192,6192999,20.412966396132475,37.53528435533699,0.08062669835911995,4095.260766506195,488.7679777145386,3288.7431268692017,27412,6236,21176,21176,0,31,6193000.0
6193,6193999,20.411853223826512,37.53319651544711,0.08063174038410836,4095.89843416214,488.83407044410706,3289.2518854141235,27412,6236,21176,21176,0,31,6194000.0
6194,6194999,20.410870562686593,37.53140917492468,0.08063550432696587,4096.71225976944,488.8966455459595,3288.800103187561,27414,6237,21177,21177,0,31,6195000.0
6195,6195999,20.41005444369841,37.52973567675256,0.08063824805345887,4097.323949575424,488.9607617855072,3289.392357826233,27417,6238,21179,21179,0,31,6196000.0
6196,6196999,20.409521539376783,37.52844257228353,0.08063501989726463,4098.2578065395355,489.02692317962646,3288.4418954849243,27419,6239,21180,21180,0,31,6197000.0
6197,6197999,20.40876617567505,37.52686051231643,0.08063460027750602,4098.798189163208,489.0894374847412,3289.264328956604,27428,6241,21187,21187,0,31,6198000.0
6198,6198999,20.408026007946628,37.5252056972401,0.08063430377897585,4099.296931028366,489.1545829772949,3290.35888004303,27430,6242,21188,21188,0,31,6199000.0
6199,6199999,20.407615005201862,37.524203456925875,0.08063101174145859,4100.003187179565,489.2187657356262,3290.3699808120728,27435,6243,21192,21192,0,31,6200000.0
6200,6200999,20.407297081161506,37.52318266225709,0.0806301610846003,4100.49193239212,489.28214740753174,3291.4612588882446,27435,6243,21192,21192,0,31,6201000.0
6201,6201999,20.407049492092316,37.52332810685514,0.08062511351307189,4101.091536998749,489.34502506256104,3292.0317010879517,27435,6243,21192,21192,0,31,6202000.0
6202,6202999,20.406616576632096,37.52204862229984,0.08062931326518896,4101.950736999512,489.41073513031006,3291.316964149475,27445,6247,21198,21198,0,31,6203000.0
6203,6203999,20.406295193393515,37.5208815048486,0.08063382110739115,4102.882543563843,489.47360706329346,3290.230507850647,27449,6249,21200,21200,0,31,6204000.0
6204,6204999,20.405738450772603,37.51931048073508,0.08064002867648223,4103.381151199341,489.5358703136444,3291.398522377014,27569,6250,21319,21319,0,31,6205000.0
6205,6205999,20.40497418384977,37.517423486836044,0.08064247262560731,4103.974913597107,489.601571559906,3292.009949684143,27569,6250,21319,21319,0,31,6206000.0
6206,6206999,20.403844527337455,37.51511990372987,0.0806528453893216,4104.427320480347,489.66451811790466,3293.734917640686,27586,6250,21336,21336,0,31,6207000.0
6207,6207999,20.40250616537431,37.512818599604806,0.08066401806072854,4104.693768978119,489.725789308548,3296.180390357971,27587,6250,21337,21337,0,31,6208000.0
6208,6208999,20.401230843235492,37.51081459161133,0.0806713962443264,4105.197069168091,489.7876844406128,3297.3562707901,27596,6252,21344,21344,0,31,6209000.0
6209,6209999,20.399960274630526,37.508496013625845,0.08068262967842277,4106.038996219635,489.8507606983185,3297.031777381897,27605,6256,21349,21349,0,31,6210000.0
6210,6210999,20.398894603327005,37.50673098557189,0.080686951901495,4106.565798044205,489.91500782966614,3298.1741342544556,27617,6258,21359,21359,0,31,6211000.0
6211,6211999,20.397813182910102,37.50490160306249,0.08069441998400462,4107.099144935608,489.97902035713196,3299.435082435608,27617,6258,21359,21359,0,31,6212000.0
6212,6212999,20.396595739604894,37.5030749173069,0.08070544343657649,4107.87766957283,490.0419626235962,3299.3106546401978,27622,6260,21362,21362,0,31,6213000.0
6213,6213999,20.395489917066502,37.501427003446246,0.08071099325158293,4108.487779378891,490.1055989265442,3299.937684059143,27624,6261,21363,21363,0,31,6214000.0
6214,6214999,20.39426817001715,37.499427345893714,0.08071967789626178,4109.274796247482,490.16874861717224,3299.683190345764,27634,6262,21372,21372,0,31,6215000.0
6215,6215999,20.393101436999977,37.497572100653095,0.08072759238462102,4109.814016580582,490.232928276062,3300.4681634902954,27636,6263,21373,21373,0,31,6216000.0
6216,6216999,20.3922730118329,37.496607292338474,0.08072881436333434,4110.547566652298,490.2988293170929,3300.386284828186,27640,6265,21375,21375,0,31,6217000.0
6217,6217999,20.39109879356219,37.49454212509737,0.0807392371738237,4111.227672100067,490.36546993255615,3300.6813745498657,27644,6267,21377,21377,0,31,6218000.0
6218,6218999,20.389951084709498,37.49255895611406,0.08074651667534849,4111.784223079681,490.430059671402,3301.8363428115845,27696,6269,21427,21427,0,31,6219000.0
6219,6219999,20.38883707396694,37.49060746043254,0.08075185073157776,4112.284538030624,490.4941282272339,3303.0615396499634,27696,6269,21427,21427,0,31,6220000.0
6220,6220999,20.38767374185053,37.488692459852444,0.08075932902497462,4113.320939064026,490.55815744400024,3301.6210565567017,27696,6269,21427,21427,0,31,6221000.0
6221,6221999,20.386682621047267,37.48721788836629,0.08076053709833786,4113.928603649139,490.61985087394714,3302.0900735855103,27705,6271,21434,21434,0,31,6222000.0
6222,6222999,20.38575040205734,37.48567273355437,0.08076087642952745,4114.406173467636,490.6826241016388,3303.247887611389,27705,6271,21434,21434,0,31,6223000.0
6223,6223999,20.384730085043955,37.4838410668499,0.08076416963739741,4114.70671749115,490.74658465385437,3305.367600440979,27705,6271,21434,21434,0,31,6224000.0
6224,6224999,20.38375054392205,37.48212302032576,0.08076648011549481,4115.258364200592,490.81217908859253,3306.0536432266235,27707,6272,21435,21435,0,31,6225000.0
6225,6225999,20.382697023935204,37.4800876681695,0.08077211435470444,4115.853189706802,490.8756368160248,3306.667618751526,27707,6272,21435,21435,0,31,6226000.0
6226,6226999,20.381513922890647,37.477842794878725,0.08078037725982556,4116.773175001144,490.9400360584259,3305.55597782135,27710,6273,21437,21437,0,31,6227000.0
6227,6227999,20.38050203435263,37.47682328730467,0.08078317516887645,4117.117001533508,491.00149059295654,3307.546654701233,27724,6273,21451,21451,0,31,6228000.0
6228,6228999,20.379313215116024,37.47487855659947,0.0807890229349374,4117.288058519363,491.0629324913025,3310.349221229553,27724,6273,21451,21451,0,31,6229000.0
6229,6229999,20.378018385636395,37.47257664381836,0.08079776670053207,4117.67425942421,491.1241729259491,3312.015862464905,27726,6274,21452,21452,0,31,6230000.0
6230,6230999,20.377028522946794,37.47228780567008,0.08080277519364465,4118.5075788497925,491.1870458126068,3311.6209421157837,27743,6278,21465,21465,0,31,6231000.0
6231,6231999,20.37564971472088,37.46999748004973,0.08081275433193924,4118.765635728836,491.2489347457886,3314.1155710220337,27743,6278,21465,21465,0,31,6232000.0
6232,6232999,20.374625531697856,37.46816610888527,0.08081973762743311,4119.674777984619,491.3117187023163,3313.2798776626587,27755,6280,21475,21475,0,31,6233000.0
6233,6233999,20.373608035231644,37.466564854200065,0.08082523362133043,4120.6774361133575,491.3746016025543,3311.9855127334595,27805,6283,21522,21522,0,31,6234000.0
6234,6234999,20.37281041017947,37.4651729610086,0.08082577551691039,4121.354304552078,491.43690752983093,3312.3948221206665,27813,6284,21529,21529,0,31,6235000.0
6235,6235999,20.37203143818928,37.46371168517671,0.08082988942712832,4121.846217632294,491.50050163269043,3313.6713495254517,27813,6284,21529,21529,0,31,6236000.0
6236,6236999,20.371529141589786,37.46303179359799,0.08082482514694822,4122.384546518326,491.5657057762146,3314.701668739319,27817,6286,21531,21531,0,31,6237000.0
6237,6237999,20.370865776492817,37.46210234439855,0.08082418831418814,4122.823003530502,491.62848234176636,3316.009575843811,27819,6287,21532,21532,0,31,6238000.0
6238,6238999,20.370324881471973,37.461631034349466,0.0808187526283689,4123.5108296871185,491.6924045085907,3316.23477268219,27821,6288,21533,21533,0,31,6239000.0
6239,6239999,20.36980837378622,37.46048873403904,0.08081636740238674,4124.33869099617,491.7554693222046,3315.613419532776,27825,6290,21535,21535,0,31,6240000.0
6240,6240999,20.36916792486526,37.459277525204946,0.08081796049349343,4124.744190216064,491.81918001174927,3317.2541284561157,27827,6291,21536,21536,0,31,6241000.0
6241,6241999,20.368499516417028,37.45786237757308,0.08081934514493827,4125.600701093674,491.8834590911865,3316.3370599746704,27831,6293,21538,21538,0,31,6242000.0
6242,6242999,20.368008122127833,37.45737275924244,0.08080978200197608,4125.990663290024,491.948885679245,3317.973801612854,27831,6293,21538,21538,0,31,6243000.0
6243,6243999,20.367499486723947,37.456133008947134,0.08081515085484903,4126.515445232391,492.01505875587463,3318.9159784317017,27833,6294,21539,21539,0,31,6244000.0
6244,6244999,20.367018991717774,37.4552047579794,0.08081259148306541,4127.212380170822,492.07930088043213,3318.9896326065063,27833,6294,21539,21539,0,31,6245000.0
6245,6245999,20.366346717909476,37.45368695213202,0.08080989790884885,4128.014592409134,492.1437327861786,3318.4660425186157,27835,6295,21540,21540,0,31,6246000.0
6246,6246999,20.365701097431373,37.45221028872753,0.08081572058864694,4128.511212110519,492.20815086364746,3319.5377893447876,27837,6296,21541,21541,0,31,6247000.0
6247,6247999,20.36492527080755,37.45066717885475,0.0808145646981906,4128.889499425888,492.2706780433655,3321.1422815322876,27837,6296,21541,21541,0,31,6248000.0
6248,6248999,20.363883088320843,37.44870691925489,0.08081971346320072,4129.038721084595,492.33510661125183,3324.2315530776978,27852,6296,21556,21556,0,31,6249000.0
6249,6249999,20.362530259833225,37.446734451070654,0.080827305487564,4129.418595790863,492.3970775604248,3326.008240699768,27861,6298,21563,21563,0,31,6250000.0
6250,6250999,20.361457957971602,37.44531233367637,0.08083112748679555,4129.880226135254,492.46002173423767,3327.234742164612,27862,6298,21564,21564,0,31,6251000.0
6251,6251999,20.360652853271116,37.44395419305055,0.08083387579715617,4130.477149248123,492.52322149276733,3327.931939125061,27869,6300,21569,21569,0,31,6252000.0
6252,6252999,20.359548008958757,37.441952271495886,0.08083849431117607,4130.865505695343,492.58905053138733,3329.7659997940063,27870,6300,21570,21570,0,31,6253000.0
6253,6253999,20.358420342106232,37.43976137089359,0.08084590569323713,4131.771130561829,492.6534912586212,3328.7974939346313,27875,6302,21573,21573,0,31,6254000.0
6254,6254999,20.357183444397645,37.43803393540468,0.08085147493389877,4132.2731239795685,492.7154414653778,3329.871438026428,27880,6304,21576,21576,0,31,6255000.0
6255,6255999,20.356504269628346,37.43718105710466,0.08085120173305671,4132.865442752838,492.7780284881592,3330.4814310073853,27882,6305,21577,21577,0,31,6256000.0
6256,6256999,20.355727306232062,37.43565315675102,0.08084828476911798,4133.349608659744,492.84119153022766,3331.5867395401,27882,6305,21577,21577,0,31,6257000.0
6257,6257999,20.355228070225436,37.43445150775373,0.0808404572094572,4151.771232366562,492.904901266098,3332.2345361709595,27892,6306,21586,21586,0,31,6258000.0
6258,6258999,20.354899929477504,37.43345502344986,0.0808331827390919,4152.4945657253265,492.9691092967987,3332.121537208557,27894,6307,21587,21587,0,31,6259000.0
6259,6259999,20.354689058044457,37.43317684226125,0.08082244126005111,4153.177049875259,493.03247570991516,3332.2011041641235,27894,6307,21587,21587,0,31,6260000.0
6260,6260999,20.354389705873633,37.43217403651469,0.08081794681603538,4153.558754205704,493.0958731174469,3333.8076791763306,27894,6307,21587,21587,0,31,6261000.0
6261,6261999,20.35415573995064,37.43142840332219,0.08081430287430258,4154.258239984512,493.1598527431488,3333.8418741226196,27896,6308,21588,21588,0,31,6262000.0
6262,6262999,20.354464575087388,37.43182080989228,0.0807966271121946,4155.053340673447,493.22225427627563,3333.3182077407837,27898,6309,21589,21589,0,31,6263000.0
6263,6263999,20.354690727104963,37.43194615670477,0.08079466500052956,4155.654261112213,493.284903049469,3333.7682123184204,27900,6310,21590,21590,0,31,6264000.0
6264,6264999,20.3548473574967,37.431593204160066,0.08078931165007752,4156.032872200012,493.3499450683594,3335.372925758362,27900,6310,21590,21590,0,31,6265000.0
6265,6265999,20.35532162360738,37.431850814929724,0.08077718402714928,4156.513478040695,493.413658618927,3336.448327064514,27900,6310,21590,21590,0,31,6266000.0
6266,6266999,20.35567759635632,37.43193117377169,0.08076560326928517,4157.319175958633,493.4774000644684,3335.9542474746704,27902,6311,21591,21591,0,31,6267000.0
6267,6267999,20.355726964719,37.43103973465101,0.08076248358375859,4157.921751976013,493.5435655117035,3336.5969858169556,27912,6313,21599,21599,0,31,6268000.0
6268,6268999,20.355404844117263,37.4299539845747,0.08075818589047212,4158.401686429977,493.60807967185974,3337.664750099182,27912,6313,21599,21599,0,31,6269000.0
6269,6269999,20.354318774076663,37.42809992074096,0.08076649600559005,4158.761021137238,493.6718690395355,3339.650559425354,27927,6313,21614,21614,0,31,6270000.0
6270,6270999,20.353065238081093,37.42605661665612,0.08077787534712189,4159.226938724518,493.7371680736542,3340.9561014175415,27929,6313,21616,21616,0,31,6271000.0
6271,6271999,20.35192569945611,37.42466204374997,0.08078695413678794,4159.84046292305,493.80087327957153,3341.633728981018,27945,6315,21630,21630,0,31,6272000.0
6272,6272999,20.350608985017413,37.4225285350522,0.08079716285794236,4160.345563411713,493.86440205574036,3342.7520151138306,27949,6316,21633,21633,0,31,6273000.0
6273,6273999,20.34932041272782,37.420351188397895,0.0808116264053369,4160.848272562027,493.9274249076843,3343.86278629303,27951,6317,21634,21634,0,31,6274000.0
6274,6274999,20.34832738145722,37.419256123701125,0.08081405422209631,4161.316477537155,493.9899871349335,3345.1774682998657,27952,6317,21635,21635,0,31,6275000.0
6275,6275999,20.3470877195256,37.4173621101407,0.08082225831660472,4162.020753145218,494.05226469039917,3345.3799142837524,27957,6319,21638,21638,0,31,6276000.0
6276,6276999,20.345990054805625,37.415745305131196,0.08082842011652513,4162.8130667209625,494.1154661178589,3344.939377784729,27960,6320,21640,21640,0,31,6277000.0
6277,6277999,20.344853589922735,37.41381141762102,0.08083571586566951,4163.601284265518,494.1779685020447,3344.4965143203735,27960,6320,21640,21640,0,31,6278000.0
6278,6278999,20.34382922375811,37.41215075834836,0.08084240755445604,4163.891019105911,494.2401783466339,3346.614846229553,27960,6320,21640,21640,0,31,6279000.0
6279,6279999,20.342865967678375,37.41060470665081,0.08084739615886471,4164.518677949905,494.30400133132935,3346.951439857483,27962,6321,21641,21641,0,31,6280000.0
6280,6280999,20.34185083184303,37.40876725241032,0.08085773043511013,4165.570995092392,494.367800951004,3345.23729801178,27976,6324,21652,21652,0,31,6281000.0
6281,6281999,20.341038780802993,37.407286811961086,0.08086720402965519,4165.857920408249,494.4348814487457,3347.3831872940063,27976,6324,21652,21652,0,31,6282000.0
6282,6282999,20.34020035015468,37.40582820464381,0.0808777200825932,4166.352400779724,494.4982006549835,3348.477021217346,27976,6324,21652,21652,0,31,6283000.0
6283,6283999,20.339192244438003,37.40400091826678,0.08089273265641161,4166.9567086696625,494.5620496273041,3349.0415353775024,27978,6325,21653,21653,0,31,6284000.0
6284,6284999,20.33803843816323,37.40180335733955,0.08090885686654226,4168.058826208115,494.6265914440155,3347.1059198379517,27980,6326,21654,21654,0,31,6285000.0
6285,6285999,20.336868679096984,37.3995308908592,0.08092734909186505,4168.550073862076,494.6923372745514,3348.180130958557,27980,6326,21654,21654,0,31,6286000.0
6286,6286999,20.335973006863775,37.39809031099338,0.08092913201229901,4169.032280921936,494.7562401294708,3349.58145236969,28004,6327,21677,21677,0,31,6287000.0
6287,6287999,20.334990928897554,37.39662328398626,0.08093837422163275,4169.511434078217,494.81924080848694,3350.849175453186,28005,6327,21678,21678,0,31,6288000.0
6288,6288999,20.334244135538448,37.397936430294735,0.08093457484543598,4170.01841044426,494.88249039649963,3352.006562232971,28016,6328,21688,21688,0,31,6289000.0
6289,6289999,20.333336508791785,37.396694415471565,0.08094437913565489,4170.428447723389,494.94509196281433,3353.558075904846,28020,6329,21691,21691,0,31,6290000.0
6290,6290999,20.332413723963185,37.395226885502424,0.08095324267591575,4171.29479765892,495.0101752281189,3353.081154823303,28041,6333,21708,21708,0,31,6291000.0
6291,6291999,20.331138022120097,37.39327118367663,0.08096533017287488,4171.894167423248,495.0770890712738,3353.8879556655884,28044,6334,21710,21710,0,31,6292000.0
6292,6292999,20.329977787460123,37.391418616821454,0.08097623327226788,4172.1884915828705,495.1411485671997,3356.046944618225,28044,6334,21710,21710,0,31,6293000.0
6293,6293999,20.328863527806057,37.38966722002755,0.08098049693639586,4173.092040777206,495.20937418937683,3355.5089349746704,28050,6337,21713,21713,0,31,6294000.0
6294,6294999,20.327819695158304,37.3876888925718,0.08098671783238542,4173.822957038879,495.27584528923035,3355.619957923889,28050,6337,21713,21713,0,31,6295000.0
6295,6295999,20.326669503220767,37.38561819003597,0.08099184302367923,4174.591368436813,495.3413631916046,3355.491623878479,28054,6339,21715,21715,0,31,6296000.0
6296,6296999,20.325859443356773,37.384382611092796,0.08098945800819646,4174.895978450775,495.406769990921,3357.637795448303,28054,6339,21715,21715,0,31,6297000.0
6297,6297999,20.325014075753483,37.38280292758168,0.08098993349240946,4175.5466475486755,495.47129678726196,3358.1695108413696,28058,6341,21717,21717,0,31,6298000.0
6298,6298999,20.324253451979207,37.38158546000405,0.08098677753616135,4176.551493167877,495.53706455230713,3356.7820520401,28069,6342,21727,21727,0,31,6299000.0
6299,6299999,20.323591218733434,37.38032871810733,0.08098425710261037,4176.8412618637085,495.5994575023651,3358.896569252014,28069,6342,21727,21727,0,31,6300000.0
6300,6300999,20.322933021084115,37.37886925046493,0.08098340676087579,4177.741008758545,495.666068315506,3357.942093849182,28069,6342,21727,21727,0,31,6301000.0
6301,6301999,20.322427691664874,37.377714277271565,0.08097776095688847,4178.215981960297,495.73028349876404,3359.0928888320923,28069,6342,21727,21727,0,31,6302000.0
6302,6302999,20.321871786113203,37.37652672991862,0.0809756481424786,4178.757528066635,495.79327964782715,3359.9078607559204,28073,6344,21729,21729,0,31,6303000.0
6303,6303999,20.321602887002296,37.37641403376945,0.08096388837154855,4179.551445007324,495.86046266555786,3359.5951318740845,28075,6345,21730,21730,0,31,6304000.0
6304,6304999,20.32118528532651,37.37531195544238,0.08095940328329998,4179.934636354446,495.9243497848511,3361.2634973526,28075,6345,21730,21730,0,31,6305000.0
6305,6305999,20.320660465190645,37.37448247578658,0.08094983314619175,4180.730827093124,495.9887447357178,3360.7732248306274,28077,6346,21731,21731,0,31,6306000.0
6306,6306999,20.320300457530458,37.37455351488726,0.08094130421618195,4181.208487272263,496.05227279663086,3362.2137155532837,28105,6347,21758,21758,0,31,6307000.0
6307,6307999,20.3194521418253,37.37363353088982,0.08093964778229956,4181.587711811066,496.1147029399872,3364.086396217346,28108,6347,21761,21761,0,31,6308000.0
6308,6308999,20.318516306683847,37.37170196244311,0.08094482224191613,4181.86851811409,496.1778082847595,3366.2857904434204,28108,6347,21761,21761,0,31,6309000.0
6309,6309999,20.31788045123925,37.370831792311655,0.08094659417447447,4182.469533443451,496.2422344684601,3366.895531654358,28112,6348,21764,21764,0,31,6310000.0
6310,6310999,20.317218742660074,37.369333809119716,0.08094721780606173,4183.195273160934,496.3080337047577,3366.9051065444946,28116,6350,21766,21766,0,31,6311000.0
6311,6311999,20.316275999493836,37.367225206049845,0.08095321774409714,4183.714721441269,496.37215638160706,3368.064003944397,28118,6351,21767,21767,0,31,6312000.0
6312,6312999,20.315309837380706,37.3652318105947,0.08095712201474725,4184.416739940643,496.43566846847534,3368.101761817932,28120,6352,21768,21768,0,31,6313000.0
6313,6313999,20.31472126497668,37.36406803836734,0.08095325398178554,4184.781477212906,496.49994230270386,3369.9160928726196,28120,6352,21768,21768,0,31,6314000.0
6314,6314999,20.31375436258744,37.36210616754303,0.08095661603854454,4185.372781038284,496.562908411026,3370.5047006607056,28121,6352,21769,21769,0,31,6315000.0
6315,6315999,20.31307354905873,37.36116374165025,0.08095214561206576,4186.020539522171,496.6261372566223,3370.714364051819,28125,6354,21771,21771,0,31,6316000.0
6316,6316999,20.31224860282281,37.359843691480364,0.08094947393952778,4186.416120767593,496.6913390159607,3372.3452310562134,28125,6354,21771,21771,0,31,6317000.0
6317,6317999,20.31163460104953,37.358499040787095,0.08094505350126435,4187.01716542244,496.75636744499207,3372.9571237564087,28125,6354,21771,21771,0,31,6318000.0
6318,6318999,20.311015093015328,37.3585996535366,0.08093511491219185,4187.761777877808,496.8215010166168,3372.9774713516235,28134,6356,21778,21778,0,31,6319000.0
6319,6319999,20.310358962085807,37.3572435296624,0.08093184036818679,4188.482006549835,496.8846945762634,3373.0073099136353,28139,6358,21781,21781,0,31,6320000.0
6320,6320999,20.309606652733912,37.355561017300815,0.08093253540257395,4189.117398738861,496.947785615921,3373.281838417053,28142,6360,21782,21782,0,31,6321000.0
6321,6321999,20.309056657070258,37.35410881737397,0.08093164545976494,4189.634598970413,497.01334524154663,3374.369355201721,28144,6361,21783,21783,0,31,6322000.0
6322,6322999,20.3085229674612,37.352708905139416,0.08092964013905424,4190.238266706467,497.07621574401855,3374.9550256729126,28146,6362,21784,21784,0,31,6323000.0
6323,6323999,20.308225155291854,37.35159844962447,0.08092311762858395,4190.869690895081,497.1392014026642,3375.659020423889,28148,6363,21785,21785,0,31,6324000.0
6324,6324999,20.307521923788492,37.3499962353833,0.08092246146631543,4191.661226511002,497.2027258872986,3375.1884775161743,28148,6363,21785,21785,0,31,6325000.0
6325,6325999,20.30678158975117,37.34822024044728,0.0809219967014555,4192.837502717972,497.2683446407318,3372.906289100647,28148,6363,21785,21785,0,31,6326000.0
6326,6326999,20.30609407947438,37.347105594269756,0.08091811456534803,4193.330405473709,497.3325684070587,3373.971947669983,28148,6363,21785,21785,0,31,6327000.0
6327,6327999,20.305354054804496,37.345542072180685,0.08090870208557144,4193.703262805939,497.3984808921814,3375.9801874160767,28166,6363,21803,21803,0,31,6328000.0
6328,6328999,20.304708900897683,37.344608769400615,0.08090295869643316,4193.97444152832,497.46270990371704,3378.266739845276,28169,6363,21806,21806,0,31,6329000.0
6329,6329999,20.303842893449694,37.343782417486686,0.08090162102333043,4194.654948949814,497.5266568660736,3378.425576210022,28171,6363,21808,21808,0,31,6330000.0
6330,6330999,20.302959313104672,37.34185874623203,0.08090461571850593,4194.9390461444855,497.58879804611206,3380.621018409729,28171,6363,21808,21808,0,31,6331000.0
6331,6331999,20.30191026662006,37.33979944876843,0.0809078687350363,4195.450450181961,497.6533534526825,3381.7348260879517,28171,6363,21808,21808,0,31,6332000.0
6332,6332999,20.301208621802456,37.338236409749136,0.08090446694179487,4196.288154363632,497.71768975257874,3381.199563026428,28176,6365,21811,21811,0,31,6333000.0
6333,6333999,20.30024019041416,37.33637456413249,0.08090416303644199,4196.815753221512,497.78162455558777,3382.2516412734985,28180,6367,21813,21813,0,31,6334000.0
6334,6334999,20.299439842433777,37.33470804430179,0.08090355604359989,4197.3845982551575,497.84731364250183,3383.186593055725,28180,6367,21813,21813,0,31,6335000.0
6335,6335999,20.298467985515373,37.3337233265158,0.0809036727236323,4198.020667314529,497.91274428367615,3383.7139139175415,28184,6369,21815,21815,0,31,6336000.0
6336,6336999,20.29763365720205,37.332003124286516,0.08090492202206423,4198.427220821381,497.97787380218506,3385.3312997817993,28184,6369,21815,21815,0,31,6337000.0
6337,6337999,20.296737479035958,37.330047826521636,0.08090827958836178,4199.0362713336945,498.0420684814453,3385.858437538147,28186,6370,21816,21816,0,31,6338000.0
6338,6338999,20.295815320307966,37.32820378418929,0.08091032757466998,4199.731021404266,498.1058449745178,3385.9497385025024,28186,6370,21816,21816,0,31,6339000.0
6339,6339999,20.294897573864212,37.32690756892491,0.08091344483243268,4200.351826906204,498.17260122299194,3386.5786752700806,28191,6372,21819,21819,0,31,6340000.0
6340,6340999,20.294095679225183,37.3251527618347,0.0809144793470501,4200.858990192413,498.2362940311432,3387.64395236969,28193,6373,21820,21820,0,31,6341000.0
6341,6341999,20.293152736867658,37.32315299030159,0.08091863651702569,4201.4609932899475,498.2990598678589,3388.179543495178,28195,6374,21821,21821,0,31,6342000.0
6342,6342999,20.292558405105527,37.321809886288555,0.080917273169121,4202.096858024597,498.36409163475037,3388.464570045471,28197,6375,21822,21822,0,31,6343000.0
6343,6343999,20.29187134796245,37.32012827997515,0.08091569131029841,4202.80899810791,498.42960000038147,3388.5227365493774,28204,6376,21828,21828,0,31,6344000.0
6344,6344999,20.291096513974903,37.31842903374285,0.0809195612541278,4203.862841367722,498.4955930709839,3386.9544076919556,28210,6379,21831,21831,0,31,6345000.0
6345,6345999,20.29038865249647,37.31673578329855,0.08092111421110038,4204.836911439896,498.5686070919037,3385.8897790908813,28218,6383,21835,21835,0,31,6346000.0
6346,6346999,20.289490558689405,37.3148034377741,0.08092592054470782,4205.22220158577,498.63332295417786,3387.499482154846,28218,6383,21835,21835,0,31,6347000.0
6347,6347999,20.288400445182653,37.31268610064276,0.08093321044119406,4205.728889465332,498.69867873191833,3388.786271095276,28231,6383,21848,21848,0,31,6348000.0
6348,6348999,20.287390111945488,37.31263047035943,0.0809306091719133,4206.20942568779,498.762314081192,3390.005784034729,28240,6384,21856,21856,0,31,6349000.0
6349,6349999,20.286353695218857,37.31222313116449,0.0809281837204392,4206.705592870712,498.8266463279724,3391.17129611969,28242,6384,21858,21858,0,31,6350000.0
6350,6350999,20.285366479857448,37.31076660228348,0.08092685505894659,4207.202966451645,498.88964772224426,3392.3363122940063,28244,6385,21859,21859,0,31,6351000.0
6351,6351999,20.284413159806178,37.30921638036414,0.08092948961041257,4208.009781599045,498.953955411911,3391.9283685684204,28246,6386,21860,21860,0,31,6352000.0
6352,6352999,20.28341732882757,37.30762809307881,0.08093211651719567,4208.315510511398,499.01632928848267,3394.0885095596313,28257,6387,21870,21870,0,31,6353000.0
6353,6353999,20.28246834732349,37.30581607681128,0.08093484867553402,4209.257160663605,499.0827796459198,3393.0972986221313,28263,6390,21873,21873,0,31,6354000.0
6354,6354999,20.281501497626902,37.3040823143207,0.08094600811375097,4209.747013092041,499.1459701061249,3394.3708810806274,28265,6391,21874,21874,0,31,6355000.0
6355,6355999,20.280617020946146,37.30267624404027,0.08095315100465794,4210.03898358345,499.2110085487366,3396.535454750061,28265,6391,21874,21874,0,31,6356000.0
6356,6356999,20.27992020326801,37.30202003068538,0.08095215873045769,4210.84539103508,499.2762496471405,3396.2122049331665,28265,6391,21874,21874,0,31,6357000.0
6357,6357999,20.27922740056323,37.300655863780854,0.08095720539072326,4211.646176099777,499.3422486782074,3395.7261514663696,28265,6391,21874,21874,0,31,6358000.0
6358,6358999,20.27890356415388,37.300062682002945,0.08096688766888727,4212.042759895325,499.40611696243286,3397.342629432678,28265,6391,21874,21874,0,31,6359000.0
6359,6359999,20.279240582590933,37.30105141516924,0.08096111785171367,4212.450167894363,499.47006916999817,3398.9487314224243,28265,6391,21874,21874,0,31,6360000.0
6360,6360999,20.279443046412773,37.30168219580322,0.0809468756117856,4213.157656431198,499.53439688682556,3398.993851661682,28265,6391,21874,21874,0,31,6361000.0
6361,6361999,20.279906965385553,37.3022721943414,0.08094129306642861,4214.005772829056,499.60078740119934,3398.3947763442993,28269,6393,21876,21876,0,31,6362000.0
6362,6362999,20.28034534296592,37.302631666636486,0.08094617904974999,4214.817395687103,499.6681544780731,3398.121819496155,28269,6393,21876,21876,0,31,6363000.0
6363,6363999,20.281318264014747,37.30499874597927,0.08092758165143588,4215.534707069397,499.7328100204468,3398.0323038101196,28271,6394,21877,21877,0,31,6364000.0
6364,6364999,20.282110764298857,37.30590364096214,0.08091635805016362,4215.832135438919,499.79784893989563,3400.131516456604,28271,6394,21877,21877,0,31,6365000.0
6365,6365999,20.282931527750012,37.30669241600248,0.08091633304798573,4216.567103624344,499.8607096672058,3400.152222633362,28277,6397,21880,21880,0,31,6366000.0
6366,6366999,20.283423117487985,37.30686030063475,0.08091573029262611,4217.185956001282,499.9270329475403,3400.624726295471,28281,6399,21882,21882,0,31,6367000.0
6367,6367999,20.28377158895623,37.30647865354095,0.08091114540401534,4217.945632457733,499.99259400367737,3400.4839334487915,28316,6402,21914,21914,0,31,6368000.0
6368,6368999,20.28315149141625,37.304996638890486,0.0809076689554441,4218.427094221115,500.0555691719055,3402.010811805725,28336,6402,21934,21934,0,31,6369000.0
6369,6369999,20.282279072949645,37.306638236278815,0.08089209206578785,4219.089979171753,500.12122654914856,3402.2630853652954,28339,6402,21937,21937,0,31,6370000.0
6370,6370999,20.281670883077435,37.307009318643395,0.0808751312627749,4219.405452251434,500.18698239326477,3404.220597267151,28346,6403,21943,21943,0,31,6371000.0
6371,6371999,20.281076673817427,37.30580698655631,0.08085661116175435,4220.174058675766,500.25031566619873,3404.066948890686,28346,6403,21943,21943,0,31,6372000.0
6372,6372999,20.280429089051427,37.30440370261544,0.08084885161189592,4221.143897533417,500.3153922557831,3402.938675880432,28347,6403,21944,21944,0,31,6373000.0
6373,6373999,20.27973795601335,37.30432007997839,0.08083817896727508,4221.715893983841,500.38069319725037,3403.6964044570923,28353,6406,21947,21947,0,31,6374000.0
6374,6374999,20.27897857366231,37.302761669095936,0.08083641852068679,4222.197890520096,500.4471731185913,3405.006516456604,28355,6407,21948,21948,0,31,6375000.0
6375,6375999,20.278336742110824,37.30152070691358,0.08083422328130374,4222.629408836365,500.5106978416443,3406.60635471344,28367,6409,21958,21958,0,31,6376000.0
6376,6376999,20.277776270348568,37.30019562703362,0.08082775492980976,4223.35360956192,500.57422399520874,3406.545205116272,28369,6410,21959,21959,0,31,6377000.0
6377,6377999,20.277183167510696,37.29885079089857,0.08082396743038178,4223.961874008179,500.6379098892212,3407.279381752014,28371,6411,21960,21960,0,31,6378000.0
6378,6378999,20.276990879337035,37.29877427453553,0.08082504448458538,4224.3690533638,500.70244812965393,3408.864701271057,28373,6412,21961,21961,0,31,6379000.0
6379,6379999,20.27688772181035,37.29803960841867,0.08082217681680504,4224.780687570572,500.7664213180542,3410.501061439514,28373,6412,21961,21961,0,31,6380000.0
6380,6380999,20.277068963314562,37.29760797093588,0.08082220109474603,4225.414333105087,500.83145403862,3410.816704750061,28375,6413,21962,21962,0,31,6381000.0
6381,6381999,20.277224058426338,37.297284271182804,0.08082022435952496,4226.333064317703,500.8973104953766,3409.8669595718384,28380,6415,21965,21965,0,31,6382000.0
6382,6382999,20.27760152217276,37.29760432849216,0.08081520836172484,4226.721899986267,500.96197032928467,3411.493577003479,28380,6415,21965,21965,0,31,6383000.0
6383,6383999,20.278226907206164,37.298269813834835,0.08082291941706243,4227.307043552399,501.02789187431335,3412.0557413101196,28380,6415,21965,21965,0,31,6384000.0
6384,6384999,20.2786244916184,37.298392734949815,0.0808189862065275,4228.015764474869,501.0915424823761,3412.08527469635,28382,6416,21966,21966,0,31,6385000.0
6385,6385999,20.27954412342892,37.29934265200891,0.08081326167556424,4228.709945201874,501.1589603424072,3412.2951669692993,28382,6416,21966,21966,0,31,6386000.0
6386,6386999,20.28008146505544,37.30054152197742,0.08081480749513692,4229.347993612289,501.2264926433563,3412.790368080139,28386,6418,21968,21968,0,31,6387000.0
6387,6387999,20.28084730213849,37.30092215705787,0.08081349685285133,4229.962917327881,501.29221057891846,3413.310029029846,28388,6419,21969,21969,0,31,6388000.0
6388,6388999,20.281105666044102,37.3006244953247,0.08080944061507556,4230.876382350922,501.35805344581604,3412.527024269104,28436,6421,22015,22015,0,31,6389000.0
6389,6389999,20.280729692049338,37.299484361149794,0.08079480262706307,4231.469189405441,501.42078852653503,3413.3388833999634,28458,6422,22036,22036,0,31,6390000.0
6390,6390999,20.279916155386797,37.29843536606545,0.0807874944548248,4231.960511684418,501.48684644699097,3414.5623865127563,28466,6423,22043,22043,0,31,6391000.0
6391,6391999,20.279172494928318,37.296662844361684,0.08077519099079566,4232.234152555466,501.5484781265259,3416.7685174942017,28468,6423,22045,22045,0,31,6392000.0
6392,6392999,20.278719579740557,37.29549977173047,0.08075827207546671,4232.992298364639,501.614399433136,3416.783440589905,28474,6425,22049,22049,0,31,6393000.0
6393,6393999,20.278502938212327,37.295288963477255,0.08074327938689119,4233.858564376831,501.67839765548706,3416.2754373550415,28485,6429,22056,22056,0,31,6394000.0
6394,6394999,20.277730939101215,37.29390774141347,0.08074224562001675,4234.170870542526,501.74378514289856,3418.488289833069,28485,6429,22056,22056,0,31,6395000.0
6395,6395999,20.27716954486153,37.29276580563326,0.08074100523302086,4234.919108867645,501.807847738266,3418.4968576431274,28491,6432,22059,22059,0,31,6396000.0
6396,6396999,20.276740882723956,37.29177368557308,0.08074153784730043,4235.9035551548,501.87572264671326,3417.450074195862,28497,6435,22062,22062,0,31,6397000.0
6397,6397999,20.27621057899782,37.29048300219744,0.08074335532055665,4236.215614557266,501.93989515304565,3419.521622657776,28500,6436,22064,22064,0,31,6398000.0
6398,6398999,20.276020533716054,37.290841319047004,0.08073815043403743,4236.725390434265,502.0081124305725,3420.669373512268,28500,6436,22064,22064,0,31,6399000.0
6399,6399999,20.275814373332935,37.289934653947356,0.08074197472376621,4237.368844747543,502.07435607910156,3421.2197427749634,28504,6438,22066,22066,0,31,6400000.0
6400,6400999,20.275510932683726,37.28911714494078,0.08074493280743156,4237.991340875626,502.1398596763611,3421.8377084732056,28506,6439,22067,22067,0,31,6401000.0
6401,6401999,20.275526828970857,37.288490228683266,0.08075421836775643,4238.69167971611,502.20543789863586,3422.0445261001587,28506,6439,22067,22067,0,31,6402000.0
6402,6402999,20.275490642442062,37.28786473885576,0.0807521847623146,4239.090705394745,502.26915550231934,3423.6603860855103,28506,6439,22067,22067,0,31,6403000.0
6403,6403999,20.275355542806622,37.287230912765125,0.08074862488199519,4239.593781709671,502.33515095710754,3424.7443704605103,28506,6439,22067,22067,0,31,6404000.0
6404,6404999,20.275349699319005,37.28672258681082,0.08074662949871425,4240.381012678146,502.4004764556885,3424.266945838928,28506,6439,22067,22067,0,31,6405000.0
6405,6405999,20.275258322729123,37.28589070731184,0.08074537522432901,4241.126806259155,502.46592712402344,3424.2866983413696,28518,6441,22077,22077,0,31,6406000.0
6406,6406999,20.275377872225622,37.285494469707274,0.08073966860044635,4241.9580636024475,502.53453278541565,3423.9731302261353,28520,6442,22078,22078,0,31,6407000.0
6407,6407999,20.275491835798263,37.284915765868014,0.08073263427423505,4242.571748495102,502.60176515579224,3424.5178232192993,28522,6443,22079,22079,0,31,6408000.0
6408,6408999,20.275558871902618,37.2841318906802,0.08072511273513006,4242.956904411316,502.6657691001892,3426.0981225967407,28522,6443,22079,22079,0,31,6409000.0
6409,6409999,20.275474583944845,37.283189576365096,0.08071663457960088,4243.662179470062,502.730899810791,3426.0278940200806,28522,6443,22079,22079,0,31,6410000.0
6410,6410999,20.2748573715371,37.28162291194648,0.0807085405477791,4244.134465932846,502.79493021965027,3427.3325815200806,28535,6443,22092,22092,0,31,6411000.0
6411,6411999,20.27448254368864,37.28163645311257,0.08068898770472765,4244.640266656876,502.8649823665619,3428.7559213638306,28541,6443,22098,22098,0,31,6412000.0
6412,6412999,20.273916071700235,37.281088333274866,0.08067642889346727,4244.846839666367,502.93677139282227,3431.5013818740845,28544,6443,22101,22101,0,31,6413000.0
6413,6413999,20.27341598714802,37.281377825140396,0.08065827417741467,4245.330205917358,503.0002164840698,3432.657525062561,28544,6443,22101,22101,0,31,6414000.0
6414,6414999,20.272624871741836,37.27972924754288,0.08065228560160953,4245.75337433815,503.06186842918396,3434.214997291565,28554,6445,22109,22109,0,31,6415000.0
6415,6415999,20.271888231774735,37.27912026716967,0.08064084627999069,4246.655929803848,503.13175225257874,3433.6194620132446,28560,6447,22113,22113,0,31,6416000.0
6416,6416999,20.27102677079796,37.27758217583569,0.08063618569025344,4247.376857757568,503.1961739063263,3433.675415992737,28562,6448,22114,22114,0,31,6417000.0
6417,6417999,20.270372740478194,37.277095261593395,0.08062809974053109,4247.799390077591,503.25833225250244,3435.394684791565,28563,6448,22115,22115,0,31,6418000.0
6418,6418999,20.26945455664307,37.27544855530485,0.0806279435475259,4248.207661151886,503.3236632347107,3437.002320289612,28563,6448,22115,22115,0,31,6419000.0
6419,6419999,20.26872036743946,37.274077598606944,0.08062401230327998,4248.850323438644,503.3875415325165,3437.3372888565063,28565,6449,22116,22116,0,31,6420000.0
6420,6420999,20.26795965964284,37.272699544650116,0.08061945530374504,4249.454043865204,503.4545316696167,3437.9419107437134,28575,6450,22125,22125,0,31,6421000.0
6421,6421999,20.267133759322274,37.27132863401177,0.08061862044992518,4249.870783090591,503.51806831359863,3439.381516456604,28577,6451,22126,22126,0,31,6422000.0
6422,6422999,20.266500409978736,37.26998144153755,0.08061550803744011,4250.612175703049,503.5826985836029,3439.5040216445923,28577,6451,22126,22126,0,31,6423000.0
6423,6423999,20.26583640645994,37.26846760093919,0.08061398934833452,4251.199734210968,503.64526414871216,3440.074921607971,28577,6451,22126,22126,0,31,6424000.0
6424,6424999,20.265182704697978,37.266853827448884,0.0806132711008164,4251.723558187485,503.7093152999878,3441.087929725647,28577,6451,22126,22126,0,31,6425000.0
6425,6425999,20.26456847481963,37.266175683028976,0.0806126921469611,4252.857359170914,503.77428221702576,3438.9254007339478,28584,6454,22130,22130,0,31,6426000.0
6426,6426999,20.264012506859476,37.26563912249426,0.0806085831497334,4253.229376792908,503.8403654098511,3440.689797401428,28584,6454,22130,22130,0,31,6427000.0
6427,6427999,20.263305817772594,37.263895468769825,0.08060730871422539,4254.265810728073,503.90388536453247,3439.379090309143,28626,6457,22169,22169,0,31,6428000.0
6428,6428999,20.262448869948344,37.26255270145672,0.08060801654182526,4254.8348298072815,503.9680061340332,3440.1455850601196,28633,6457,22176,22176,0,31,6429000.0
6429,6429999,20.26144362553825,37.26075206702667,0.08062013042636484,4255.311475038528,504.0401499271393,3441.5148935317993,28639,6458,22181,22181,0,31,6430000.0
6430,6430999,20.260758841065766,37.25962554112346,0.08062011517512113,4255.920234680176,504.10611295700073,3442.1079263687134,28642,6459,22183,22183,0,31,6431000.0
6431,6431999,20.25989194106548,37.25802334117537,0.08062489912957416,4256.298105239868,504.16926407814026,3444.0256967544556,28645,6460,22185,22185,0,31,6432000.0
6432,6432999,20.259242662458977,37.25727321149541,0.08062509168501397,4257.051661968231,504.236056804657,3444.059449195862,28661,6463,22198,22198,0,31,6433000.0
6433,6433999,20.258562822309987,37.256148517198504,0.08063026529432094,4257.353365898132,504.30020093917847,3446.2265634536743,28661,6463,22198,22198,0,31,6434000.0
6434,6434999,20.258005565966975,37.25537828729988,0.08062789729143693,4258.183730840683,504.36376571655273,3445.8952264785767,28668,6466,22202,22202,0,31,6435000.0
6435,6435999,20.257458526351797,37.25434529901227,0.08063668167337612,4258.83834862709,504.4268419742584,3446.187165260315,28673,6468,22205,22205,0,31,6436000.0
6436,6436999,20.257078324815833,37.25353886383075,0.08064174069792707,4259.999684810638,504.49169850349426,3444.1940393447876,28678,6470,22208,22208,0,31,6437000.0
6437,6437999,20.256891912247,37.2529072401671,0.08064127202080917,4260.3712520599365,504.57275342941284,3446.3340311050415,28678,6470,22208,22208,0,31,6438000.0
6438,6438999,20.256471641665378,37.251850026178154,0.08064554031457494,4261.182852745056,504.63839507102966,3446.0024194717407,28678,6470,22208,22208,0,31,6439000.0
6439,6439999,20.256257240561276,37.25113748945755,0.08065327649224541,4261.608067512512,504.706032037735,3447.6369791030884,28680,6471,22209,22209,0,31,6440000.0
6440,6440999,20.256360469261455,37.251530192361265,0.08065437643898699,4262.1147565841675,504.7723002433777,3448.721261024475,28680,6471,22209,22209,0,31,6441000.0
6441,6441999,20.256258415679174,37.25090036323441,0.08065208436981053,4263.045300960541,504.83855676651,3447.532525062561,28686,6474,22212,22212,0,31,6442000.0
6442,6442999,20.25644716752594,37.25068579039903,0.08066361004407241,4263.5476059913635,504.9060389995575,3448.6880350112915,28686,6474,22212,22212,0,31,6443000.0
6443,6443999,20.25680256692994,37.25099809825526,0.08066244370770215,4264.39589715004,504.9702625274658,3448.00878238678,28688,6475,22213,22213,0,31,6444000.0
6444,6444999,20.256857036991235,37.25057774532233,0.08066020953511199,4264.762570858002,505.0348172187805,3449.895287513733,28688,6475,22213,22213,0,31,6445000.0
6445,6445999,20.257146287469535,37.25136672687871,0.0806499291181052,4265.647404909134,505.0987949371338,3449.182915687561,28689,6476,22213,22213,0,31,6446000.0
6446,6446999,20.25720740131058,37.25080265036306,0.08064602258165432,4266.479050159454,505.16552662849426,3448.6465158462524,28698,6477,22221,22221,0,31,6447000.0
6447,6447999,20.256964479551485,37.24958165956632,0.08063719586469209,4266.870882987976,505.23188948631287,3450.487877845764,28715,6477,22238,22238,0,31,6448000.0
6448,6448999,20.256786565633288,37.249718995693165,0.08061887694964609,4267.346266508102,505.29916071891785,3451.79230594635,28722,6477,22245,22245,0,31,6449000.0
6449,6449999,20.25721914230364,37.250696684875486,0.0806012304491468,4267.641031265259,505.3622725009918,3453.933129310608,28728,6478,22250,22250,0,31,6450000.0
6450,6450999,20.257523106702582,37.25111480800664,0.08058278513331585,4268.360557556152,505.4271709918976,3454.0670862197876,28735,6479,22256,22256,0,31,6451000.0
6451,6451999,20.258360204363832,37.25194545098046,0.08056427625393559,4269.080441474915,505.4915611743927,3454.1971139907837,28740,6481,22259,22259,0,31,6452000.0
6452,6452999,20.259296271074422,37.25408241574543,0.08055003400179561,4269.610496044159,505.5549120903015,3455.288826942444,28745,6483,22262,22262,0,31,6453000.0
6453,6453999,20.260212518018562,37.25463311526428,0.08054692551995557,4270.27262544632,505.6210219860077,3455.971405982971,28745,6483,22262,22262,0,31,6454000.0
6454,6454999,20.261560289850134,37.25620976400234,0.080545637336216,4270.984246015549,505.6855990886688,3456.203225135803,28750,6485,22265,22265,0,31,6455000.0
6455,6455999,20.262878872803235,37.25782670734814,0.08055506270462942,4271.426563739777,505.7524907588959,3457.81476688385,28756,6487,22269,22269,0,31,6456000.0
6456,6456999,20.264169968376386,37.258802404460226,0.08057401275261644,4272.37827372551,505.8192226886749,3456.748261451721,28758,6488,22270,22270,0,31,6457000.0
6457,6457999,20.26554595040804,37.26054581320435,0.0806072469134711,4273.099716424942,505.88654947280884,3456.789330482483,28762,6489,22273,22273,0,31,6458000.0
6458,6458999,20.266819218826974,37.26182627398999,0.08063981186498714,4273.529727935791,505.94951486587524,3458.1485986709595,28764,6490,22274,22274,0,31,6459000.0
6459,6459999,20.268136257057613,37.26284617682765,0.08066523574061257,4273.990123748779,506.01459789276123,3459.271637916565,28768,6492,22276,22276,0,31,6460000.0
6460,6460999,20.26953504413519,37.264046405342434,0.08070926144356327,4274.28236079216,506.0774943828583,3461.433243751526,28768,6492,22276,22276,0,31,6461000.0
6461,6461999,20.27104085481055,37.26533567216822,0.08074034192686341,4275.011405944824,506.1410231590271,3461.316948890686,28770,6493,22277,22277,0,31,6462000.0
6462,6462999,20.272447617310245,37.26622072300293,0.08076420206528878,4275.922882318497,506.2043619155884,3460.473732948303,28773,6494,22279,22279,0,31,6463000.0
6463,6463999,20.273906163895507,37.267310839603255,0.08079015706036241,4276.7585372924805,506.2720205783844,3459.9478006362915,28777,6496,22281,22281,0,31,6464000.0
6464,6464999,20.275047064987746,37.267814438638794,0.0808086106520074,4277.506318807602,506.3403444290161,3459.9208459854126,28784,6499,22285,22285,0,31,6465000.0
6465,6465999,20.276209937769647,37.26819099725913,0.08082929431373442,4278.105295419693,506.40790343284607,3460.4875116348267,28786,6500,22286,22286,0,31,6466000.0
6466,6466999,20.276895029448745,37.2676746060336,0.0808419823643226,4278.805890798569,506.4722707271576,3460.5515604019165,28796,6501,22295,22295,0,31,6467000.0
6467,6467999,20.276867680159576,37.26673859993642,0.08083511221086459,4279.302275657654,506.5358018875122,3461.88174533844,28823,6502,22321,22321,0,31,6468000.0
6468,6468999,20.275872900713175,37.26518466370835,0.08083710544894496,4279.69410276413,506.59810090065,3463.477189064026,28832,6503,22329,22329,0,31,6469000.0
6469,6469999,20.27501543394183,37.26395108424168,0.08083561994518984,4280.391129255295,506.6604235172272,3463.634316444397,28841,6504,22337,22337,0,31,6470000.0
6470,6470999,20.274048388877723,37.262577619223066,0.08084067538146211,4281.223802566528,506.7279284000397,3463.0854349136353,28875,6506,22369,22369,0,31,6471000.0
6471,6471999,20.273330308868555,37.26144957267238,0.08083859654042103,4281.416868209839,506.7905647754669,3465.7614068984985,28876,6506,22370,22370,0,31,6472000.0
6472,6472999,20.272338892218404,37.25998495072152,0.08083903203366771,4282.158137798309,506.85494112968445,3465.799027442932,28880,6508,22372,22372,0,31,6473000.0
6473,6473999,20.271760244830578,37.259406830587864,0.08083134366158795,4282.8834936618805,506.91847825050354,3465.8942193984985,28885,6510,22375,22375,0,31,6474000.0
6474,6474999,20.271273249328708,37.25862124963353,0.08082342726457947,4283.63606595993,506.9831898212433,3465.8970193862915,28887,6511,22376,22376,0,31,6475000.0
6475,6475999,20.27082171859376,37.25761374561466,0.08081967338871732,4284.164843320847,507.0517146587372,3467.0794610977173,28890,6512,22378,22378,0,31,6476000.0
6476,6476999,20.27040205525357,37.25650545384278,0.08081726207831785,4284.805911064148,507.11940455436707,3467.576195716858,28896,6514,22382,22382,0,31,6477000.0
6477,6477999,20.27053418971505,37.256529419759794,0.080816789557979,4285.502422332764,507.18318939208984,3467.696358680725,28896,6514,22382,22382,0,31,6478000.0
6478,6478999,20.270973177486848,37.256735500158634,0.08081818157394594,4286.240756511688,507.24725699424744,3467.7275247573853,28899,6515,22384,22384,0,31,6479000.0
6479,6479999,20.271505760288644,37.257404167907055,0.08081770612844463,4286.637208938599,507.3106195926666,3469.3512964248657,28899,6515,22384,22384,0,31,6480000.0
6480,6480999,20.272169818456252,37.25836601109819,0.08080943224363424,4287.053994417191,507.3738925457001,3470.869111061096,28899,6515,22384,22384,0,31,6481000.0
6481,6481999,20.273046353490884,37.25923978721037,0.08080927137000249,4287.2495810985565,507.4389388561249,3473.497498512268,28899,6515,22384,22384,0,31,6482000.0
6482,6482999,20.273966485826467,37.26058385439891,0.08081198800913059,4288.091819763184,507.50503396987915,3472.9193353652954,28905,6517,22388,22388,0,31,6483000.0
6483,6483999,20.274924523470403,37.26166099483275,0.08081579120258175,4289.159908056259,507.57218050956726,3471.1710138320923,28915,6521,22394,22394,0,31,6484000.0
6484,6484999,20.276143776027173,37.26383016051305,0.08081502630696402,4289.846027135849,507.6370704174042,3471.640221595764,28919,6523,22396,22396,0,31,6485000.0
6485,6485999,20.277081995980968,37.264825596430256,0.08082090662458441,4290.473406076431,507.70050835609436,3472.21426486969,28923,6525,22398,22398,0,31,6486000.0
6486,6486999,20.277974076522245,37.265328883078226,0.08082390634679504,4291.114933252335,507.76529121398926,3472.8005151748657,28928,6527,22401,22401,0,31,6487000.0
6487,6487999,20.278520924302452,37.265145468513374,0.08082088938697929,4291.722043275833,507.82938265800476,3473.407349586487,28930,6528,22402,22402,0,31,6488000.0
6488,6488999,20.278370362874863,37.264688978478354,0.08080143860787992,4292.231554985046,507.89751958847046,3474.7313928604126,28945,6528,22417,22417,0,31,6489000.0
6489,6489999,20.277540223546143,37.263402035350445,0.08079570588199303,4292.594337940216,507.9599530696869,3476.525361061096,28949,6528,22421,22421,0,31,6490000.0
6490,6490999,20.27682662109885,37.2624718206618,0.08079427260437799,4293.1904554367065,508.02274203300476,3477.1433725357056,28953,6529,22424,22424,0,31,6491000.0
6491,6491999,20.27610206855831,37.261166465281065,0.08079749720116536,4293.71187543869,508.08583903312683,3478.2670679092407,28958,6531,22427,22427,0,31,6492000.0
6492,6492999,20.275588658106802,37.259773553727534,0.08078935671408094,4294.129044532776,508.1495461463928,3479.7743463516235,28961,6532,22429,22429,0,31,6493000.0
6493,6493999,20.27472124860475,37.25828144845904,0.0807854654670368,4294.78643488884,508.2141227722168,3480.161644935608,28968,6535,22433,22433,0,31,6494000.0
6494,6494999,20.274065554275683,37.25670294093493,0.08078082739143211,4295.5906455516815,508.2777245044708,3479.839539527893,28974,6537,22437,22437,0,31,6495000.0
6495,6495999,20.273310285809753,37.25756110142368,0.08077325743955499,4296.018253564835,508.34041929244995,3481.3866052627563,28978,6539,22439,22439,0,31,6496000.0
6496,6496999,20.272477282405372,37.25588834921577,0.080771342038226,4296.600971221924,508.40550565719604,3482.0903940200806,28978,6539,22439,22439,0,31,6497000.0
6497,6497999,20.271849797692177,37.25459912877442,0.08076482977448673,4297.117268562317,508.46950006484985,3483.145043373108,28980,6540,22440,22440,0,31,6498000.0
6498,6498999,20.271626349817215,37.254132518288316,0.08075677186831964,4297.633790969849,508.5326051712036,3484.232102394104,28982,6541,22441,22441,0,31,6499000.0
6499,6499999,20.271543420455675,37.25357243052073,0.08075019748476198,4298.752609014511,508.5985803604126,3482.2382974624634,28984,6542,22442,22442,0,31,6500000.0
6500,6500999,20.27152082517349,37.25293486859015,0.08074510095502108,4299.374895572662,508.665296792984,3482.6565103530884,28986,6543,22443,22443,0,31,6501000.0
6501,6501999,20.271464077135406,37.25222301138792,0.08073953358521213,4299.669461250305,508.73129963874817,3484.7807474136353,28986,6543,22443,22443,0,31,6502000.0
6502,6502999,20.272211271414697,37.25274606961298,0.0807288729845006,4300.252094268799,508.7947599887848,3485.425148963928,28986,6543,22443,22443,0,31,6503000.0
6503,6503999,20.27283760374617,37.25392286933411,0.08072065777245352,4301.002548217773,508.8587350845337,3485.309838294983,28990,6545,22445,22445,0,31,6504000.0
6504,6504999,20.273936054025633,37.25551366118338,0.08071077557307293,4301.509294986725,508.92663049697876,3486.357804298401,28992,6546,22446,22446,0,31,6505000.0
6505,6505999,20.275185026222243,37.25710955202393,0.08071115985569444,4302.2248504161835,508.9917230606079,3486.398636817932,28994,6547,22447,22447,0,31,6506000.0
6506,6506999,20.27669121910472,37.26025284272162,0.08070860255372436,4303.323769330978,509.0584433078766,3484.458336830139,28996,6548,22448,22448,0,31,6507000.0
6507,6507999,20.27817554188348,37.26410325196772,0.08070410380048898,4304.151260137558,509.12398290634155,3483.836663246155,29007,6550,22457,22457,0,31,6508000.0
6508,6508999,20.278967238373852,37.26471513973163,0.08069958327330673,4304.860133647919,509.19025683403015,3483.899384498596,29010,6551,22459,22459,0,31,6509000.0
6509,6509999,20.279169342698996,37.26486511253423,0.08068531331920081,4305.56783747673,509.25448298454285,3484.169045448303,29030,6552,22478,22478,0,31,6510000.0
6510,6510999,20.27862090695814,37.26417196317867,0.08067001706472376,4305.7280213832855,509.3184645175934,3487.0821237564087,29037,6552,22485,22485,0,31,6511000.0
6511,6511999,20.277937932951843,37.26260914338938,0.08066025893809392,4306.005166053772,509.3809459209442,3489.3287897109985,29039,6552,22487,22487,0,31,6512000.0
6512,6512999,20.277366598351755,37.26137214078705,0.08065338467054994,4306.725218296051,509.44617772102356,3489.5859994888306,29052,6554,22498,22498,0,31,6513000.0
6513,6513999,20.27687017126354,37.260045207640836,0.08064679921335793,4307.546037435532,509.5123965740204,3489.3827753067017,29060,6557,22503,22503,0,31,6514000.0
6514,6514999,20.276080174715226,37.25820571344475,0.08064114125213151,4308.062021017075,509.5790572166443,3490.5261240005493,29062,6558,22504,22504,0,31,6515000.0
6515,6515999,20.275483023952923,37.25669624681065,0.0806387845967399,4308.565460681915,509.644935131073,3491.7233209609985,29064,6559,22505,22505,0,31,6516000.0
6516,6516999,20.274864547524952,37.255097656615135,0.08063643918976404,4309.219329357147,509.71097207069397,3492.2338190078735,29087,6562,22525,22525,0,31,6517000.0
6517,6517999,20.274296647153747,37.25354299986305,0.08063461342013611,4309.950467824936,509.7764210700989,3492.5394525527954,29089,6563,22526,22526,0,31,6518000.0
6518,6518999,20.27393445160273,37.25250987355769,0.08063012269357661,4310.494390487671,509.8416941165924,3493.5883264541626,29094,6565,22529,22529,0,31,6519000.0
6519,6519999,20.273594167628175,37.251145910169534,0.08062565812971789,4311.118576049805,509.9063808917999,3494.1882104873657,29099,6566,22533,22533,0,31,6520000.0
6520,6520999,20.273175905879107,37.249799001139486,0.08062233115207174,4311.883982896805,509.97442507743835,3493.98171710968,29104,6568,22536,22536,0,31,6521000.0
6521,6521999,20.272704722554767,37.248209830187484,0.08062508929180945,4312.542831420898,510.04085421562195,3494.268780708313,29108,6570,22538,22538,0,31,6522000.0
6522,6522999,20.272410915636232,37.2467066948485,0.08063136516785552,4312.929709911346,510.10642552375793,3495.940396308899,29108,6570,22538,22538,0,31,6523000.0
6523,6523999,20.27219310799596,37.2452771080311,0.08064134071632045,4313.439715147018,510.17139530181885,3496.9411973953247,29111,6571,22540,22540,0,31,6524000.0
6524,6524999,20.271666619073294,37.243539012310585,0.08064771134737658,4313.9326140880585,510.2351257801056,3498.306393623352,29139,6572,22567,22567,0,31,6525000.0
6525,6525999,20.27102829921928,37.24268432830859,0.08064667974727702,4314.640502691269,510.2993688583374,3498.383023262024,29147,6573,22574,22574,0,31,6526000.0
6526,6526999,20.27030874966633,37.241566213265244,0.08064852666286815,4315.183356761932,510.36451530456543,3499.3233613967896,29153,6575,22578,22578,0,31,6527000.0
6527,6527999,20.26938903766168,37.23961538847453,0.08065368044301657,4315.951368093491,510.42924451828003,3499.3046159744263,29168,6579,22589,22589,0,31,6528000.0
6528,6528999,20.268496919112607,37.23762873516923,0.08066294643867822,4316.596506595612,510.4938633441925,3500.0073976516724,29175,6581,22594,22594,0,31,6529000.0
6529,6529999,20.267491633809726,37.235617979714675,0.08067140414167695,4316.905010938644,510.5575842857361,3502.1428728103638,29178,6582,22596,22596,0,31,6530000.0
6530,6530999,20.26658091360875,37.23378304493629,0.08067911054031252,4317.4150390625,510.6226222515106,3503.2972383499146,29179,6582,22597,22597,0,31,6531000.0
6531,6531999,20.265616990767665,37.23187097792973,0.0806870507841555,4318.154824018478,510.68809747695923,3503.2998476028442,29184,6584,22600,22600,0,31,6532000.0
6532,6532999,20.26462886896246,37.229828828008536,0.08069346687902212,4318.7913138866425,510.7534718513489,3503.874135017395,29188,6586,22602,22602,0,31,6533000.0
6533,6533999,20.263738865504976,37.22831113045283,0.08069688237034522,4319.676901817322,510.820351600647,3503.019558906555,29196,6589,22607,22607,0,31,6534000.0
6534,6534999,20.26262119848065,37.22626642129449,0.0807072426116957,4320.024621009827,510.8853189945221,3505.1560258865356,29196,6589,22607,22607,0,31,6535000.0
6535,6535999,20.26176361493184,37.224630900262774,0.08071505083568575,4320.6818151474,510.95150423049927,3505.6568422317505,29202,6591,22611,22611,0,31,6536000.0
6536,6536999,20.260854416582173,37.22306336655311,0.08072620576574108,4321.072217702866,511.01487278938293,3507.2753953933716,29202,6591,22611,22611,0,31,6537000.0
6537,6537999,20.25980596959114,37.220975771898395,0.08073977609116845,4321.7028958797455,511.07992243766785,3507.655415534973,29212,6592,22620,22620,0,31,6538000.0
6538,6538999,20.25887309705109,37.21910208770853,0.08075135639140163,4322.716318368912,511.14583134651184,3506.173581123352,29214,6593,22621,22621,0,31,6539000.0
6539,6539999,20.257759407752967,37.21701879778927,0.08076582212696448,4323.254673242569,511.2113962173462,3507.2442750930786,29218,6595,22623,22623,0,31,6540000.0
6540,6540999,20.256635756913134,37.2149386455026,0.08078001774819266,4324.356380701065,511.2774143218994,3505.6662645339966,29234,6600,22634,22634,0,31,6541000.0
6541,6541999,20.255864015315478,37.214766271714936,0.08077185934306108,4324.864122390747,511.3444676399231,3506.867802619934,29256,6601,22655,22655,0,31,6542000.0
6542,6542999,20.254960655581467,37.21297472884262,0.08077333428471178,4325.474004507065,511.41094183921814,3507.673436164856,29322,6602,22720,22720,0,31,6543000.0
6543,6543999,20.254403349745594,37.21343270255034,0.08076525532307433,4326.011113882065,511.47782278060913,3508.9770936965942,29335,6604,22731,22731,0,31,6544000.0
6544,6544999,20.253690493057285,37.21195531480311,0.08076426841531492,4326.29101061821,511.5427370071411,3511.3447847366333,29337,6604,22733,22733,0,31,6545000.0
6545,6545999,20.253081887223782,37.210794932767854,0.08076145842691962,4326.718075752258,511.60924458503723,3513.006054878235,29340,6605,22735,22735,0,31,6546000.0
6546,6546999,20.252543775288427,37.20947206701849,0.08075840133568768,4327.462007045746,511.6734757423401,3513.064518928528,29350,6608,22742,22742,0,31,6547000.0
6547,6547999,20.251789150127355,37.20812553624909,0.08075849155653891,4328.073529481888,511.73989152908325,3513.6674547195435,29352,6609,22743,22743,0,31,6548000.0
6548,6548999,20.2511475293825,37.20655540932953,0.0807597989174983,4328.864552021027,511.80359959602356,3513.429654121399,29355,6610,22745,22745,0,31,6549000.0
6549,6549999,20.25039045540686,37.205198139640316,0.0807580755972811,4329.50866317749,511.8692135810852,3513.7256364822388,29366,6611,22755,22755,0,31,6550000.0
6550,6550999,20.249855756776917,37.20397278406679,0.08075299265062974,4330.040360689163,511.9347953796387,3514.740246772766,29369,6612,22757,22757,0,31,6551000.0
6551,6551999,20.249414615639708,37.203501510413844,0.08075014869095343,4330.354667186737,512.0012466907501,3516.8831071853638,29369,6612,22757,22757,0,31,6552000.0
6552,6552999,20.248862519990148,37.20217728148326,0.08074775046187543,4330.970122098923,512.0646028518677,3517.39488697052,29369,6612,22757,22757,0,31,6553000.0
6553,6553999,20.248465322404492,37.20148681617507,0.08074224713143519,4331.782425642014,512.130439043045,3516.9158143997192,29371,6613,22758,22758,0,31,6554000.0
6554,6554999,20.248024563520723,37.20031153877402,0.0807374392531558,4332.481720685959,512.1937961578369,3516.9697160720825,29371,6613,22758,22758,0,31,6555000.0
6555,6555999,20.24752312493607,37.19895299148951,0.08073600396262604,4332.876162528992,512.2583951950073,3518.5524492263794,29371,6613,22758,22758,0,31,6556000.0
6556,6556999,20.247077950681255,37.197651258218286,0.08073748849068219,4333.451211452484,512.3241865634918,3519.345051765442,29371,6613,22758,22758,0,31,6557000.0
6557,6557999,20.246393454459213,37.196147136437894,0.08073783884994823,4334.390150547028,512.3890120983124,3518.3586854934692,29373,6614,22759,22759,0,31,6558000.0
6558,6558999,20.245775320914916,37.19458290889629,0.0807402661233878,4334.801330089569,512.4528253078461,3519.90945148468,29375,6615,22760,22760,0,31,6559000.0
6559,6559999,20.245055234021848,37.19332683611673,0.08073903255937664,4354.458852767944,512.5190348625183,3520.126317024231,29393,6617,22776,22776,0,31,6560000.0
6560,6560999,20.244933402057534,37.19823415892623,0.08069936440671521,4354.818716049194,512.582334280014,3521.9873552322388,29402,6617,22785,22785,0,31,6561000.0
6561,6561999,20.244104417308773,37.19674368428817,0.08069613554178745,4355.090898036957,512.6467571258545,3524.2541551589966,29407,6617,22790,22790,0,31,6562000.0
6562,6562999,20.243482077268578,37.196153877973636,0.08069065509349649,4355.595613002777,512.7114980220795,3525.335629463196,29410,6618,22792,22792,0,31,6563000.0
6563,6563999,20.242878649225414,37.19470121133396,0.08068682673836436,4356.131146192551,512.7773771286011,3526.462384223938,29415,6620,22795,22795,0,31,6564000.0
6564,6564999,20.242137738779075,37.193548198965075,0.08068301813037382,4356.7448852062225,512.8423826694489,3527.0673036575317,29417,6621,22796,22796,0,31,6565000.0
6565,6565999,20.241219568466057,37.19233905872275,0.08068033801245078,4357.380520820618,512.9076159000397,3527.625485420227,29440,6624,22816,22816,0,31,6566000.0
6566,6566999,20.240491194165514,37.19081344972671,0.08067843079019721,4357.680326938629,512.976188659668,3529.771191596985,29440,6624,22816,22816,0,31,6567000.0
6567,6567999,20.240115549742477,37.190262063439285,0.08066952348098488,4358.625766992569,513.0417723655701,3528.8850679397583,29448,6627,22821,22821,0,31,6568000.0
6568,6568999,20.239767593264848,37.18936489030326,0.08066071407697017,4359.355560064316,513.1085233688354,3528.951085090637,29450,6628,22822,22822,0,31,6569000.0
6569,6569999,20.239184398031227,37.18810481016093,0.08065422300150094,4359.753995656967,513.1736829280853,3530.571545600891,29450,6628,22822,22822,0,31,6570000.0
6570,6570999,20.238911966815905,37.18747121348168,0.08064530930959668,4360.271710634232,513.2378990650177,3531.6732683181763,29452,6629,22823,22823,0,31,6571000.0
6571,6571999,20.238923069996435,37.187284106811454,0.08063337637569501,4360.994925260544,513.303252696991,3531.7150774002075,29454,6630,22824,22824,0,31,6572000.0
6572,6572999,20.239102103032643,37.18696816502409,0.08062001561302301,4361.387036561966,513.3680756092072,3533.320294380188,29454,6630,22824,22824,0,31,6573000.0
6573,6573999,20.23956731646798,37.18738756233613,0.08061114817095894,4362.14120721817,513.4401042461395,3533.2860383987427,29457,6631,22826,22826,0,31,6574000.0
6574,6574999,20.240143969701666,37.18793186246497,0.08060712108638635,4362.432070493698,513.5027396678925,3535.3973817825317,29457,6631,22826,22826,0,31,6575000.0
6575,6575999,20.241785790130677,37.19096088478778,0.08060742500272655,4363.232146263123,513.5668694972992,3535.146237373352,29463,6633,22830,22830,0,31,6576000.0
6576,6576999,20.24282401320347,37.19187434940487,0.08061636586255039,4363.84400844574,513.6340963840485,3535.902714729309,29465,6634,22831,22831,0,31,6577000.0
6577,6577999,20.24434785884534,37.19555706096728,0.08061883245124457,4364.517176866531,513.6993532180786,3536.1145601272583,29471,6637,22834,22834,0,31,6578000.0
6578,6578999,20.246014710223356,37.19779429475693,0.0806186628804193,4365.880707025528,513.7655386924744,3533.2066316604614,29483,6641,22842,22842,0,31,6579000.0
6579,6579999,20.246940233433424,37.198467274340025,0.08062154695005952,4366.271507501602,513.8300392627716,3534.8594102859497,29483,6641,22842,22842,0,31,6580000.0
6580,6580999,20.24726564741026,37.19871723009481,0.0806142550793455,4366.569585800171,513.8979189395905,3537.3022356033325,29511,6642,22869,22869,0,31,6581000.0
6581,6581999,20.246605229503142,37.197706725089944,0.08060670623643751,4366.832890748978,513.9628982543945,3539.7552461624146,29520,6642,22878,22878,0,31,6582000.0
6582,6582999,20.246219443593443,37.19738118115356,0.08059962205109727,4367.1844844818115,514.0268564224243,3541.722104072571,29523,6642,22881,22881,0,31,6583000.0
6583,6583999,20.246214943907127,37.19940967367294,0.08058528833604939,4367.488388538361,514.0898954868317,3543.8949480056763,29525,6643,22882,22882,0,31,6584000.0
6584,6584999,20.246045722896543,37.198449386830404,0.08058226814071845,4367.943363189697,514.1562633514404,3545.552067756653,29531,6645,22886,22886,0,31,6585000.0
6585,6585999,20.246105791129615,37.198265862664144,0.08057874011349309,4368.73072218895,514.2216534614563,3545.4638261795044,29539,6649,22890,22890,0,31,6586000.0
6586,6586999,20.24610866352206,37.1974167296882,0.0805790693769124,4369.371874332428,514.285382270813,3546.0852937698364,29545,6652,22893,22893,0,31,6587000.0
6587,6587999,20.246150735564978,37.197319098530656,0.08058256526036545,4370.018306255341,514.3499057292938,3546.6162691116333,29552,6655,22897,22897,0,31,6588000.0
6588,6588999,20.246319634008774,37.19745959167603,0.08059331619945065,4370.48256111145,514.4150156974792,3548.0121660232544,29552,6655,22897,22897,0,31,6589000.0
6589,6589999,20.24661242595389,37.19763392193272,0.08060030779419369,4371.385692596436,514.4809060096741,3547.3421297073364,29557,6657,22900,22900,0,31,6590000.0
6590,6590999,20.247146636967607,37.198235949575285,0.0806180853180839,4371.8001029491425,514.5463120937347,3549.044545173645,29582,6658,22924,22924,0,31,6591000.0
6591,6591999,20.24790698808251,37.19929179708778,0.0806472367207055,4372.366575479507,514.6110458374023,3550.0728425979614,29582,6658,22924,22924,0,31,6592000.0
6592,6592999,20.248886919567642,37.200743220161314,0.08068309229868875,4373.098947048187,514.6770145893097,3550.1644563674927,29604,6660,22944,22944,0,31,6593000.0
6593,6593999,20.250483197351905,37.205474623469314,0.08071656015064921,4373.593227386475,514.7419152259827,3551.2897844314575,29604,6660,22944,22944,0,31,6594000.0
6594,6594999,20.251533260259546,37.206550754914346,0.08074697443483059,4374.2009518146515,514.8068120479584,3551.8799715042114,29604,6660,22944,22944,0,31,6595000.0
6595,6595999,20.25345113209452,37.21191836884488,0.08079458312172094,4375.184254407883,514.8743107318878,3550.5131273269653,29610,6662,22948,22948,0,31,6596000.0
6596,6596999,20.25553538442545,37.218464809624834,0.08083247853991793,4375.57895565033,514.9384186267853,3552.1295442581177,29610,6662,22948,22948,0,31,6597000.0
6597,6597999,20.257693716406273,37.222265101414756,0.08087609447977828,4375.986629009247,515.0050027370453,3553.709713935852,29612,6663,22949,22949,0,31,6598000.0
6598,6598999,20.259621792639233,37.22611157755036,0.08093491343029013,4376.844523429871,515.072726726532,3553.1726961135864,29618,6666,22952,22952,0,31,6599000.0
6599,6599999,20.261759518277294,37.22958226252205,0.08099788065352931,4377.812129497528,515.139993429184,3552.008137702942,29632,6669,22963,22963,0,31,6600000.0
6600,6600999,20.263124058216032,37.23134708911226,0.08104722359366678,4378.633565664291,515.2052111625671,3551.5197496414185,29642,6670,22972,22972,0,31,6601000.0
6601,6601999,20.26308611547816,37.23050503895515,0.08103739401368915,4379.017300367355,515.271945476532,3553.5920000076294,29676,6670,23006,23006,0,31,6602000.0
6602,6602999,20.262061807232325,37.2290719940106,0.08103617590612167,4379.182944059372,515.3378229141235,3556.5400285720825,29680,6670,23010,23010,0,31,6603000.0
6603,6603999,20.26125609819421,37.22794637352548,0.08103253359033336,4379.357749700546,515.4017083644867,3559.340001106262,29682,6670,23012,23012,0,31,6604000.0
6604,6604999,20.26040554897323,37.22659445021836,0.08103143187196415,4379.719780445099,515.4656457901001,3561.2894792556763,29682,6670,23012,23012,0,31,6605000.0
6605,6605999,20.25976752890623,37.225488832151555,0.08102870336687007,4380.55194067955,515.531037569046,3560.9456300735474,29690,6673,23017,23017,0,31,6606000.0
6606,6606999,20.25890046943463,37.22390478899329,0.08102868969168486,4381.285885334015,515.5963892936707,3561.3136262893677,29717,6677,23040,23040,0,31,6607000.0
6607,6607999,20.257946854994984,37.222126710556644,0.08102991658476888,4382.138745307922,515.6632590293884,3560.9217195510864,29726,6681,23045,23045,0,31,6608000.0
6608,6608999,20.25709791824703,37.22045223853361,0.08102839328696121,4382.66880106926,515.7290358543396,3562.0489015579224,29730,6683,23047,23047,0,31,6609000.0
6609,6609999,20.256263948953833,37.21861587929717,0.08102922773365184,4383.251038074493,515.7935080528259,3563.191891670227,29740,6685,23055,23055,0,31,6610000.0
6610,6610999,20.25563082878472,37.2173766329871,0.08102469161266002,4383.885648727417,515.8588757514954,3563.8745622634888,29742,6686,23056,23056,0,31,6611000.0
6611,6611999,20.25500977045758,37.215874407704575,0.08102434135016401,4384.0792763233185,515.9229378700256,3566.577748298645,29742,6686,23056,23056,0,31,6612000.0
6612,6612999,20.254636385806513,37.21524326535031,0.08102313733224165,4384.5759971141815,515.9885702133179,3567.7142000198364,29742,6686,23056,23056,0,31,6613000.0
6613,6613999,20.25402052956628,37.21375460319283,0.0810225938135124,4385.452755212784,516.0548586845398,3566.9280824661255,29747,6688,23059,23059,0,31,6614000.0
6614,6614999,20.253658116504184,37.21268130624257,0.08101991436682876,4386.050763130188,516.1217076778412,3567.7489519119263,29747,6688,23059,23059,0,31,6615000.0
6615,6615999,20.253206445931298,37.21119832362779,0.08101954220986451,4387.057126998901,516.1861662864685,3566.1656999588013,29780,6692,23088,23088,0,31,6616000.0
6616,6616999,20.253128299356877,37.21047412799349,0.08101968307244889,4387.479277849197,516.2521049976349,3567.7859926223755,29782,6693,23089,23089,0,31,6617000.0
6617,6617999,20.252958985849187,37.20967936090668,0.08101821834273615,4388.193103551865,516.3183395862579,3567.8661012649536,29803,6694,23109,23109,0,31,6618000.0
6618,6618999,20.25266382485886,37.208399879325995,0.08101771356011311,4388.685976743698,516.3815183639526,3568.9710969924927,29803,6694,23109,23109,0,31,6619000.0
6619,6619999,20.252428931186962,37.207169929457365,0.08101925340324634,4389.703754425049,516.4468038082123,3567.5351152420044,29814,6699,23115,23115,0,31,6620000.0
6620,6620999,20.252029559533476,37.20573337642286,0.08101715822644207,4390.539407014847,516.5154542922974,3567.0035219192505,29820,6701,23119,23119,0,31,6621000.0
6621,6621999,20.251522282461046,37.20419967053297,0.08101588346986255,4391.341922044754,516.5823302268982,3566.633816719055,29820,6701,23119,23119,0,31,6622000.0
6622,6622999,20.25096780056532,37.20356224549741,0.0810090516701868,4391.496417045593,516.647801399231,3569.761326789856,29850,6701,23149,23149,0,31,6623000.0
6623,6623999,20.250146703304754,37.20220335551223,0.08100516338040564,4391.664676189423,516.7105231285095,3572.6339387893677,29857,6701,23156,23156,0,31,6624000.0
6624,6624999,20.249078736454347,37.20010967094628,0.08101138671244446,4392.176192998886,516.7746551036835,3573.794125556946,29861,6702,23159,23159,0,31,6625000.0
6625,6625999,20.248280820609033,37.1983413769536,0.08101147225564043,4392.851267814636,516.8402941226959,3574.15855884552,29864,6703,23161,23161,0,31,6626000.0
6626,6626999,20.247531845623,37.196854634182074,0.0810102793771712,4393.645161867142,516.9066767692566,3574.0876512527466,29875,6707,23168,23168,0,31,6627000.0
6627,6627999,20.246751024302537,37.19536464909474,0.08101081103984975,4394.2423276901245,516.970814704895,3575.0694856643677,29879,6709,23170,23170,0,31,6628000.0
6628,6628999,20.245974628651123,37.193729415306265,0.08100635588719463,4394.703635931015,517.0362920761108,3576.5038118362427,29879,6709,23170,23170,0,31,6629000.0
6629,6629999,20.24517061864903,37.192157073038686,0.08100382779316995,4395.090569972992,517.1000123023987,3578.2406282424927,29879,6709,23170,23170,0,31,6630000.0
6630,6630999,20.24444546981916,37.19058440887083,0.08100012449787153,4395.681521892548,517.1639771461487,3578.844937324524,29880,6709,23171,23171,0,31,6631000.0
6631,6631999,20.243652496622516,37.18875358293295,0.08099790719435684,4396.394982337952,517.2276167869568,3578.88161945343,29882,6710,23172,23172,0,31,6632000.0
6632,6632999,20.24275574634035,37.18703286064086,0.08099523902365424,4397.110878229141,517.2920904159546,3578.810383796692,29882,6710,23172,23172,0,31,6633000.0
6633,6633999,20.241957775729016,37.18543830859806,0.08099092551596865,4397.648351192474,517.3559129238129,3579.57221698761,29884,6711,23173,23173,0,31,6634000.0
6634,6634999,20.241255358167763,37.18436238871412,0.08098841336168272,4397.96545124054,517.4198486804962,3581.645535469055,29886,6712,23174,23174,0,31,6635000.0
6635,6635999,20.24053956965549,37.18285841698899,0.08099114489577297,4398.4897220134735,517.4837939739227,3582.7170763015747,29888,6713,23175,23175,0,31,6636000.0
6636,6636999,20.239832610061903,37.1816721240211,0.08098812094984176,4399.525735378265,517.5505492687225,3581.3347597122192,29896,6716,23180,23180,0,31,6637000.0
6637,6637999,20.23911310594591,37.180071927454755,0.08098938343992235,4400.231960058212,517.6177213191986,3581.4050340652466,29898,6717,23181,23181,0,31,6638000.0
6638,6638999,20.238362511967477,37.17849026366915,0.08099016188120167,4400.766685009003,517.6818904876709,3582.411068916321,29902,6719,23183,23183,0,31,6639000.0
6639,6639999,20.237661979793838,37.17696277847336,0.08099130617775008,4401.677460193634,517.7478659152985,3581.439953804016,29904,6720,23184,23184,0,31,6640000.0
6640,6640999,20.237092974013564,37.17755741406339,0.08098500449199542,4402.309051513672,517.8122186660767,3581.9889574050903,29911,6722,23189,23189,0,31,6641000.0
6641,6641999,20.236277275986772,37.17578282795099,0.08098899813148785,4402.7087495327,517.8768391609192,3583.62641620636,29911,6722,23189,23189,0,31,6642000.0
6642,6642999,20.235686779614785,37.174088535221685,0.08099151329118925,4403.4118773937225,517.9429857730865,3584.00279712677,29939,6723,23216,23216,0,31,6643000.0
6643,6643999,20.235053371967762,37.17317331381114,0.08097782584796098,4403.669859647751,518.0064249038696,3586.366894721985,29944,6723,23221,23221,0,31,6644000.0
6644,6644999,20.234186203429598,37.1715081959093,0.08097543523493345,4404.173607110977,518.0697209835052,3587.590947151184,29951,6725,23226,23226,0,31,6645000.0
6645,6645999,20.233274189396134,37.16990809595856,0.08097481320829802,4404.907266616821,518.1329815387726,3587.6470613479614,29957,6728,23229,23229,0,31,6646000.0
6646,6646999,20.232835904737893,37.16859981935274,0.08096655972701083,4405.323207855225,518.1974964141846,3589.309506416321,29960,6729,23231,23231,0,31,6647000.0
6647,6647999,20.23203782819393,37.16684331771689,0.08096504386792591,4405.728805541992,518.2619030475616,3590.9440355300903,29962,6730,23232,23232,0,31,6648000.0
6648,6648999,20.23127181857682,37.16505793980149,0.08096597761331159,4406.252228975296,518.3274502754211,3592.0176210403442,29966,6732,23234,23234,0,31,6649000.0
6649,6649999,20.230719826887842,37.16361003431859,0.08095911680933976,4406.868042469025,518.3922166824341,3592.718892097473,29970,6734,23236,23236,0,31,6650000.0
6650,6650999,20.230119739726998,37.16214828837545,0.08095827860972504,4407.687984704971,518.4582159519196,3592.272702217102,29972,6735,23237,23237,0,31,6651000.0
6651,6651999,20.22946823955778,37.16088998674788,0.08095853509479778,4408.194595336914,518.5217728614807,3593.3832597732544,29974,6736,23238,23238,0,31,6652000.0
6652,6652999,20.22890441022693,37.159667471717945,0.08096201080579457,4408.925797700882,518.5894148349762,3593.499020576477,29980,6738,23242,23242,0,31,6653000.0
6653,6653999,20.228187466015548,37.15847523594288,0.08096676795718527,4409.496920824051,518.6529171466827,3594.270817756653,29980,6738,23242,23242,0,31,6654000.0
6654,6654999,20.22749685986054,37.15724903489795,0.08097332738313057,4409.886769771576,518.7184164524078,3595.91148853302,29980,6738,23242,23242,0,31,6655000.0
6655,6655999,20.226848239750346,37.15670195660417,0.08097646947908987,4410.384905338287,518.7820961475372,3597.0079774856567,29980,6738,23242,23242,0,31,6656000.0
6656,6656999,20.226194936330558,37.15534322084071,0.08098107376836616,4411.272746086121,518.8481562137604,3596.0365495681763,29980,6738,23242,23242,0,31,6657000.0
6657,6657999,20.226024825925798,37.155144809318166,0.08098287625438283,4411.944708824158,518.9140954017639,3596.1974000930786,29988,6741,23247,23247,0,31,6658000.0
6658,6658999,20.225584404699088,37.15412828161881,0.08098791683593798,4412.447629451752,518.9793741703033,3597.3109636306763,30011,6742,23269,23269,0,31,6659000.0
6659,6659999,20.22508593033926,37.15295625679887,0.08098884920129035,4413.075901031494,519.0449674129486,3597.8515825271606,30015,6744,23271,23271,0,31,6660000.0
6660,6660999,20.224625832916026,37.15169222918458,0.0809921416666628,4413.9753630161285,519.1116304397583,3597.11306476593,30019,6746,23273,23273,0,31,6661000.0
6661,6661999,20.224139722672376,37.1502906911982,0.0809970767152024,4414.562142372131,519.1766076087952,3597.7025117874146,30019,6746,23273,23273,0,31,6662000.0
6662,6662999,20.2234975239652,37.14862122534183,0.08100169990066708,4415.356590509415,519.2426719665527,3597.389355659485,30021,6747,23274,23274,0,31,6663000.0
6663,6663999,20.22348819675725,37.14849620294519,0.08100997753175077,4416.020233392715,519.3080208301544,3598.027684211731,30047,6748,23299,23299,0,31,6664000.0
6664,6664999,20.22343548258424,37.14808616628742,0.08101282340928584,4416.543304443359,519.3706603050232,3599.1256074905396,30056,6750,23306,23306,0,31,6665000.0
6665,6665999,20.22311884101051,37.147071396910384,0.08100438993812864,4416.843905925751,519.4338657855988,3601.346013069153,30060,6751,23309,23309,0,31,6666000.0
6666,6666999,20.222885439226175,37.146064619122576,0.08099669714288382,4417.536586761475,519.4990134239197,3601.7833681106567,30070,6753,23317,23317,0,31,6667000.0
6667,6667999,20.223075517089946,37.14571668363496,0.08098982154629897,4418.338468790054,519.5629556179047,3601.6766328811646,30075,6755,23320,23320,0,31,6668000.0
6668,6668999,20.22296577156918,37.14505756767063,0.08098251843788784,4419.213212251663,519.6262843608856,3601.12340259552,30081,6758,23323,23323,0,31,6669000.0
6669,6669999,20.223023418313712,37.144496698234065,0.08099131270789928,4419.7380657196045,519.6898486614227,3602.2309923171997,30085,6760,23325,23325,0,31,6670000.0
6670,6670999,20.222985051658252,37.1438937430218,0.08100238438123963,4420.689623594284,519.7551310062408,3601.046483039856,30089,6762,23327,23327,0,31,6671000.0
6671,6671999,20.222977167175124,37.143244042778136,0.08098780240531445,4421.203531265259,519.8196024894714,3602.1854066848755,30091,6763,23328,23328,0,31,6672000.0
6672,6672999,20.22292481202044,37.14246148147635,0.0809958628637466,4421.5008816719055,519.8833205699921,3604.3635988235474,30091,6763,23328,23328,0,31,6673000.0
6673,6673999,20.223055139221767,37.14271624471664,0.080987472122655,4421.79948425293,519.9499099254608,3606.5106859207153,30091,6763,23328,23328,0,31,6674000.0
6674,6674999,20.223245223698445,37.14273131835792,0.08097385681957103,4422.7769610881805,520.0159270763397,3605.3360109329224,30091,6763,23328,23328,0,31,6675000.0
6675,6675999,20.22350993025244,37.14265839130502,0.08096109633549353,4423.196336984634,520.0836319923401,3607.0002870559692,30091,6763,23328,23328,0,31,6676000.0
6676,6676999,20.22416234709604,37.143937337586756,0.08094759554300501,4424.244455575943,520.149652004242,3605.4294786453247,30096,6765,23331,23331,0,31,6677000.0
6677,6677999,20.225035169322503,37.145343402952776,0.08095692833139623,4424.824752807617,520.2166402339935,3606.1585969924927,30108,6767,23341,23341,0,31,6678000.0
6678,6678999,20.225766292272404,37.14623115781115,0.08094598106991513,4425.528700828552,520.2815794944763,3606.2674531936646,30108,6767,23341,23341,0,31,6679000.0
6679,6679999,20.226814010720567,37.14795142256055,0.08097039701469166,4425.821532487869,520.3477907180786,3608.3977479934692,30108,6767,23341,23341,0,31,6680000.0
6680,6680999,20.22792398207066,37.149660970702996,0.08098686140858802,4426.639577388763,520.4132862091064,3607.9271211624146,30118,6768,23350,23350,0,31,6681000.0
6681,6681999,20.229058968411003,37.151513068020485,0.08100789669186848,4427.414644956589,520.4772796630859,3607.7625246047974,30122,6770,23352,23352,0,31,6682000.0
6682,6682999,20.230549576871542,37.154380928388015,0.08104424968617752,4428.149790525436,520.5429122447968,3607.7098054885864,30127,6772,23355,23355,0,31,6683000.0
6683,6683999,20.231692694925204,37.15697259622805,0.08105889595780802,4428.636164665222,520.6083474159241,3609.0365953445435,30129,6773,23356,23356,0,31,6684000.0
6684,6684999,20.232231727645015,37.1592502539817,0.08105016626212946,4429.003569841385,520.6879198551178,3610.8684663772583,30140,6774,23366,23366,0,31,6685000.0
6685,6685999,20.23255838888993,37.16939383353404,0.08099915076239272,4429.575508117676,520.7477576732635,3611.520718574524,30145,6775,23370,23370,0,31,6686000.0
6686,6686999,20.232541139413733,37.17045386716791,0.08096467256945505,4430.305265665054,520.8107652664185,3611.6682329177856,30187,6778,23409,23409,0,31,6687000.0
6687,6687999,20.232489589949548,37.17344026489755,0.0809351270904708,4430.901613712311,520.8724319934845,3612.337918281555,30196,6779,23417,23417,0,31,6688000.0
6688,6688999,20.23183592045045,37.17195381307635,0.0809670158603768,4431.469158649445,520.9339210987091,3612.9930391311646,30199,6779,23420,23420,0,31,6689000.0
6689,6689999,20.231707510247414,37.17259384145388,0.08104459584535961,4432.177797079086,520.9974970817566,3612.933491706848,30213,6780,23433,23433,0,31,6690000.0
6690,6690999,20.231814549689727,37.172918149715876,0.08104247561597322,4432.553596735001,521.0569615364075,3614.5284700393677,30214,6780,23434,23434,0,31,6691000.0
6691,6691999,20.231542881367663,37.17200337158188,0.08104063939349926,4433.231352806091,521.1182126998901,3614.573796272278,30215,6780,23435,23435,0,31,6692000.0
6692,6692999,20.232303880214346,37.174328489469865,0.08101207642890829,4434.030187368393,521.1816935539246,3614.0580339431763,30217,6781,23436,23436,0,31,6693000.0
6693,6693999,20.23261233959657,37.175221572333356,0.08099748395622774,4434.842716217041,521.2448534965515,3613.5621004104614,30222,6783,23439,23439,0,31,6694000.0
6694,6694999,20.233613821843683,37.177926542978284,0.08098170700049423,4435.572567939758,521.3069469928741,3613.451802253723,30225,6785,23440,23440,0,31,6695000.0
6695,6695999,20.23475071063367,37.18448176738282,0.08095204934898415,4436.267651796341,521.3681931495667,3613.540463447571,30228,6786,23442,23442,0,31,6696000.0
6696,6696999,20.23585631937378,37.18690828548769,0.08094000680091273,4436.76337480545,521.4307284355164,3614.563603401184,30229,6787,23442,23442,0,31,6697000.0
6697,6697999,20.236977861390603,37.190156321913555,0.08090101000384398,4437.495274543762,521.49280834198,3614.580464363098,30234,6789,23445,23445,0,31,6698000.0
6698,6698999,20.23885567662957,37.19662032041598,0.08088527088208086,4438.06703710556,521.5548362731934,3615.176785469055,30234,6789,23445,23445,0,31,6699000.0
6699,6699999,20.239442828479937,37.19689695394541,0.08087397591245449,4438.444957733154,521.6156477928162,3616.820019721985,30238,6789,23449,23449,0,31,6700000.0
6700,6700999,20.239823630448228,37.19996744762321,0.08078227033756491,4438.9182250499725,521.6777493953705,3617.91596698761,30242,6790,23452,23452,0,31,6701000.0
6701,6701999,20.239824682259485,37.20001937140176,0.08076098628261796,4439.643832683563,521.7396552562714,3617.968892097473,30268,6793,23475,23475,0,31,6702000.0
6702,6702999,20.240189837520298,37.201195751973735,0.08072981489624464,4440.179737329483,521.8010833263397,3618.983235359192,30311,6795,23516,23516,0,31,6703000.0
6703,6703999,20.24028059963484,37.20133544583865,0.08070235183734054,4440.658118963242,521.862841129303,3620.138279914856,30312,6795,23517,23517,0,31,6704000.0
6704,6704999,20.24038496231379,37.20154798572837,0.08067873324053532,4441.354186058044,521.9238188266754,3620.1840028762817,30323,6796,23527,23527,0,31,6705000.0
6705,6705999,20.240803054043596,37.20211850393734,0.08066269932186854,4442.123658895493,521.9860320091248,3620.0150957107544,30331,6800,23531,23531,0,31,6706000.0
6706,6706999,20.241206571268904,37.20238249870478,0.08065917727929883,4442.5226719379425,522.0486826896667,3621.70942401886,30333,6801,23532,23532,0,31,6707000.0
6707,6707999,20.242245606980816,37.204347659538065,0.08064167554477308,4443.1433074474335,522.1112632751465,3622.1862001419067,30336,6803,23533,23533,0,31,6708000.0
6708,6708999,20.243130034258137,37.20551111877575,0.0806329160093171,4443.52928853035,522.1748676300049,3623.882908821106,30336,6803,23533,23533,0,31,6709000.0
6709,6709999,20.244336450295233,37.2067364226313,0.08063240272451944,4444.133279323578,522.2387938499451,3624.4876985549927,30338,6804,23534,23534,0,31,6710000.0
6710,6710999,20.24525190029276,37.207788759556934,0.0806238202154066,4444.759076595306,522.3023941516876,3625.016842842102,30340,6805,23535,23535,0,31,6711000.0
6711,6711999,20.246369970690953,37.20936523824158,0.0806190982594377,4445.5094294548035,522.3658044338226,3624.9911012649536,30344,6807,23537,23537,0,31,6712000.0
6712,6712999,20.24783388196147,37.21216127807669,0.08061286580734761,4446.257923841476,522.4295284748077,3625.020260810852,30348,6809,23539,23539,0,31,6713000.0
6713,6713999,20.249062851177584,37.21337878603256,0.08062517137220016,4446.972691297531,522.4951190948486,3625.2015047073364,30352,6811,23541,23541,0,31,6714000.0
6714,6714999,20.250600664145143,37.21621630067411,0.0806215338872357,4447.584270000458,522.5584890842438,3625.770344734192,30354,6812,23542,23542,0,31,6715000.0
6715,6715999,20.25168055404193,37.217103542268156,0.08062944894844692,4448.551613807678,522.6238949298859,3624.584210395813,30359,6815,23544,23544,0,31,6716000.0
6716,6716999,20.253093093853796,37.2182775667035,0.08064093366151248,4448.930602788925,522.6890530586243,3626.2749071121216,30359,6815,23544,23544,0,31,6717000.0
6717,6717999,20.254385313020187,37.21921596153734,0.08064527350372452,4449.759407281876,522.7552530765533,3625.8928575515747,30364,6818,23546,23546,0,31,6718000.0
6718,6718999,20.25530556108811,37.22023284289677,0.08062357416151811,4450.328408002853,522.8203594684601,3626.636784553528,30369,6818,23551,23551,0,31,6719000.0
6719,6719999,20.25580346226798,37.22188463024588,0.08058853392672571,4451.254116535187,522.8884370326996,3625.5521516799927,30380,6820,23560,23560,0,31,6720000.0
6720,6720999,20.255801447368228,37.221066101389646,0.0805696134936521,4451.645520687103,522.9537167549133,3627.2290468215942,30382,6820,23562,23562,0,31,6721000.0
6721,6721999,20.255820362435728,37.22019083342849,0.0805545654606048,4452.451392889023,523.0181570053101,3626.819577217102,30384,6821,23563,23563,0,31,6722000.0
6722,6722999,20.25592495997892,37.22022051001103,0.08054085760127705,4452.839782953262,523.0821530818939,3628.419316291809,30384,6821,23563,23563,0,31,6723000.0
6723,6723999,20.25608584534424,37.219585857554456,0.0805220264535692,4453.634891271591,523.1479411125183,3627.94273853302,30384,6821,23563,23563,0,31,6724000.0
6724,6724999,20.256084256188153,37.21876527669173,0.08050778324306196,4454.022617101669,523.211119890213,3629.5187425613403,30384,6821,23563,23563,0,31,6725000.0
6725,6725999,20.256359715031028,37.218573636104836,0.08049094015749836,4455.04998922348,523.2756178379059,3628.0347032546997,30395,6822,23573,23573,0,31,6726000.0
6726,6726999,20.25645404454413,37.21808773250377,0.08047793887323329,4455.711465835571,523.3413672447205,3628.391125679016,30401,6825,23576,23576,0,31,6727000.0
6727,6727999,20.257098399610275,37.21885071658479,0.0804545809490963,4456.426275730133,523.406626701355,3628.444951057434,30403,6826,23577,23577,0,31,6728000.0
6728,6728999,20.257543469899993,37.21888801717692,0.08044265181966392,4456.842703342438,523.4749565124512,3629.9722566604614,30404,6827,23577,23577,0,31,6729000.0
6729,6729999,20.258093551838577,37.21881389227038,0.08043115317910021,4457.487896442413,523.5401451587677,3630.502995491028,30408,6829,23579,23579,0,31,6730000.0
6730,6730999,20.258847392532502,37.21930843602196,0.08041848790018269,4457.894284248352,523.6056637763977,3632.129574775696,30408,6829,23579,23579,0,31,6731000.0
6731,6731999,20.259412725629797,37.21925191170467,0.08041016330920259,4458.788156032562,523.6721360683441,3631.203938484192,30408,6829,23579,23579,0,31,6732000.0
6732,6732999,20.259868346567625,37.21893119355841,0.08040270930579485,4459.424983739853,523.7373039722443,3631.6292238235474,30410,6830,23580,23580,0,31,6733000.0
6733,6733999,20.260807660744756,37.21945539928715,0.08039597415601107,4460.335533857346,523.8038372993469,3630.8813219070435,30426,6831,23595,23595,0,31,6734000.0
6734,6734999,20.26135873589408,37.21911836925172,0.08038489781332592,4461.144967317581,523.8705952167511,3630.421811103821,30428,6832,23596,23596,0,31,6735000.0
6735,6735999,20.261940449741342,37.21872598233547,0.08037545938198587,4461.625438690186,523.937017917633,3631.6874437332153,30428,6832,23596,23596,0,31,6736000.0
6736,6736999,20.262465415225776,37.21836640568344,0.08036743243455646,4462.315858840942,524.004273891449,3631.7968339920044,30428,6832,23596,23596,0,31,6737000.0
6737,6737999,20.26296729129025,37.21781072602011,0.08035972014584636,4462.9235599040985,524.0717036724091,3632.3410997390747,30429,6833,23596,23596,0,31,6738000.0
6738,6738999,20.26300029259102,37.21660797676784,0.08035380731492703,4463.429661512375,524.1370935440063,3633.554753303528,30441,6835,23606,23606,0,31,6739000.0
6739,6739999,20.262358758492816,37.215175784052086,0.08034531776482767,4464.012503862381,524.204216003418,3634.2294359207153,30446,6836,23610,23610,0,31,6740000.0
6740,6740999,20.261758659199078,37.21426657648057,0.08033590019044001,4464.396545886993,524.2680456638336,3635.9521837234497,30451,6837,23614,23614,0,31,6741000.0
6741,6741999,20.26114707127485,37.213003312733235,0.0803329494122248,4464.9773824214935,524.3341863155365,3636.716290473938,30455,6838,23617,23617,0,31,6742000.0
6742,6742999,20.26062484517418,37.211638048242435,0.0803275904716888,4465.7121052742,524.4007184505463,3636.5893983840942,30456,6838,23618,23618,0,31,6743000.0
6743,6743999,20.26016627258141,37.21018380993447,0.0803209689136537,4466.303235769272,524.4657726287842,3637.1821489334106,30456,6838,23618,23618,0,31,6744000.0
6744,6744999,20.259658267623788,37.20871583072983,0.0803185762101919,4466.991836071014,524.52978348732,3637.2439851760864,30456,6838,23618,23618,0,31,6745000.0
6745,6745999,20.25927371693368,37.20764813157146,0.08031812291886664,4467.380249738693,524.5948612689972,3638.8257341384888,30456,6838,23618,23618,0,31,6746000.0
6746,6746999,20.258983690938685,37.20689018999314,0.08030992402421555,4467.995953321457,524.6597428321838,3639.31326007843,30458,6839,23619,23619,0,31,6747000.0
6747,6747999,20.2587835513641,37.205955941959985,0.08030231339902427,4468.685183048248,524.7251052856445,3639.36013507843,30458,6839,23619,23619,0,31,6748000.0
6748,6748999,20.258542215904445,37.20556552649536,0.08030264682698318,4469.40656876564,524.7911996841431,3639.311459541321,30458,6839,23619,23619,0,31,6749000.0
6749,6749999,20.258176080096153,37.20437302581685,0.0803071184993911,4470.255755662918,524.8585176467896,3638.7724199295044,30462,6841,23621,23621,0,31,6750000.0
6750,6750999,20.25806950582081,37.20352804324104,0.08031041875918177,4470.647751092911,524.9238879680634,3640.368535041809,30462,6841,23621,23621,0,31,6751000.0
6751,6751999,20.25822392556208,37.204854336531106,0.08030633415388866,4471.465616703033,524.9903712272644,3639.7934617996216,30463,6842,23621,23621,0,31,6752000.0
6752,6752999,20.258475743797902,37.204655853555096,0.08030424971868189,4472.151923418045,525.0570375919342,3639.906147956848,30463,6842,23621,23621,0,31,6753000.0
6753,6753999,20.259093704659396,37.204981443294294,0.08031244623089806,4472.773451089859,525.1227431297302,3640.4157609939575,30464,6843,23621,23621,0,31,6754000.0
6754,6754999,20.259730068136008,37.206733347516575,0.08031653815763884,4473.055178165436,525.1873869895935,3642.5381593704224,30464,6843,23621,23621,0,31,6755000.0
6755,6755999,20.26060957786878,37.20749734161487,0.0803251878563278,4473.732607841492,525.2545094490051,3642.684323310852,30464,6843,23621,23621,0,31,6756000.0
6756,6756999,20.261424374238693,37.20831461864961,0.08031817632536475,4474.421162605286,525.3214118480682,3642.715489387512,30464,6843,23621,23621,0,31,6757000.0
6757,6757999,20.26226971326867,37.209008932068805,0.08031377117807914,4475.010825395584,525.3887770175934,3643.2631731033325,30464,6843,23621,23621,0,31,6758000.0
6758,6758999,20.262348677701436,37.208278724387846,0.08031407045098515,4475.869791507721,525.455747127533,3642.7112169265747,30475,6846,23629,23629,0,31,6759000.0
6759,6759999,20.262200189411328,37.208144240897305,0.08030381115844887,4476.254242897034,525.5212178230286,3644.3406953811646,30477,6847,23630,23630,0,31,6760000.0
6760,6760999,20.262447231893105,37.2091157155963,0.08029689722467093,4476.910737752914,525.587548494339,3644.7231035232544,30543,6849,23694,23694,0,31,6761000.0
6761,6761999,20.262802635973816,37.2098662509157,0.08029469043770587,4478.138954162598,525.6540825366974,3642.2978410720825,30547,6851,23696,23696,0,31,6762000.0
6762,6762999,20.263582891751565,37.21084544203954,0.08029661151346112,4478.537990808487,525.718368768692,3644.013005256653,30547,6851,23696,23696,0,31,6763000.0
6763,6763999,20.264475654861684,37.2121312047007,0.08031472158107522,4479.388197422028,525.786285161972,3643.7129335403442,30549,6852,23697,23697,0,31,6764000.0
6764,6764999,20.265240699047048,37.21291235044954,0.08031742621796167,4480.075608491898,525.8501513004303,3643.7979860305786,30549,6852,23697,23697,0,31,6765000.0
6765,6765999,20.266414765397904,37.21480124308653,0.08032366249720069,4480.657985210419,525.9153161048889,3644.528042793274,30549,6852,23697,23697,0,31,6766000.0
6766,6766999,20.26730705001979,37.21584413150247,0.08032760928326721,4481.148772716522,525.9824781417847,3645.6116456985474,30549,6852,23697,23697,0,31,6767000.0
6767,6767999,20.268264633724918,37.2166898465372,0.08033688514025117,4481.793647527695,526.050252199173,3646.018620491028,30562,6854,23708,23708,0,31,6768000.0
6768,6768999,20.269592066274353,37.21822657975398,0.08036779422777562,4482.499887228012,526.1162528991699,3646.1114625930786,30564,6855,23709,23709,0,31,6769000.0
6769,6769999,20.27099376607929,37.22016686494485,0.08038618920012197,4482.921537399292,526.1810102462769,3647.6290102005005,30565,6856,23709,23709,0,31,6770000.0
6770,6770999,20.272281885915312,37.22179183611566,0.08038921360587359,4483.432386875153,526.2471146583557,3648.730450630188,30567,6857,23710,23710,0,31,6771000.0
6771,6771999,20.273488038512014,37.22298776064784,0.08040465899970384,4484.163192272186,526.3148052692413,3648.933133125305,30571,6859,23712,23712,0,31,6772000.0
6772,6772999,20.27514109182151,37.22496891928377,0.08042282744824913,4484.889016866684,526.3809826374054,3648.9520692825317,30581,6860,23721,23721,0,31,6773000.0
6773,6773999,20.2766159237197,37.22657097849182,0.08042598124619993,4485.587462902069,526.4493443965912,3649.028630256653,30581,6860,23721,23721,0,31,6774000.0
6774,6774999,20.278185189046532,37.227994150639375,0.08043725169705152,4486.184721708298,526.5148642063141,3649.5965089797974,30581,6860,23721,23721,0,31,6775000.0
6775,6775999,20.279730187907578,37.229711469539964,0.08043149510411829,4486.572403430939,526.5805337429047,3651.1687593460083,30581,6860,23721,23721,0,31,6776000.0
6776,6776999,20.281182393608407,37.23078712334805,0.08042920532367359,4487.2761771678925,526.6465508937836,3651.1900453567505,30581,6860,23721,23721,0,31,6777000.0
6777,6777999,20.281898750323617,37.23074781666173,0.08042299404413256,4487.581989526749,526.7122859954834,3653.276188850403,30597,6861,23736,23736,0,31,6778000.0
6778,6778999,20.281466705760728,37.229924736142586,0.08041451055407933,4487.819180250168,526.7764098644257,3655.8087434768677,30605,6861,23744,23744,0,31,6779000.0
6779,6779999,20.28087593609764,37.22918741452982,0.08039873431727629,4488.634760141373,526.8414659500122,3655.0934648513794,30608,6862,23746,23746,0,31,6780000.0
6780,6780999,20.280254405245437,37.22770010745011,0.0803880976422966,4489.406248807907,526.9095225334167,3654.794346809387,30610,6862,23748,23748,0,31,6781000.0
6781,6781999,20.2798067320423,37.2277431457319,0.08037266075200189,4490.113288402557,526.974383354187,3654.853756904602,30612,6863,23749,23749,0,31,6782000.0
6782,6782999,20.279108980852016,37.226143433371746,0.08036646315518625,4490.824219226837,527.0398092269897,3654.900273323059,30614,6864,23750,23750,0,31,6783000.0
6783,6783999,20.278403429359663,37.22444520910237,0.08036292813248158,4491.629118442535,527.1038198471069,3654.4458208084106,30616,6865,23751,23751,0,31,6784000.0
6784,6784999,20.277882508378582,37.22319563868964,0.08035967217547657,4492.1471536159515,527.1680610179901,3655.4842500686646,30618,6866,23752,23752,0,31,6785000.0
6785,6785999,20.277333632643483,37.221727949911276,0.080357667804414,4492.839795351028,527.2327182292938,3655.51012134552,30618,6866,23752,23752,0,31,6786000.0
6786,6786999,20.277054774103995,37.22110168388234,0.0803493107930231,4493.470962762833,527.2976129055023,3655.9541521072388,30620,6867,23753,23753,0,31,6787000.0
6787,6787999,20.276663378383894,37.21989505968543,0.08034052356504295,4493.769891738892,527.3640258312225,3658.031186103821,30620,6867,23753,23753,0,31,6788000.0
6788,6788999,20.276225168722974,37.21865638945687,0.0803406624375066,4494.870014667511,527.4299335479736,3656.2205629348755,30627,6871,23756,23756,0,31,6789000.0
6789,6789999,20.27605654048234,37.218147674380475,0.08032611755734664,4495.4797875881195,527.4961497783661,3656.7670640945435,30628,6872,23756,23756,0,31,6790000.0
6790,6790999,20.27595047599496,37.21746219990863,0.080320660710817,4495.98921585083,527.5617108345032,3657.8935594558716,30630,6873,23757,23757,0,31,6791000.0
6791,6791999,20.275990207880444,37.216821211114166,0.08031096594904741,4496.788082122803,527.6282062530518,3657.4895601272583,30630,6873,23757,23757,0,31,6792000.0
6792,6792999,20.276112470517774,37.21642034619436,0.08029728155545401,4497.503881931305,527.6946954727173,3657.5459184646606,30630,6873,23757,23757,0,31,6793000.0
6793,6793999,20.276565180593998,37.21657746786554,0.08028726162136735,4497.995047569275,527.7617506980896,3658.6378297805786,30630,6873,23757,23757,0,31,6794000.0
6794,6794999,20.27690174228988,37.21646917373909,0.08028947019151744,4498.845476865768,527.8313438892365,3658.111668586731,30634,6875,23759,23759,0,31,6795000.0
6795,6795999,20.277683291434496,37.21677786427501,0.08029222273850689,4499.340973615646,527.8985149860382,3659.2088441848755,30634,6875,23759,23759,0,31,6796000.0
6796,6796999,20.27833848073295,37.2168690796163,0.08028632146016268,4500.239247560501,527.9661192893982,3658.2214708328247,30634,6875,23759,23759,0,31,6797000.0
6797,6797999,20.279120055116664,37.21702735276212,0.0802876835954135,4500.871341943741,528.0353515148163,3658.742253303528,30636,6876,23760,23760,0,31,6798000.0
6798,6798999,20.27943834989773,37.21653712032725,0.08028040602944964,4502.000211238861,528.1011800765991,3656.792134284973,30646,6878,23768,23768,0,31,6799000.0
6799,6799999,20.278882026447352,37.215482527178885,0.08026972408530508,4502.297382593155,528.1665830612183,3659.026738166809,30649,6879,23770,23770,0,31,6800000.0
6800,6800999,20.278527179147016,37.21443610143427,0.08025990405737704,4503.142540216446,528.2309920787811,3658.521710395813,30655,6881,23774,23774,0,31,6801000.0
6801,6801999,20.278347697568336,37.21387975957634,0.08025055740302522,4503.610956192017,528.2944123744965,3659.8020524978638,30655,6881,23774,23774,0,31,6802000.0
6802,6802999,20.278484242349165,37.213515256207494,0.08024454895535771,4504.012006044388,528.361005783081,3661.5147676467896,30657,6882,23775,23775,0,31,6803000.0
6803,6803999,20.278427529901425,37.21298153220666,0.08023707203921604,4504.837616920471,528.4258668422699,3661.064435005188,30659,6883,23776,23776,0,31,6804000.0
6804,6804999,20.278497839092793,37.212225563989456,0.08023077389297995,4505.940895557404,528.4950618743896,3659.1467714309692,30659,6883,23776,23776,0,31,6805000.0
6805,6805999,20.278358665843022,37.21160478202952,0.08022168846296684,4506.449801683426,528.5631482601166,3660.219754219055,30670,6884,23786,23786,0,31,6806000.0
6806,6806999,20.278405494098095,37.211114370811686,0.08021512606976144,4507.084717512131,528.6290040016174,3660.451153755188,30672,6885,23787,23787,0,31,6807000.0
6807,6807999,20.27868342887484,37.21088867519193,0.08020685143585315,4507.694585800171,528.6946296691895,3661.269726753235,30672,6885,23787,23787,0,31,6808000.0
6808,6808999,20.27878238221878,37.2101435640057,0.0801998481448083,4508.137097597122,528.7668466567993,3662.72838306427,30674,6886,23788,23788,0,31,6809000.0
6809,6809999,20.278811120129202,37.20920765223177,0.08019500679545755,4509.196988105774,528.8325109481812,3661.183346748352,30680,6889,23791,23791,0,31,6810000.0
6810,6810999,20.279486043211648,37.2097391940527,0.08018932628010789,4509.796033859253,528.8986630439758,3661.8335008621216,30680,6889,23791,23791,0,31,6811000.0
6811,6811999,20.28000062334489,37.20969131084792,0.0801819544141128,4510.403846502304,528.9682650566101,3662.4386796951294,30680,6889,23791,23791,0,31,6812000.0
6812,6812999,20.280866824004583,37.21022119034594,0.08018165973676394,4511.105064153671,529.0348913669586,3662.4840898513794,30680,6889,23791,23791,0,31,6813000.0
6813,6813999,20.28181788836135,37.210760985296226,0.0801827607988026,4511.806970357895,529.1039447784424,3662.521466255188,30680,6889,23791,23791,0,31,6814000.0
6814,6814999,20.282731063399563,37.21122162417463,0.08017945338682597,4512.738000631332,529.1715688705444,3661.4856462478638,30682,6890,23792,23792,0,31,6815000.0
6815,6815999,20.283722329480128,37.2113683016108,0.08017833396926022,4513.136716365814,529.2396903038025,3663.078824043274,30682,6890,23792,23792,0,31,6816000.0
6816,6816999,20.28492437412371,37.21199222242843,0.08017394741325978,4513.842493057251,529.3074774742126,3663.207356452942,30682,6890,23792,23792,0,31,6817000.0
6817,6817999,20.286004720772123,37.21225887973198,0.08017710849642212,4514.283411502838,529.3846635818481,3664.6328172683716,30683,6891,23792,23792,0,31,6818000.0
6818,6818999,20.28692614364041,37.21246929971366,0.08017298858569177,4514.868664979935,529.4519667625427,3665.295102119446,30683,6891,23792,23792,0,31,6819000.0
6819,6819999,20.28661947759824,37.211883666756684,0.08016076698565966,4515.45059299469,529.5177450180054,3665.9604234695435,30690,6892,23798,23798,0,31,6820000.0
6820,6820999,20.286200476888258,37.211133865247156,0.08015003367696416,4516.28284239769,529.5846185684204,3665.3161821365356,30700,6894,23806,23806,0,31,6821000.0
6821,6821999,20.2856562592926,37.20969779618455,0.08015076835894153,4516.869929790497,529.6522846221924,3665.9603242874146,30700,6894,23806,23806,0,31,6822000.0
6822,6822999,20.285070789588335,37.208280687412625,0.08014890766941185,4517.278594732285,529.7173659801483,3667.5830507278442,30702,6895,23807,23807,0,31,6823000.0
6823,6823999,20.28449435270751,37.20704603351693,0.0801484753125995,4517.860932826996,529.7818338871002,3668.2556886672974,30702,6895,23807,23807,0,31,6824000.0
6824,6824999,20.284203537143807,37.20629789471365,0.08014625666917818,4518.7918038368225,529.8489196300507,3667.2388887405396,30715,6897,23818,23818,0,31,6825000.0
6825,6825999,20.283865623894584,37.205326352111115,0.08014114569669717,4519.18110203743,529.9156062602997,3668.849362373352,30715,6897,23818,23818,0,31,6826000.0
6826,6826999,20.28362926960346,37.2043308820488,0.0801314967813268,4519.987947225571,529.9819552898407,3668.3695878982544,30715,6897,23818,23818,0,31,6827000.0
6827,6827999,20.28335277075082,37.20343262220896,0.08012358685678012,4520.521106004715,530.0490202903748,3669.3343782424927,30715,6897,23818,23818,0,31,6828000.0
6828,6828999,20.283073158973973,37.20264981859125,0.08012146159471867,4521.477371931076,530.1162967681885,3668.268223762512,30721,6900,23821,23821,0,31,6829000.0
6829,6829999,20.283077563110005,37.20227016546233,0.08011509196456179,4522.225431203842,530.1826756000519,3668.228108406067,30730,6902,23828,23828,0,31,6830000.0
6830,6830999,20.283376530082922,37.20417011692957,0.08011703967772121,4522.934896230698,530.2486054897308,3668.2746782302856,30732,6903,23829,23829,0,31,6831000.0
6831,6831999,20.283782657006018,37.205545384207376,0.08010915598719925,4523.548969507217,530.3149254322052,3668.8105821609497,30734,6904,23830,23830,0,31,6832000.0
6832,6832999,20.28406935697878,37.20590813967626,0.08010419919289846,4524.286216259003,530.3795669078827,3668.6760683059692,30736,6906,23830,23830,0,31,6833000.0
6833,6833999,20.28417787614777,37.205348485293484,0.08010398921594875,4524.928819656372,530.4547991752625,3669.2017641067505,30738,6907,23831,23831,0,31,6834000.0
6834,6834999,20.284137222277522,37.20561178962192,0.08010465867635275,4525.314865112305,530.5209140777588,3670.83385181427,30738,6907,23831,23831,0,31,6835000.0
6835,6835999,20.284125995834525,37.20572312807186,0.0801042281299541,4525.889397144318,530.5849840641022,3671.5692796707153,30746,6907,23839,23839,0,31,6836000.0
6836,6836999,20.28413932850838,37.20563860805487,0.08009868631902228,4526.362113952637,530.6518392562866,3672.7843141555786,30748,6907,23841,23841,0,31,6837000.0
6837,6837999,20.28485786336578,37.21164476362177,0.08007688792525891,4526.834242343903,530.717892408371,3673.9212160110474,30749,6907,23842,23842,0,31,6838000.0
6838,6838999,20.28500497677715,37.21110232780292,0.0800771691954808,4528.194674491882,530.7820007801056,3670.474835395813,30753,6909,23844,23844,0,31,6839000.0
6839,6839999,20.285520835998348,37.21270604318925,0.08006931270605555,4528.484526872635,530.8458578586578,3672.612729072571,30753,6909,23844,23844,0,31,6840000.0
6840,6840999,20.285718470516162,37.2121671780802,0.08007097600111646,4529.243716716766,530.9122180938721,3672.5535402297974,30765,6912,23853,23853,0,31,6841000.0
6841,6841999,20.28589463532127,37.21173777477393,0.08006821946201303,4529.764844179153,530.977676153183,3673.690526008606,30765,6912,23853,23853,0,31,6842000.0
6842,6842999,20.28624169216668,37.21410412164921,0.08005750049043914,4530.439685344696,531.043425321579,3674.0462770462036,30767,6913,23854,23854,0,31,6843000.0
6843,6843999,20.286537239491654,37.21367116353819,0.08006825604004286,4531.123072147369,531.1088156700134,3674.3114824295044,30767,6913,23854,23854,0,31,6844000.0
6844,6844999,20.286983836263776,37.21384171752652,0.08007009608867854,4531.846830606461,531.1773018836975,3674.311116218567,30769,6914,23855,23855,0,31,6845000.0
6845,6845999,20.287805920731568,37.21653846255539,0.08007255067484187,4532.47216796875,531.243513584137,3674.7203340530396,30770,6915,23855,23855,0,31,6846000.0
6846,6846999,20.288244646350694,37.217042682217354,0.08008047665187046,4532.880376577377,531.3078272342682,3676.2658281326294,30771,6916,23855,23855,0,31,6847000.0
6847,6847999,20.289394214687867,37.21832370177136,0.08008468494172816,4533.804192066193,531.3750417232513,3675.2974214553833,30775,6918,23857,23857,0,31,6848000.0
6848,6848999,20.29051622919167,37.21953651781279,0.08009162777099155,4534.205361843109,531.439944267273,3676.926938056946,30775,6918,23857,23857,0,31,6849000.0
6849,6849999,20.29173939880578,37.22120735573211,0.08010152822436356,4534.975437164307,531.5058960914612,3676.5966081619263,30779,6920,23859,23859,0,31,6850000.0
6850,6850999,20.292785807731786,37.22179573754722,0.08011095329252471,4535.573341369629,531.570648431778,3677.166211128235,30779,6920,23859,23859,0,31,6851000.0
6851,6851999,20.294159447544008,37.22427620977873,0.08012013911153293,4536.527865886688,531.6392669677734,3676.17670917511,30783,6922,23861,23861,0,31,6852000.0
6852,6852999,20.295328742356965,37.225913585912934,0.08013118197736646,4537.243901252747,531.7048976421356,3676.2064027786255,30794,6923,23871,23871,0,31,6853000.0
6853,6853999,20.296089153432256,37.22584217740059,0.08014516345213052,4537.98175907135,531.7721831798553,3676.172505378723,30804,6925,23879,23879,0,31,6854000.0
6854,6854999,20.296621679205764,37.226419205839626,0.08012277631484965,4538.4568593502045,531.8381881713867,3677.4330492019653,30816,6925,23891,23891,0,31,6855000.0
6855,6855999,20.296850156245334,37.22637765066508,0.08010952763704515,4539.235202550888,531.9038636684418,3677.0556383132935,30817,6925,23892,23892,0,31,6856000.0
6856,6856999,20.297300535352704,37.22777790187244,0.08008094817563793,4539.717349529266,531.9678015708923,3678.197331428528,30819,6925,23894,23894,0,31,6857000.0
6857,6857999,20.29760373636195,37.22860299180367,0.0800575347799668,4540.370206356049,532.0351274013519,3678.7133684158325,30823,6927,23896,23896,0,31,6858000.0
6858,6858999,20.2978794875262,37.228798842991054,0.08004263696989877,4540.770211219788,532.0995714664459,3680.4460878372192,30823,6927,23896,23896,0,31,6859000.0
6859,6859999,20.298258918251395,37.22945603428303,0.08003854490770168,4541.313477277756,532.1643617153168,3681.44900226593,30827,6929,23898,23898,0,31,6860000.0
6860,6860999,20.2983827492594,37.228927128505426,0.08003810403689293,4542.460664510727,532.2325007915497,3679.2631120681763,30840,6931,23909,23909,0,31,6861000.0
6861,6861999,20.298768950730224,37.229070517168765,0.08004024248097252,4543.056362628937,532.2976443767548,3680.0377168655396,30851,6932,23919,23919,0,31,6862000.0
6862,6862999,20.299274999633443,37.22914436020344,0.08005256866753607,4543.880378246307,532.3646330833435,3679.574772834778,30853,6933,23920,23920,0,31,6863000.0
6863,6863999,20.29981460086104,37.22922848962398,0.08006164689987127,4544.286282539368,532.4303796291351,3681.188572883606,30854,6933,23921,23921,0,31,6864000.0
6864,6864999,20.300631291913884,37.22967639400018,0.08007476108358125,4544.789722442627,532.4968066215515,3682.445034980774,30854,6933,23921,23921,0,31,6865000.0
6865,6865999,20.301411653441498,37.23026310538286,0.08009661613254826,4545.930185079575,532.5645105838776,3680.3567094802856,30858,6935,23923,23923,0,31,6866000.0
6866,6866999,20.30194285362267,37.23032670275767,0.08011356965264615,4546.21927690506,532.6311502456665,3682.522068977356,30858,6935,23923,23923,0,31,6867000.0
6867,6867999,20.30293667569732,37.23120314395217,0.08013293224617479,4546.629395246506,532.6993525028229,3684.08669757843,30860,6936,23924,23924,0,31,6868000.0
6868,6868999,20.3040420157432,37.23213711357303,0.0801520096352375,4547.28746676445,532.7659890651703,3684.5711183547974,30860,6936,23924,23924,0,31,6869000.0
6869,6869999,20.304901574959406,37.232442244107816,0.08017288469383277,4548.0166845321655,532.8325214385986,3684.525143623352,30862,6937,23925,23925,0,31,6870000.0
6870,6870999,20.30576207367423,37.233765927860254,0.08018824104156186,4549.063631296158,532.903489112854,3683.111264228821,30862,6937,23925,23925,0,31,6871000.0
6871,6871999,20.30670752045593,37.234239785506404,0.08020065282932598,4549.747758150101,532.9722764492035,3683.1939210891724,30862,6937,23925,23925,0,31,6872000.0
6872,6872999,20.307542433311635,37.23466833426007,0.08021838133006998,4550.467418432236,533.0430307388306,3683.1908235549927,30871,6938,23933,23933,0,31,6873000.0
6873,6873999,20.3074779499646,37.2335287831653,0.08022278501917401,4551.200587749481,533.1127798557281,3683.152501106262,30875,6940,23935,23935,0,31,6874000.0
6874,6874999,20.307871824229565,37.23513654370982,0.0802250395057662,4551.614599227905,533.1856324672699,3684.9107179641724,30895,6941,23954,23954,0,31,6875000.0
6875,6875999,20.307943115870327,37.23654976865475,0.08020171964625966,4552.255438089371,533.253974199295,3685.634388923645,30898,6942,23956,23956,0,31,6876000.0
6876,6876999,20.307723625005142,37.23561842984461,0.0802004118664077,4552.745231389999,533.3206865787506,3686.7633485794067,30899,6942,23957,23957,0,31,6877000.0
6877,6877999,20.30754337159887,37.23453656416109,0.08019595775146349,4553.3344831466675,533.3864018917084,3687.450337409973,30900,6942,23958,23958,0,31,6878000.0
6878,6878999,20.30737109325316,37.233712618768095,0.08018625430618131,4554.026943922043,533.4528307914734,3687.6446962356567,30900,6942,23958,23958,0,31,6879000.0
6879,6879999,20.30727820221812,37.23320854522507,0.08018093772832946,4554.6364595890045,533.518602848053,3688.1769227981567,30902,6943,23959,23959,0,31,6880000.0
6880,6880999,20.307140480220436,37.23220580809792,0.08017940934567747,4555.2986652851105,533.588671207428,3688.619236946106,30914,6945,23969,23969,0,31,6881000.0
6881,6881999,20.30708625963591,37.23180565959779,0.08017545227454692,4556.134073257446,533.65598320961,3688.0174531936646,30918,6947,23971,23971,0,31,6882000.0
6882,6882999,20.307001030778093,37.231178693443084,0.0801821140878467,4556.658369779587,533.7255418300629,3689.114270210266,30919,6948,23971,23971,0,31,6883000.0
6883,6883999,20.30695468902703,37.23066035906137,0.08019231897389356,4557.362400054932,533.7927162647247,3689.217465400696,30919,6948,23971,23971,0,31,6884000.0
6884,6884999,20.307516710431376,37.23160653268558,0.08019741055900687,4558.379011154175,533.8599727153778,3687.727292060852,30921,6949,23972,23972,0,31,6885000.0
6885,6885999,20.30860549972214,37.23357352286361,0.0802048472021355,4558.771711349487,533.926849603653,3689.3388566970825,30921,6949,23972,23972,0,31,6886000.0
6886,6886999,20.309601317767104,37.234662970956784,0.08021239818411874,4579.126945972443,533.9960606098175,3689.497097969055,30921,6949,23972,23972,0,31,6887000.0
6887,6887999,20.311063605738042,37.237593352141964,0.08022875556012998,4579.539844274521,534.0621600151062,3691.037724494934,30923,6950,23973,23973,0,31,6888000.0
6888,6888999,20.312404978996724,37.23939335252208,0.08024572031686827,4580.035692453384,534.129013299942,3692.1223039627075,30923,6950,23973,23973,0,31,6889000.0
6889,6889999,20.313900205713914,37.24138086909989,0.08024847049294614,4580.638619422913,534.1973352432251,3692.6832246780396,30923,6950,23973,23973,0,31,6890000.0
6890,6890999,20.315184197666845,37.242989961729606,0.08025742594365004,4581.560180425644,534.2646906375885,3691.674038887024,30925,6951,23974,23974,0,31,6891000.0
6891,6891999,20.315970291893645,37.24338950325497,0.08026347435565984,4582.1411690711975,534.3340561389923,3692.5722093582153,30931,6954,23977,23977,0,31,6892000.0
6892,6892999,20.31666802019419,37.244065150402804,0.08023055809324708,4582.651283025742,534.406730890274,3693.900387763977,30945,6955,23990,23990,0,31,6893000.0
6893,6893999,20.316973637152852,37.24463211531527,0.08020023316980229,4583.264476060867,534.4784097671509,3694.5941972732544,30960,6956,24004,24004,0,31,6894000.0
6894,6894999,20.31682075036729,37.24371402547457,0.08018187573037727,4583.961670875549,534.5443351268768,3694.752034187317,30967,6957,24010,24010,0,31,6895000.0
6895,6895999,20.3166956359672,37.24276952642295,0.08016933885624522,4584.338788509369,534.6096453666687,3696.4091844558716,30968,6957,24011,24011,0,31,6896000.0
6896,6896999,20.31648939738245,37.24170942840305,0.08015914570422222,4584.860237598419,534.6847894191742,3697.813015937805,30970,6958,24012,24012,0,31,6897000.0
6897,6897999,20.3164398004276,37.2405623867887,0.08014746683873097,4585.277571439743,534.7513134479523,3699.4642000198364,30977,6959,24018,24018,0,31,6898000.0
6898,6898999,20.31607507815076,37.23949483131877,0.08014306000839932,4586.094653606415,534.8198320865631,3698.9640550613403,30979,6960,24019,24019,0,31,6899000.0
6899,6899999,20.31588267579198,37.23809712374957,0.08013423516906637,4586.736287593842,534.8887259960175,3699.4979906082153,30981,6961,24020,24020,0,31,6900000.0
6900,6900999,20.315633970452744,37.23678358829921,0.08012740241058836,4587.57121181488,534.9578428268433,3698.9857301712036,30995,6963,24032,24032,0,31,6901000.0
6901,6901999,20.315337830102532,37.23530482165473,0.08012322579681386,4588.061943054199,535.0252418518066,3700.1015520095825,30995,6963,24032,24032,0,31,6902000.0
6902,6902999,20.314964568391108,37.23431308433155,0.08011777384229801,4588.363446474075,535.0916030406952,3702.2237215042114,30995,6963,24032,24032,0,31,6903000.0
6903,6903999,20.314686705032504,37.23308838170548,0.08011440224872479,4589.535290002823,535.1621797084808,3699.9069032669067,31009,6965,24044,24044,0,31,6904000.0
6904,6904999,20.31451787149116,37.23206804871582,0.08011354451477048,4589.831188201904,535.2287459373474,3702.024235725403,31009,6965,24044,24044,0,31,6905000.0
6905,6905999,20.314331966220823,37.23093108604193,0.08011770669331109,4590.31320977211,535.2939698696136,3703.2543687820435,31009,6965,24044,24044,0,31,6906000.0
6906,6906999,20.31416564772907,37.229953465620426,0.08011958788895535,4591.204154968262,535.3633224964142,3702.2766466140747,31010,6965,24045,24045,0,31,6907000.0
6907,6907999,20.31426142457361,37.22931254866246,0.08011785366201185,4591.981561899185,535.4301896095276,3702.200276374817,31018,6969,24049,24049,0,31,6908000.0
6908,6908999,20.314161075270516,37.2281918726726,0.08011647605832506,4592.593901634216,535.4976236820221,3702.7354860305786,31020,6970,24050,24050,0,31,6909000.0
6909,6909999,20.314082525485205,37.22712240850374,0.08011653978077438,4593.413231611252,535.5654022693634,3702.2532777786255,31022,6971,24051,24051,0,31,6910000.0
6910,6910999,20.313911562966343,37.225984818255846,0.08011689378200171,4593.904022693634,535.6308538913727,3703.3419313430786,31022,6971,24051,24051,0,31,6911000.0
6911,6911999,20.31338241483309,37.224353102890966,0.08012110130590977,4594.696904420853,535.7006454467773,3702.8504457473755,31022,6971,24051,24051,0,31,6912000.0
6912,6912999,20.312891720824098,37.223120974600064,0.08011302466610892,4595.301475286484,535.7685606479645,3703.694760322571,31039,6973,24066,24066,0,31,6913000.0
6913,6913999,20.312546629190834,37.22200079059179,0.08009094387529736,4595.897095918655,535.8371636867523,3704.36616230011,31056,6974,24082,24082,0,31,6914000.0
6914,6914999,20.312149367056065,37.22110459612213,0.0800778235662869,4596.403131484985,535.9032707214355,3705.5814332962036,31059,6975,24084,24084,0,31,6915000.0
6915,6915999,20.31171622117884,37.21986413053771,0.08006764950056444,4597.11706495285,535.9698643684387,3705.6584672927856,31062,6976,24086,24086,0,31,6916000.0
6916,6916999,20.31122154979259,37.218369894749,0.08005618571287743,4597.519578933716,536.0378186702728,3707.294560432434,31064,6977,24087,24087,0,31,6917000.0
6917,6917999,20.310826424077273,37.217627765227824,0.08004635708467644,4598.099895954132,536.1059436798096,3707.937397956848,31065,6977,24088,24088,0,31,6918000.0
6918,6918999,20.310559773707887,37.216908125682416,0.08003877857846387,4598.412405967712,536.1751055717468,3710.0817461013794,31075,6978,24097,24097,0,31,6919000.0
6919,6919999,20.310246267161453,37.21626842815703,0.08003116138456945,4598.828708648682,536.2419121265411,3711.6649293899536,31077,6979,24098,24098,0,31,6920000.0
6920,6920999,20.31000568516338,37.215968025279395,0.08001909799805418,4599.771763324738,536.3103005886078,3710.674138069153,31081,6981,24100,24100,0,31,6921000.0
6921,6921999,20.310411559443086,37.217356971983186,0.0800032224927042,4600.703364372253,536.3787727355957,3709.675633430481,31094,6983,24111,24111,0,31,6922000.0
6922,6922999,20.310895746439748,37.22096190809831,0.0799792010427477,4601.32125377655,536.4476506710052,3710.2339067459106,31096,6984,24112,24112,0,31,6923000.0
6923,6923999,20.311493995171887,37.22250463540529,0.07996779607980564,4601.922248840332,536.5150244235992,3710.9386796951294,31098,6985,24113,24113,0,31,6924000.0
6924,6924999,20.312239768385325,37.225119655705456,0.07996233923857643,4602.343560218811,536.5847463607788,3712.55105304718,31109,6986,24123,24123,0,31,6925000.0
6925,6925999,20.312659682980854,37.22550680609697,0.07996213170926125,4602.74235701561,536.6515755653381,3714.1431245803833,31109,6986,24123,24123,0,31,6926000.0
6926,6926999,20.31369378053623,37.22787704290194,0.07995228589374082,4603.691118955612,536.7219552993774,3713.0927476882935,31121,6988,24133,24133,0,31,6927000.0
6927,6927999,20.31471840923772,37.229913434413874,0.0799519854011248,4604.197681903839,536.7898604869843,3714.196225166321,31121,6988,24133,24133,0,31,6928000.0
6928,6928999,20.315625060894668,37.23159270180857,0.07995135130925146,4604.943362951279,536.8596928119659,3714.2437868118286,31121,6988,24133,24133,0,31,6929000.0
6929,6929999,20.316273755957504,37.23246535968934,0.07995197462623038,4605.745347976685,536.9327521324158,3713.785801887512,31122,6988,24134,24134,0,31,6930000.0
6930,6930999,20.316919081380366,37.2328778430426,0.0799459629844188,4606.871959924698,537.0044469833374,3712.1747941970825,31130,6992,24138,24138,0,31,6931000.0
6931,6931999,20.317271399622392,37.232900875362944,0.0799451525467787,4607.469738006592,537.0718808174133,3712.7159090042114,31130,6992,24138,24138,0,31,6932000.0
6932,6932999,20.317784936542264,37.233532894021735,0.07992324324857936,4608.129467725754,537.1416227817535,3713.2262620925903,31151,6995,24156,24156,0,31,6933000.0
6933,6933999,20.317718243622352,37.23273876233247,0.07991239026521557,4608.6287541389465,537.2108733654022,3714.519917488098,31166,6996,24170,24170,0,31,6934000.0
6934,6934999,20.317575698185003,37.23166718179376,0.07990701667355926,4609.312139749527,537.2833545207977,3714.734272956848,31171,6998,24173,24173,0,31,6935000.0
6935,6935999,20.317439551556152,37.23077646231577,0.07990427953756485,4610.19175863266,537.3514931201935,3714.249264717102,31179,7002,24177,24177,0,31,6936000.0
6936,6936999,20.317425023421716,37.23005147751102,0.07990181474354208,4610.608084440231,537.4187662601471,3715.8763856887817,31191,7003,24188,24188,0,31,6937000.0
6937,6937999,20.317163882090693,37.22874240119428,0.07989371794830036,4611.421189546585,537.4889895915985,3715.635899543762,31203,7004,24199,24199,0,31,6938000.0
6938,6938999,20.317111739849476,37.227647836929556,0.07988708899167363,4612.041745901108,537.5562846660614,3716.2134675979614,31203,7004,24199,24199,0,31,6939000.0
6939,6939999,20.31714983245045,37.22688543278921,0.0798825873123784,4612.926787376404,537.6223833560944,3715.3628664016724,31203,7004,24199,24199,0,31,6940000.0
6940,6940999,20.31720006377928,37.22611017093021,0.07987350813135285,4613.697044372559,537.6890459060669,3715.3569078445435,31220,7007,24213,24213,0,31,6941000.0
6941,6941999,20.317320188987722,37.227783400424286,0.07986008110844622,4614.332231760025,537.7565400600433,3715.883481025696,31224,7009,24215,24215,0,31,6942000.0
6942,6942999,20.317677557831203,37.22790114382915,0.07985111072835938,4614.926791191101,537.8262481689453,3716.5523195266724,31224,7009,24215,24215,0,31,6943000.0
6943,6943999,20.31790460975964,37.227541789867324,0.07984406032114255,4615.372022151947,537.8948936462402,3718.1523866653442,31237,7010,24227,24227,0,31,6944000.0
6944,6944999,20.31831492389858,37.22770385478125,0.07983747407069886,4616.313406229019,537.9673459529877,3717.1845598220825,31247,7011,24236,24236,0,31,6945000.0
6945,6945999,20.31905169042154,37.228079100821816,0.07983128209845758,4617.112904787064,538.0361082553864,3716.815510749817,31247,7011,24236,24236,0,31,6946000.0
6946,6946999,20.319681662081127,37.22821611384608,0.07983132494125822,4617.633095741272,538.1072239875793,3717.8824892044067,31247,7011,24236,24236,0,31,6947000.0
6947,6947999,20.320439492819833,37.228685975483806,0.07982881986439072,4618.197991847992,538.1782357692719,3718.9052019119263,31261,7013,24248,24248,0,31,6948000.0
6948,6948999,20.321148823518534,37.22885869275908,0.079829681155421,4619.0705671310425,538.2467942237854,3718.3329133987427,31267,7016,24251,24251,0,31,6949000.0
6949,6949999,20.321926138673625,37.228985540222446,0.07983074793026246,4619.709959745407,538.3170299530029,3719.0224657058716,31269,7017,24252,24252,0,31,6950000.0
6950,6950999,20.322598030177506,37.229002533832535,0.07983642536132396,4620.318945407867,538.3830575942993,3719.78347492218,31280,7018,24262,24262,0,31,6951000.0
6951,6951999,20.323041156592513,37.22851330727127,0.07983675519928879,4620.993073225021,538.4502317905426,3720.2054872512817,31283,7020,24263,24263,0,31,6952000.0
6952,6952999,20.323228394455885,37.2288205655247,0.07982460926199386,4621.500724554062,538.516592502594,3721.447331428528,31302,7021,24281,24281,0,31,6953000.0
6953,6953999,20.323189806234392,37.22872059978136,0.07982434828425122,4621.905650854111,538.5850985050201,3723.189435005188,31322,7022,24300,24300,0,31,6954000.0
6954,6954999,20.32303603007417,37.22833233827244,0.07982044985813841,4622.362304210663,538.6516919136047,3724.6006212234497,31326,7022,24304,24304,0,31,6955000.0
6955,6955999,20.323052227022977,37.22829231268837,0.07980971387927815,4622.908412456512,538.7200884819031,3725.7195024490356,31335,7024,24311,24311,0,31,6956000.0
6956,6956999,20.323175956768715,37.228224130266845,0.07980558275800209,4623.292897939682,538.7861557006836,3727.4298219680786,31336,7024,24312,24312,0,31,6957000.0
6957,6957999,20.32365926440534,37.228765089737905,0.07980557941974353,4624.0694353580475,538.8539428710938,3727.3931856155396,31356,7028,24328,24328,0,31,6958000.0
6958,6958999,20.323902214064237,37.22886770107471,0.0798087140336845,4624.678503751755,538.9201874732971,3728.035283088684,31358,7029,24329,24329,0,31,6959000.0
6959,6959999,20.324310270796023,37.22946204347324,0.07981404729934971,4624.969316244125,538.9868271350861,3730.2127809524536,31358,7029,24329,24329,0,31,6960000.0
6960,6960999,20.325353867191744,37.23284524437491,0.07982840346177711,4625.393282651901,539.0529983043671,3731.834858894348,31360,7030,24330,24330,0,31,6961000.0
6961,6961999,20.326418961186217,37.23418503754351,0.07983952564726748,4626.339275360107,539.1210708618164,3730.825421333313,31386,7032,24354,24354,0,31,6962000.0
6962,6962999,20.327945340212395,37.2392586930539,0.07987642896807512,4627.067737340927,539.1892123222351,3730.8830156326294,31390,7034,24356,24356,0,31,6963000.0
6963,6963999,20.329192723512637,37.24077558122196,0.07990124972806034,4627.641124725342,539.2575240135193,3731.9204149246216,31392,7035,24357,24357,0,31,6964000.0
6964,6964999,20.330785089730274,37.24357504508271,0.07993397454734075,4628.133211135864,539.3260886669159,3733.02672290802,31392,7035,24357,24357,0,31,6965000.0
6965,6965999,20.333053620317816,37.247504887199646,0.07997890437200894,4628.824787378311,539.3940539360046,3733.09011554718,31392,7035,24357,24357,0,31,6966000.0
6966,6966999,20.33462141837424,37.24931289023785,0.08003066980752382,4629.827477693558,539.4630200862885,3731.942723274231,31402,7040,24362,24362,0,31,6967000.0
6967,6967999,20.33677138723039,37.25262386778967,0.0800779206039397,4630.543288469315,539.5307025909424,3732.076855659485,31405,7041,24364,24364,0,31,6968000.0
6968,6968999,20.338801468418975,37.2572126357725,0.08011314714471163,4631.214205503464,539.5976297855377,3732.59370136261,31407,7042,24365,24365,0,31,6969000.0
6969,6969999,20.340203436237424,37.261447432623164,0.08007437255226091,4631.617052316666,539.6638934612274,3734.443585395813,31431,7043,24388,24388,0,31,6970000.0
6970,6970999,20.341577151572505,37.26703844911736,0.0800462057386816,4631.884384393692,539.7282016277313,3736.6241426467896,31432,7043,24389,24389,0,31,6971000.0
6971,6971999,20.342874369720594,37.271473562098834,0.08003592057540176,4632.764596223831,539.7943711280823,3735.8320360183716,31440,7047,24393,24393,0,31,6972000.0
6972,6972999,20.343754961760098,37.27382259154276,0.08002025817396707,4633.4046022892,539.8611469268799,3736.4170503616333,31442,7048,24394,24394,0,31,6973000.0
6973,6973999,20.344742005778233,37.27658751209531,0.08001782062585261,4633.893124341965,539.9281992912292,3737.5840196609497,31442,7048,24394,24394,0,31,6974000.0
6974,6974999,20.345612462076204,37.279253287208924,0.08002234786979612,4634.406285762787,539.9953346252441,3738.6806535720825,31444,7049,24395,24395,0,31,6975000.0
6975,6975999,20.346335934045072,37.28085514238704,0.08002153438852377,4635.024246931076,540.0622682571411,3739.21519947052,31446,7050,24396,24396,0,31,6976000.0
6976,6976999,20.34807003545563,37.28868126141637,0.08002423390605251,4635.402893066406,540.1276843547821,3741.0627489089966,31446,7050,24396,24396,0,31,6977000.0
6977,6977999,20.34951695624193,37.291266448513205,0.08001591436683608,4636.159975767136,540.1944191455841,3741.068112373352,31452,7053,24399,24399,0,31,6978000.0
6978,6978999,20.350716809829397,37.292471438797264,0.08002010925254899,4636.860910892487,540.2604355812073,3741.1408433914185,31452,7053,24399,24399,0,31,6979000.0
6979,6979999,20.352184604691285,37.29458487806947,0.08002242507278567,4637.855087280273,540.3283567428589,3740.054211616516,31479,7057,24422,24422,0,31,6980000.0
6980,6980999,20.353587782995323,37.297563633352716,0.08002864654500019,4638.457584619522,540.3961265087128,3740.6263704299927,31479,7057,24422,24422,0,31,6981000.0
6981,6981999,20.355004697408305,37.299164410859895,0.08004815301709223,4639.414142131805,540.4637279510498,3739.6594972610474,31484,7060,24424,24424,0,31,6982000.0
6982,6982999,20.357140858032874,37.30354618083012,0.08009564269139957,4639.806566238403,540.530410528183,3741.3947954177856,31484,7060,24424,24424,0,31,6983000.0
6983,6983999,20.359063989384698,37.30682525594647,0.08009969993151766,4640.892882347107,540.6000573635101,3739.9621934890747,31489,7063,24426,24426,0,31,6984000.0
6984,6984999,20.361018960582605,37.30996699246438,0.08012453107845441,4641.742257118225,540.6692171096802,3739.476071357727,31493,7065,24428,24428,0,31,6985000.0
6985,6985999,20.362767318950837,37.31147130983715,0.08014887512277136,4642.238398075104,540.7367210388184,3740.602032661438,31493,7065,24428,24428,0,31,6986000.0
6986,6986999,20.364222619085112,37.3123271675491,0.08015954902838185,4642.820872545242,540.804949760437,3741.3604021072388,31493,7065,24428,24428,0,31,6987000.0
6987,6987999,20.36486068149998,37.31321811576149,0.08013663078558997,4643.110067844391,540.8772864341736,3743.7196474075317,31513,7065,24448,24448,0,31,6988000.0
6988,6988999,20.364411343165,37.312576521186394,0.08012906357995864,4644.173145055771,540.9438111782074,3741.9452562332153,31519,7065,24454,24454,0,31,6989000.0
6989,6989999,20.364078057420382,37.31196897082557,0.08012780503421302,4644.581738948822,541.0153388977051,3743.6496934890747,31522,7065,24457,24457,0,31,6990000.0
6990,6990999,20.363815420117863,37.31102704116763,0.08011993130274597,4645.1183087825775,541.0826301574707,3744.7847108840942,31524,7066,24458,24458,0,31,6991000.0
6991,6991999,20.363672589893024,37.310194001366234,0.0801155065606517,4645.608449935913,541.148713350296,3746.132565498352,31527,7067,24460,24460,0,31,6992000.0
6992,6992999,20.363613614746352,37.30942033514742,0.0801116707927112,4646.537256479263,541.2168779373169,3745.171093940735,31529,7068,24461,24461,0,31,6993000.0
6993,6993999,20.363410616019227,37.308256508861255,0.08010640399748736,4647.022549152374,541.285329580307,3746.278820991516,31529,7068,24461,24461,0,31,6994000.0
6994,6994999,20.363464218879514,37.30777595256267,0.08010380747396606,4647.379949569702,541.3587567806244,3748.034665107727,31531,7069,24462,24462,0,31,6995000.0
6995,6995999,20.36345757596427,37.30766193847282,0.08010825978310165,4648.159429073334,541.4302430152893,3748.0580339431763,31545,7071,24474,24474,0,31,6996000.0
6996,6996999,20.36356767198589,37.30720256796153,0.08011862998583352,4648.856014490128,541.4970059394836,3748.145276069641,31545,7071,24474,24474,0,31,6997000.0
6997,6997999,20.36384449779259,37.30693677990582,0.08012645820375508,4649.481557846069,541.5667824745178,3748.7271547317505,31545,7071,24474,24474,0,31,6998000.0
6998,6998999,20.3640351277865,37.30647002823509,0.08013351242646105,4650.151261806488,541.6341638565063,3749.1184587478638,31545,7071,24474,24474,0,31,6999000.0
6999,6999999,20.36444174490768,37.306766956109556,0.08014021613137323,4650.682150840759,541.7035641670227,3750.2009172439575,31545,7071,24474,24474,0,31,7000000.0
7000,7000999,20.364679732812327,37.30657145595022,0.08014084593074744,4651.216301202774,541.7693569660187,3751.221531867981,31549,7073,24476,24476,0,31,7001000.0
7001,7001999,20.364964969799605,37.30635982771279,0.08014269962395693,4651.934015512466,541.8356394767761,3751.225911140442,31551,7074,24477,24477,0,31,7002000.0
7002,7002999,20.36545597325437,37.306670373102264,0.08014426396947794,4652.356112957001,541.9012176990509,3752.743718147278,31554,7075,24479,24479,0,31,7003000.0
7003,7003999,20.36557995522385,37.30631234903557,0.08013936942478206,4652.82657623291,541.9675393104553,3754.2255601882935,31554,7075,24479,24479,0,31,7004000.0
7004,7004999,20.366048719754158,37.30613822696642,0.08014147214112899,4653.673918008804,542.0339815616608,3753.731869697571,31558,7077,24481,24481,0,31,7005000.0
7005,7005999,20.366144801502134,37.30529011248398,0.08014234532078424,4654.748361825943,542.1024160385132,3751.8792543411255,31558,7077,24481,24481,0,31,7006000.0
7006,7006999,20.36585164173035,37.304155583850026,0.08014231461791488,4655.383961200714,542.1691398620605,3752.3608980178833,31562,7079,24483,24483,0,31,7007000.0
7007,7007999,20.36548142564749,37.30294873619247,0.080130407269143,4655.988392353058,542.2369015216827,3753.2419328689575,31582,7080,24502,24502,0,31,7008000.0
7008,7008999,20.36494248098462,37.30181492351271,0.08011261664099867,4656.562247991562,542.3042311668396,3753.97146320343,31587,7080,24507,24507,0,31,7009000.0
7009,7009999,20.364186681147846,37.30030439195525,0.08010370235076014,4656.860731840134,542.3703961372375,3756.109066963196,31604,7081,24523,24523,0,31,7010000.0
7010,7010999,20.363813412836304,37.29957961709993,0.08008138885879479,4657.434798955917,542.4373962879181,3756.8342485427856,31605,7081,24524,24524,0,31,7011000.0
7011,7011999,20.363532080607087,37.29906720768103,0.08006079692339452,4657.91711974144,542.5050690174103,3758.0224809646606,31606,7081,24525,24525,0,31,7012000.0
7012,7012999,20.36328786304774,37.29836532490576,0.08004936541107466,4658.427592277527,542.5721507072449,3759.120083808899,31609,7082,24527,24527,0,31,7013000.0
7013,7013999,20.362991755982886,37.29805737752218,0.08003606034537114,4659.061221122742,542.639429807663,3759.692982673645,31613,7084,24529,24529,0,31,7014000.0
7014,7014999,20.3627290942459,37.29716466287364,0.080027522973388,4659.706330060959,542.7077770233154,3760.2320985794067,31626,7086,24540,24540,0,31,7015000.0
7015,7015999,20.36229468211266,37.29602230558988,0.08002783542473535,4660.343027353287,542.7762010097504,3760.8221406936646,31630,7088,24542,24542,0,31,7016000.0
7016,7016999,20.362138926826265,37.295467342094575,0.08002469606191698,4660.726460456848,542.8429327011108,3762.547558784485,31630,7088,24542,24542,0,31,7017000.0
7017,7017999,20.362028459375033,37.2947829953992,0.08001765572423525,4661.261691570282,542.9113273620605,3763.4634370803833,31637,7089,24548,24548,0,31,7018000.0
7018,7018999,20.361957368853453,37.29448149657749,0.08000463592877727,4662.050353527069,542.981155872345,3763.4013414382935,31645,7093,24552,24552,0,31,7019000.0
7019,7019999,20.36160402174779,37.29367626207036,0.08000277712254555,4662.91553068161,543.0526306629181,3762.8823595046997,31645,7093,24552,24552,0,31,7020000.0
7020,7020999,20.361626709380204,37.2933319380409,0.07999486681026435,4663.736770391464,543.1209416389465,3762.662709236145,31647,7094,24553,24553,0,31,7021000.0
7021,7021999,20.361662075920368,37.29435265077836,0.07998066266567727,4664.356263875961,543.1903164386749,3763.209942817688,31663,7095,24568,24568,0,31,7022000.0
7022,7022999,20.36147798103399,37.29358537474362,0.07997306671512971,4664.839707374573,543.2579035758972,3764.438786506653,31663,7095,24568,24568,0,31,7023000.0
7023,7023999,20.361329489839708,37.29258435669107,0.07996615604608615,4665.240275859833,543.3253529071808,3766.0413789749146,31663,7095,24568,24568,0,31,7024000.0
7024,7024999,20.36132346792425,37.29200754818666,0.0799596801602187,4666.069229125977,543.3923246860504,3765.6186418533325,31667,7097,24570,24570,0,31,7025000.0
7025,7025999,20.361233822501866,37.2912185531718,0.07995095885445747,4666.896583557129,543.4623353481293,3765.1234254837036,31669,7098,24571,24571,0,31,7026000.0
7026,7026999,20.361164086821688,37.29049152642984,0.07994182550103757,4667.839630126953,543.5326819419861,3764.057156562805,31673,7100,24573,24573,0,31,7027000.0
7027,7027999,20.361045309512026,37.29102912911444,0.07993274044795817,4668.517743587494,543.6015949249268,3764.4694566726685,31687,7101,24586,24586,0,31,7028000.0
7028,7028999,20.360519180668327,37.2904000153052,0.07991814974372946,4669.213220357895,543.6726880073547,3764.8431673049927,31719,7102,24617,24617,0,31,7029000.0
7029,7029999,20.359812338118097,37.289244901621416,0.07991053456151453,4669.894650220871,543.7413198947906,3764.979344367981,31723,7102,24621,24621,0,31,7030000.0
7030,7030999,20.359334970358315,37.29002574592382,0.0798947258942253,4670.586903095245,543.8100290298462,3765.1119813919067,31725,7102,24623,24623,0,31,7031000.0
7031,7031999,20.358689368114018,37.28849632924457,0.07988930402918493,4671.297795295715,543.877222776413,3765.170521736145,31728,7103,24625,24625,0,31,7032000.0
7032,7032999,20.358187873813247,37.28731040647592,0.07988154541883286,4671.622596979141,543.9449946880341,3767.2976503372192,31729,7103,24626,24626,0,31,7033000.0
7033,7033999,20.357720950437592,37.2864110120465,0.07987538687334128,4672.167155742645,544.0110146999359,3768.3535203933716,31750,7105,24645,24645,0,31,7034000.0
7034,7034999,20.357215408260448,37.28529188225235,0.07986831178048037,4672.803532838821,544.0787808895111,3768.855954170227,31753,7106,24647,24647,0,31,7035000.0
7035,7035999,20.356676667532195,37.28395656055032,0.07986158542368083,4673.554958343506,544.1484179496765,3768.8499269485474,31757,7108,24649,24649,0,31,7036000.0
7036,7036999,20.356435672858808,37.28323905082208,0.07985073247210128,4674.253703117371,544.2164306640625,3768.9920778274536,31757,7108,24649,24649,0,31,7037000.0
7037,7037999,20.35589066984723,37.281793973075,0.07984337576864742,4674.7975816726685,544.2824456691742,3769.9442415237427,31760,7109,24651,24651,0,31,7038000.0
7038,7038999,20.355487851198053,37.28082875863121,0.07983320808562222,4675.662337779999,544.3502945899963,3769.5126543045044,31767,7112,24655,24655,0,31,7039000.0
7039,7039999,20.355208104565257,37.2799600060461,0.07982596099619987,4676.188939809799,544.42001080513,3770.595913887024,31769,7113,24656,24656,0,31,7040000.0
7040,7040999,20.354918567890568,37.27893593193419,0.07981657175955281,4677.149650096893,544.4876675605774,3769.5243196487427,31773,7115,24658,24658,0,31,7041000.0
7041,7041999,20.354767712902163,37.27953414374781,0.079804238186851,4677.548503875732,544.5535953044891,3771.138096809387,31773,7115,24658,24658,0,31,7042000.0
7042,7042999,20.354702881942742,37.278958189065996,0.07979873657987657,4678.27282166481,544.6233623027802,3771.186718940735,31775,7116,24659,24659,0,31,7043000.0
7043,7043999,20.354702447922136,37.27856501110749,0.07979528991625462,4678.90606379509,544.6908257007599,3771.7038011550903,31777,7117,24660,24660,0,31,7044000.0
7044,7044999,20.354599343282903,37.277575564225884,0.07978741677802048,4679.611397981644,544.756637096405,3771.9084672927856,31779,7118,24661,24661,0,31,7045000.0
7045,7045999,20.35488914526945,37.27707782826743,0.07978564602624971,4680.365264177322,544.8236329555511,3771.901738166809,31783,7120,24663,24663,0,31,7046000.0
7046,7046999,20.35508109148808,37.2764394755937,0.07978108389916871,4681.191979885101,544.890997171402,3771.6121644973755,31787,7122,24665,24665,0,31,7047000.0
7047,7047999,20.355236900567856,37.275702935283476,0.07977727712798532,4681.704724550247,544.9600763320923,3772.6551179885864,31790,7123,24667,24667,0,31,7048000.0
7048,7048999,20.355084912036663,37.274862182374505,0.07977200396397299,4682.455030679703,545.032185792923,3772.8412370681763,31815,7125,24690,24690,0,31,7049000.0
7049,7049999,20.354787794985786,37.27483556325328,0.07975275248708769,4683.040531635284,545.098388671875,3773.5305604934692,31822,7126,24696,24696,0,31,7050000.0
7050,7050999,20.354297641056117,37.27400792872659,0.07974498294142085,4683.433838844299,545.1685645580292,3775.2393159866333,31824,7126,24698,24698,0,31,7051000.0
7051,7051999,20.35389968643226,37.27326789686555,0.0797402132612075,4683.9180426597595,545.2364239692688,3776.3815965652466,31825,7126,24699,24699,0,31,7052000.0
7052,7052999,20.353565838536497,37.27298814022549,0.0797292978182027,4684.390205383301,545.3034496307373,3777.6529817581177,31825,7126,24699,24699,0,31,7053000.0
7053,7053999,20.353525825454582,37.27353026312768,0.07971223520084536,4685.327968835831,545.370701789856,3776.6794023513794,31830,7128,24702,24702,0,31,7054000.0
7054,7054999,20.353302834458194,37.272686516579874,0.0797044579525712,4685.713854312897,545.4369568824768,3778.28990650177,31830,7128,24702,24702,0,31,7055000.0
7055,7055999,20.353385965800168,37.27365763117729,0.07969303552165397,4686.126071214676,545.5041747093201,3779.884663581848,31833,7129,24704,24704,0,31,7056000.0
7056,7056999,20.353288887371047,37.2733729171486,0.07968422276545672,4686.7915914058685,545.5708932876587,3780.351704597473,31839,7132,24707,24707,0,31,7057000.0
7057,7057999,20.353383247247177,37.27323088976928,0.0796767687581339,4687.5842888355255,545.6387808322906,3780.0499238967896,31840,7132,24708,24708,0,31,7058000.0
7058,7058999,20.353411229661322,37.27275724302514,0.07967046816760237,4688.080497980118,545.7078912258148,3781.1353273391724,31840,7132,24708,24708,0,31,7059000.0
7059,7059999,20.353932710199924,37.27434331324834,0.07965966116419865,4688.5362412929535,545.7824206352234,3782.7114305496216,31842,7133,24709,24709,0,31,7060000.0
7060,7060999,20.35426408597166,37.274544453366744,0.07965695743615209,4689.331275463104,545.8551013469696,3782.6709718704224,31853,7136,24717,24717,0,31,7061000.0
7061,7061999,20.35488361846528,37.27604615153517,0.07964670868383095,4690.255847454071,545.9244539737701,3781.662777900696,31855,7137,24718,24718,0,31,7062000.0
7062,7062999,20.355606831971944,37.2772322302783,0.07963804580457345,4690.766992807388,545.9920732975006,3782.7253465652466,31866,7138,24728,24728,0,31,7063000.0
7063,7063999,20.35693606826786,37.280014382719266,0.0796342739241579,4691.284085512161,546.0618622303009,3783.7803621292114,31868,7139,24729,24729,0,31,7064000.0
7064,7064999,20.35788772768105,37.281861393459685,0.07963667034621957,4692.0501165390015,546.1318256855011,3783.51500415802,31872,7141,24731,24731,0,31,7065000.0
7065,7065999,20.359165812912288,37.2845093218055,0.07963879556962439,4693.317493438721,546.2011470794678,3781.028203010559,31880,7145,24735,24735,0,31,7066000.0
7066,7066999,20.360486923111562,37.28701861604469,0.07964692860169997,4693.853097438812,546.269193649292,3782.1288347244263,31884,7147,24737,24737,0,31,7067000.0
7067,7067999,20.362122472461827,37.29125319901808,0.07965217941619218,4694.5137622356415,546.3374423980713,3782.6383867263794,31890,7150,24740,24740,0,31,7068000.0
7068,7068999,20.363614376518406,37.293259921377704,0.07967370155977727,4695.182903051376,546.4049029350281,3783.185025215149,31906,7153,24753,24753,0,31,7069000.0
7069,7069999,20.363890472800488,37.293102588293976,0.0796647828351742,4695.552628993988,546.474440574646,3785.0939226150513,31926,7153,24773,24773,0,31,7070000.0
7070,7070999,20.363657406260263,37.29316091561327,0.07965413444882763,4696.21164059639,546.5413496494293,3785.4758195877075,31931,7154,24777,24777,0,31,7071000.0
7071,7071999,20.363554655320147,37.29287125976119,0.07964485308443325,4696.752189397812,546.6061105728149,3786.3814363479614,31937,7156,24781,24781,0,31,7072000.0
7072,7072999,20.3637207435682,37.293892725307266,0.07963426803119988,4697.248242139816,546.6733818054199,3787.5879945755005,31939,7157,24782,24782,0,31,7073000.0
7073,7073999,20.36414501097879,37.2955616572993,0.07963047907579646,4697.9817497730255,546.7419033050537,3787.645604133606,31944,7159,24785,24785,0,31,7074000.0
7074,7074999,20.364192730219138,37.29534284922463,0.07962468758940489,4698.590513944626,546.8120491504669,3788.256901741028,31946,7160,24786,24786,0,31,7075000.0
7075,7075999,20.36523838415547,37.29747143708388,0.07962894350651872,4699.078094959259,546.8804767131805,3789.396023750305,31946,7160,24786,24786,0,31,7076000.0
7076,7076999,20.36612084642439,37.29935926653483,0.07962883232004248,4699.376181125641,546.947765827179,3791.5113039016724,31946,7160,24786,24786,0,31,7077000.0
7077,7077999,20.36681944221637,37.29997012267256,0.07963522529918765,4700.077470302582,547.0158865451813,3791.690526008606,31948,7161,24787,24787,0,31,7078000.0
7078,7078999,20.36773103835739,37.30094739445736,0.07965827471363429,4700.718743562698,547.0828423500061,3792.177990913391,31952,7163,24789,24789,0,31,7079000.0
7079,7079999,20.36943795174798,37.30390743477247,0.07969477073297737,4701.323506355286,547.1512434482574,3792.8522844314575,31954,7164,24790,24790,0,31,7080000.0
7080,7080999,20.37112522714226,37.30644062505203,0.07972563407932454,4702.01771068573,547.2175266742706,3792.9345750808716,31954,7164,24790,24790,0,31,7081000.0
7081,7081999,20.372917177716488,37.3095960970587,0.0797520253255607,4702.5237429142,547.2840881347656,3794.0185976028442,31954,7164,24790,24790,0,31,7082000.0
7082,7082999,20.374879340169926,37.312432126177676,0.07977930523666321,4703.040393829346,547.3508908748627,3795.0561418533325,31956,7165,24791,24791,0,31,7083000.0
7083,7083999,20.377027033743477,37.31615902089439,0.07982721820974492,4703.656571626663,547.4207954406738,3795.5864763259888,31958,7166,24792,24792,0,31,7084000.0
7084,7084999,20.379539071327876,37.31986221965441,0.07989785313875919,4704.156175374985,547.4888308048248,3796.679844856262,31958,7166,24792,24792,0,31,7085000.0
7085,7085999,20.38177561280282,37.32266865291592,0.0799496005281406,4704.885610580444,547.5571525096893,3796.7252626419067,31960,7167,24793,24793,0,31,7086000.0
7086,7086999,20.384380810855674,37.32699593305522,0.08001953827685215,4705.863343954086,547.62442445755,3795.6721696853638,31977,7171,24806,24806,0,31,7087000.0
7087,7087999,20.386921964024143,37.33085454110356,0.08009814920967717,4706.744914770126,547.6956470012665,3795.1286821365356,31992,7174,24818,24818,0,31,7088000.0
7088,7088999,20.38932225215826,37.334649932451164,0.08015546956733122,4707.408841609955,547.7654693126678,3795.6057024002075,32021,7177,24844,24844,0,31,7089000.0
7089,7089999,20.391327355091462,37.33909846913527,0.08018822109641333,4708.0658638477325,547.8326749801636,3796.05251789093,32027,7180,24847,24847,0,31,7090000.0
7090,7090999,20.391571616954383,37.33979856073837,0.0801434463453714,4708.529421806335,547.9005739688873,3797.4484300613403,32047,7180,24867,24867,0,31,7091000.0
7091,7091999,20.39199850359619,37.341088460886944,0.08012496203052921,4709.2639491558075,547.9681797027588,3797.426526069641,32055,7182,24873,24873,0,31,7092000.0
7092,7092999,20.3923865541991,37.3439372214798,0.0801009977847601,4709.781384706497,548.0355000495911,3798.569416999817,32057,7183,24874,24874,0,31,7093000.0
7093,7093999,20.39273343478239,37.34413362384627,0.08008847073719894,4710.4023241996765,548.1080651283264,3799.3244981765747,32062,7185,24877,24877,0,31,7094000.0
7094,7094999,20.393019330860508,37.344350173111565,0.08008323153525343,4711.140663146973,548.1765904426575,3799.5036058425903,32076,7187,24889,24889,0,31,7095000.0
7095,7095999,20.393496843270718,37.34486487951491,0.08007674209009097,4711.850455522537,548.2487990856171,3799.989773750305,32100,7190,24910,24910,0,31,7096000.0
7096,7096999,20.394151269403356,37.34604466736204,0.08008225447207551,4712.2908890247345,548.3210513591766,3801.623356819153,32102,7191,24911,24911,0,31,7097000.0
7097,7097999,20.395109966599207,37.34695280416767,0.0800884571731808,4712.847553014755,548.3879106044769,3802.737919807434,32106,7193,24913,24913,0,31,7098000.0
7098,7098999,20.396435818091046,37.34940269870554,0.08009443000666605,4713.137718677521,548.4542789459229,3805.0227785110474,32106,7193,24913,24913,0,31,7099000.0
7099,7099999,20.39901616967919,37.35755149984346,0.08011671005933274,4714.285299062729,548.5237782001495,3803.4369401931763,32112,7196,24916,24916,0,31,7100000.0
7100,7100999,20.40130780537691,37.36184785733364,0.0801545220107831,4715.0377452373505,548.5914249420166,3803.4483308792114,32121,7198,24923,24923,0,31,7101000.0
7101,7101999,20.40326852517854,37.36557756456884,0.08019645489076399,4716.025038719177,548.661581993103,3802.150860786438,32125,7200,24925,24925,0,31,7102000.0
7102,7102999,20.406091112398066,37.372112141980004,0.08024877332345381,4716.571679353714,548.7302491664886,3803.234288215637,32127,7201,24926,24926,0,31,7103000.0
7103,7103999,20.408671628966765,37.37832600684654,0.0803198656408517,4717.5606899261475,548.7994668483734,3802.128628730774,32131,7203,24928,24928,0,31,7104000.0
7104,7104999,20.411233788468284,37.385164365390615,0.08039360411354735,4718.073276996613,548.8667042255402,3803.256413459778,32133,7204,24929,24929,0,31,7105000.0
7105,7105999,20.413717004521313,37.38916349618337,0.08047268797300289,4719.256301403046,548.9339604377747,3801.178463935852,32139,7207,24932,24932,0,31,7106000.0
7106,7106999,20.41603085303798,37.39283325048834,0.08053733599428736,4719.641641139984,549.0015337467194,3802.907254219055,32139,7207,24932,24932,0,31,7107000.0
7107,7107999,20.417812339027925,37.39559824272105,0.08057590152909389,4720.363064050674,549.069452047348,3803.3009157180786,32141,7208,24933,24933,0,31,7108000.0
7108,7108999,20.418835732247242,37.398820418770796,0.08055171634467395,4720.7443997859955,549.1374289989471,3805.237271308899,32165,7208,24957,24957,0,31,7109000.0
7109,7109999,20.419619728718725,37.40450761037519,0.08051886230224348,4721.116148948669,549.2025737762451,3806.93793964386,32166,7208,24958,24958,0,31,7110000.0
7110,7110999,20.420230745175136,37.40511494284425,0.08051807425051427,4721.835140943527,549.2685356140137,3807.024983406067,32170,7210,24960,24960,0,31,7111000.0
7111,7111999,20.420901947655956,37.4064887385483,0.08052056112092099,4722.422086715698,549.3347144126892,3807.7600603103638,32171,7210,24961,24961,0,31,7112000.0
7112,7112999,20.421558362374853,37.407884973708434,0.08053591434245111,4723.080104827881,549.4063496589661,3808.235951423645,32175,7212,24963,24963,0,31,7113000.0
7113,7113999,20.422645844367104,37.409513794016085,0.0805710239142825,4723.7395441532135,549.4781126976013,3808.8191652297974,32179,7214,24965,24965,0,31,7114000.0
7114,7114999,20.424024981378537,37.412832508966346,0.0806190147656558,4724.255748271942,549.5463938713074,3809.90163898468,32181,7215,24966,24966,0,31,7115000.0
7115,7115999,20.425727110785598,37.416393170102516,0.08065870356863614,4724.655178785324,549.6150801181793,3811.5338563919067,32182,7215,24967,24967,0,31,7116000.0
7116,7116999,20.427924111638777,37.42452469537713,0.08072499273899536,4725.663374423981,549.6849896907806,3810.303364753723,32198,7219,24979,24979,0,31,7117000.0
7117,7117999,20.430566621612186,37.432834173353434,0.08082846197358795,4726.191149234772,549.7545273303986,3811.3951082229614,32200,7220,24980,24980,0,31,7118000.0
7118,7118999,20.433610939244556,37.44002182197827,0.08098394529084574,4726.611755132675,549.8215291500092,3812.9939317703247,32202,7221,24981,24981,0,31,7119000.0
7119,7119999,20.43660598802628,37.44745768936816,0.08105962352407858,4727.672490119934,549.8903787136078,3811.412480354309,32207,7224,24983,24983,0,31,7120000.0
7120,7120999,20.439594292688145,37.456561550068216,0.0811253644151958,4728.350817203522,549.9605214595795,3811.983510017395,32231,7227,25004,25004,0,31,7121000.0
7121,7121999,20.44320092199298,37.466443009022804,0.08124611422742745,4728.978424787521,550.0320081710815,3812.5816164016724,32233,7228,25005,25005,0,31,7122000.0
7122,7122999,20.44743261311256,37.47947048447728,0.0813928671273546,4729.844760417938,550.101838350296,3812.047764778137,32239,7231,25008,25008,0,31,7123000.0
7123,7123999,20.451135162562235,37.48914155790801,0.0815158742948594,4730.614344835281,550.1706812381744,3811.9778413772583,32244,7234,25010,25010,0,31,7124000.0
7124,7124999,20.45545267145713,37.498959011848136,0.08164498908942064,4731.263551712036,550.2407379150391,3812.554799079895,32248,7236,25012,25012,0,31,7125000.0
7125,7125999,20.459314018914736,37.508070924729935,0.08176702378722756,4732.060492277145,550.3102724552155,3812.116032600403,32248,7236,25012,25012,0,31,7126000.0
7126,7126999,20.46285841837135,37.515123015398686,0.08190400721922897,4732.677058458328,550.3802480697632,3812.6778688430786,32250,7237,25013,25013,0,31,7127000.0
7127,7127999,20.46507952605888,37.51974216250914,0.08183574263631876,4733.372517108917,550.4486856460571,3813.008526802063,32275,7237,25038,25038,0,31,7128000.0
7128,7128999,20.465797052978836,37.52110923999055,0.08181606624161886,4733.746372938156,550.5142393112183,3814.784436225891,32281,7237,25044,25044,0,31,7129000.0
7129,7129999,20.466400991666628,37.52343849308521,0.08181061876258722,4734.021600723267,550.580644607544,3816.9855241775513,32281,7237,25044,25044,0,31,7130000.0
7130,7130999,20.466688574366348,37.52411065153856,0.08179751478213182,4734.850474357605,550.6470375061035,3816.48757648468,32286,7239,25047,25047,0,31,7131000.0
7131,7131999,20.46699403755686,37.52454893372026,0.08179592088645593,4735.408134698868,550.7143497467041,3817.437008857727,32293,7241,25052,25052,0,31,7132000.0
7132,7132999,20.467263838060067,37.524950858707584,0.08179167611216709,4736.017872333527,550.7814552783966,3818.04763507843,32295,7242,25053,25053,0,31,7133000.0
7133,7133999,20.467257218853256,37.525113878334295,0.08179104772029566,4736.547665596008,550.851190328598,3819.240330696106,32321,7244,25077,25077,0,31,7134000.0
7134,7134999,20.467500100792932,37.525818232992435,0.08179145584635583,4737.2665247917175,550.9181578159332,3819.265866279602,32323,7245,25078,25078,0,31,7135000.0
7135,7135999,20.467731437539438,37.52565711930637,0.0817941754480368,4738.050746202469,550.9858462810516,3819.2321214675903,32340,7248,25092,25092,0,31,7136000.0
7136,7136999,20.468010353048975,37.525888018653205,0.08178397459300624,4738.474070072174,551.0536923408508,3820.842198371887,32342,7249,25093,25093,0,31,7137000.0
7137,7137999,20.468167850388657,37.52563794454496,0.08178603802170792,4739.283084630966,551.1198770999908,3820.654911994934,32344,7250,25094,25094,0,31,7138000.0
7138,7138999,20.468252699921702,37.525098768503334,0.08179193052103562,4740.006694555283,551.1907293796539,3820.647282600403,32348,7251,25097,25097,0,31,7139000.0
7139,7139999,20.468465725604727,37.52453613770751,0.08178965991683307,4740.7345197200775,551.25798869133,3820.679265022278,32350,7252,25098,25098,0,31,7140000.0
7140,7140999,20.46897738385219,37.524452818945484,0.08179070837430502,4741.031514644623,551.3238832950592,3822.7999544143677,32350,7252,25098,25098,0,31,7141000.0
7141,7141999,20.469227783447696,37.524872737588595,0.0817867835947379,4741.650346279144,551.3886134624481,3823.3231172561646,32352,7253,25099,25099,0,31,7142000.0
7142,7142999,20.469430341376718,37.52406448171419,0.08178382863739186,4742.298930168152,551.4543566703796,3823.8418855667114,32356,7255,25101,25101,0,31,7143000.0
7143,7143999,20.46938609396923,37.52280905604488,0.0817835586703709,4743.063280105591,551.520742893219,3823.8785066604614,32364,7258,25106,25106,0,31,7144000.0
7144,7144999,20.469343575837847,37.521942313166775,0.08176185658373436,4743.493975639343,551.5892107486725,3825.65522480011,32396,7260,25136,25136,0,31,7145000.0
7145,7145999,20.469268841015317,37.5218130196755,0.0817496272549667,4743.763885974884,551.65491771698,3827.918843269348,32399,7260,25139,25139,0,31,7146000.0
7146,7146999,20.46935321316873,37.52215269635977,0.08173856863550955,4744.453088283539,551.7232086658478,3828.248875617981,32404,7261,25143,25143,0,31,7147000.0
7147,7147999,20.46891302996435,37.520729160960286,0.08173788182532915,4745.216871976852,551.794716835022,3828.195713996887,32413,7263,25150,25150,0,31,7148000.0
7148,7148999,20.46892411438861,37.52114606729088,0.08174308493410698,4746.077459573746,551.866110086441,3827.7509050369263,32434,7266,25168,25168,0,31,7149000.0
7149,7149999,20.469024933434817,37.521195668868835,0.08176195780748352,4746.549031972885,551.9341070652008,3829.140393257141,32434,7266,25168,25168,0,31,7150000.0
7150,7150999,20.469081368693345,37.52113800592268,0.0817569450420097,4747.135166883469,552.0045552253723,3829.895115852356,32434,7266,25168,25168,0,31,7151000.0
7151,7151999,20.469256281443503,37.52152089978754,0.08175437827685206,4747.820437669754,552.074068069458,3830.230664253235,32441,7269,25172,25172,0,31,7152000.0
7152,7152999,20.469296602200654,37.52145209150327,0.08176735863478812,4748.721884012222,552.1453223228455,3829.5961809158325,32447,7272,25175,25175,0,31,7153000.0
7153,7153999,20.46996864029749,37.52467287827222,0.08176144912211658,4749.296409606934,552.2161595821381,3830.6830644607544,32469,7274,25195,25195,0,31,7154000.0
7154,7154999,20.470491361075425,37.52562635691267,0.0817719507852287,4750.0811903476715,552.2866864204407,3830.687092781067,32473,7276,25197,25197,0,31,7155000.0
7155,7155999,20.47077795071892,37.526027011106876,0.08177559452053274,4750.671627521515,552.3571610450745,3831.5758867263794,32479,7279,25200,25200,0,31,7156000.0
7156,7156999,20.47099929342441,37.525949569041636,0.08179373181471095,4751.590754032135,552.42675948143,3830.6405000686646,32485,7282,25203,25203,0,31,7157000.0
7157,7157999,20.471396603476645,37.526100444614926,0.08179522089584212,4752.2750470638275,552.4975740909576,3830.922444343567,32485,7282,25203,25203,0,31,7158000.0
7158,7158999,20.472267075072132,37.529052683402696,0.08180156976235564,4752.824540376663,552.5677042007446,3831.979748725891,32489,7284,25205,25205,0,31,7159000.0
7159,7159999,20.47243778950088,37.52852854953005,0.08181916508114262,4753.528565645218,552.638265132904,3832.4184312820435,32495,7287,25208,25208,0,31,7160000.0
7160,7160999,20.472575029468018,37.527993675268924,0.08183615310629933,4754.0661244392395,552.7076332569122,3833.5791902542114,32504,7288,25216,25216,0,31,7161000.0
7161,7161999,20.473288564741125,37.53372067626776,0.08199864532778323,4754.323090553284,552.776171207428,3836.076329231262,32528,7288,25240,25240,0,31,7162000.0
7162,7162999,20.473849899410432,37.53825729035068,0.08195476020398262,4754.912721157074,552.8436822891235,3836.7942247390747,32532,7288,25244,25244,0,31,7163000.0
7163,7163999,20.474011941867342,37.53903217858886,0.08190084133710562,4755.184850692749,552.9115836620331,3838.985997200012,32532,7288,25244,25244,0,31,7164000.0
7164,7164999,20.47436499623448,37.540182342706174,0.08189116370200489,4755.969362020493,552.9798099994659,3839.0182695388794,32541,7291,25250,25250,0,31,7165000.0
7165,7165999,20.474910355953664,37.541334411166815,0.0818685508872029,4756.500573158264,553.0483887195587,3840.0931367874146,32546,7293,25253,25253,0,31,7166000.0
7166,7166999,20.475503855971414,37.54243026160226,0.08182523220900939,4756.987243652344,553.1149952411652,3841.3747911453247,32548,7294,25254,25254,0,31,7167000.0
7167,7167999,20.47586019355144,37.54289962664328,0.0818282617696503,4757.403743505478,553.1823709011078,3843.010334968567,32559,7295,25264,25264,0,31,7168000.0
7168,7168999,20.47660858425505,37.543615067159216,0.08180807890106656,4757.974193811417,553.2507693767548,3844.015507698059,32567,7298,25269,25269,0,31,7169000.0
7169,7169999,20.477295187285787,37.5440375156007,0.08180584038594796,4758.621718645096,553.3181312084198,3844.5348176956177,32572,7300,25272,25272,0,31,7170000.0
7170,7170999,20.478378914874533,37.54737795348859,0.081805739819923,4759.345001459122,553.3856008052826,3844.584668159485,32574,7301,25273,25273,0,31,7171000.0
7171,7171999,20.479245934956854,37.54863921249448,0.08181340468832488,4760.1251521110535,553.4539752006531,3844.6143312454224,32596,7304,25292,25292,0,31,7172000.0
7172,7172999,20.480091462161916,37.54920582832878,0.08181793625699918,4760.704776287079,553.5231640338898,3845.533268928528,32602,7307,25295,25295,0,31,7173000.0
7173,7173999,20.481027962473714,37.550365495003625,0.08182990985005323,4761.293117046356,553.5905854701996,3846.1586503982544,32603,7307,25296,25296,0,31,7174000.0
7174,7174999,20.48224083276998,37.55372721828427,0.0818103927157694,4762.214502811432,553.6590256690979,3845.2999086380005,32607,7309,25298,25298,0,31,7175000.0
7175,7175999,20.483537732554947,37.555156110740946,0.08182207288174392,4762.502782583237,553.7268466949463,3847.4633073806763,32607,7309,25298,25298,0,31,7176000.0
7176,7176999,20.484560333921,37.55586395579274,0.0818136024306233,4763.121874809265,553.7951815128326,3848.0165224075317,32607,7309,25298,25298,0,31,7177000.0
7177,7177999,20.485708491444385,37.55715948764148,0.08180670776342491,4764.401109695435,553.8633179664612,3845.4559602737427,32613,7312,25301,25301,0,31,7178000.0
7178,7178999,20.486744598221975,37.55776273799406,0.08182249319744184,4764.994295358658,553.9356226921082,3846.108036994934,32613,7312,25301,25301,0,31,7179000.0
7179,7179999,20.487530570874057,37.557746517989195,0.08183157828412768,4765.6768589019775,554.0055487155914,3846.477765083313,32627,7315,25312,25312,0,31,7180000.0
7180,7180999,20.488572743120443,37.55894116803251,0.08185392600932095,4766.28324174881,554.07750248909,3847.163784980774,32627,7315,25312,25312,0,31,7181000.0
7181,7181999,20.48896149972586,37.55948028255975,0.08184966821430129,4767.261148452759,554.147923707962,3846.3359804153442,32670,7319,25351,25351,0,31,7182000.0
7182,7182999,20.48877902416812,37.55947012289513,0.08182916948195951,4767.571991920471,554.2155010700226,3848.604329109192,32675,7320,25355,25355,0,31,7183000.0
7183,7183999,20.4887498977716,37.55968337774547,0.08180888187031421,4768.106501579285,554.2825291156769,3849.703999519348,32689,7322,25367,25367,0,31,7184000.0
7184,7184999,20.4888403359993,37.55934894049425,0.08179647033150028,4768.696901321411,554.351092338562,3850.6506929397583,32691,7323,25368,25368,0,31,7185000.0
7185,7185999,20.488912240212304,37.5587787913332,0.08178902614177286,4769.442367076874,554.4208111763,3850.7195253372192,32697,7325,25372,25372,0,31,7186000.0
7186,7186999,20.488897203971227,37.55898739384252,0.08178480905437246,4769.9828543663025,554.4907329082489,3851.813847541809,32699,7326,25373,25373,0,31,7187000.0
7187,7187999,20.489309004422182,37.55892810981277,0.08180162576393779,4770.604287862778,554.5641725063324,3852.4060945510864,32702,7327,25375,25375,0,31,7188000.0
7188,7188999,20.489810289344245,37.55935918047386,0.08181175210738034,4771.20739197731,554.6338315010071,3853.15123462677,32705,7328,25377,25377,0,31,7189000.0
7189,7189999,20.490394006230982,37.559802897744646,0.08181873698490172,4771.630492448807,554.7006123065948,3854.774296760559,32716,7329,25387,25387,0,31,7190000.0
7190,7190999,20.49138254407704,37.560982163787145,0.08182845906589797,4772.426654100418,554.7715203762054,3854.7798585891724,32727,7332,25395,25395,0,31,7191000.0
7191,7191999,20.492552742112853,37.56228828808998,0.08185716187370762,4773.129557609558,554.846432685852,3855.2285890579224,32734,7335,25399,25399,0,31,7192000.0
7192,7192999,20.493954812039494,37.56464571307454,0.0818779855374473,4773.776309728622,554.9186599254608,3855.79723072052,32736,7336,25400,25400,0,31,7193000.0
7193,7193999,20.49551867457823,37.56808636134762,0.08191354403393836,4774.551469564438,554.9938530921936,3855.828007698059,32745,7338,25407,25407,0,31,7194000.0
7194,7194999,20.496854802653527,37.56933853165305,0.0819663574784244,4775.25492477417,555.0633518695831,3856.352925300598,32752,7341,25411,25411,0,31,7195000.0
7195,7195999,20.498673420450725,37.57202349609478,0.08200434925567546,4776.116406679153,555.135534286499,3856.0063982009888,32765,7343,25422,25422,0,31,7196000.0
7196,7196999,20.50046022859227,37.57421693880445,0.0820607994509186,4777.066888332367,555.205335855484,3855.0055894851685,32769,7345,25424,25424,0,31,7197000.0
7197,7197999,20.502144137082393,37.57642939759791,0.08211030142240872,4777.797687530518,555.2798626422882,3855.354329109192,32771,7346,25425,25425,0,31,7198000.0
7198,7198999,20.503906093050983,37.578372374682075,0.08217642218168797,4778.376545906067,555.3511216640472,3856.1272478103638,32771,7346,25425,25425,0,31,7199000.0
7199,7199999,20.505819698128075,37.58148443140488,0.08225540298268286,4779.14431810379,555.4224722385406,3856.096013069153,32776,7348,25428,25428,0,31,7200000.0
7200,7200999,20.507695587791098,37.58352566514306,0.08234764500293079,4779.6558792591095,555.4909172058105,3857.2921648025513,32778,7349,25429,25429,0,31,7201000.0
7201,7201999,20.508988446065946,37.585618810640504,0.08238994657156562,4780.246686697006,555.5630593299866,3858.19908618927,32796,7350,25446,25446,0,31,7202000.0
7202,7202999,20.509107448191376,37.585866306345544,0.08237299482044835,4780.691258192062,555.62992811203,3859.713231086731,32809,7350,25459,25459,0,31,7203000.0
7203,7203999,20.508898134085563,37.584976793837434,0.08236881723082623,4781.26652097702,555.6967105865479,3860.4629487991333,32814,7351,25463,25463,0,31,7204000.0
7204,7204999,20.509044646076227,37.58481748224947,0.08236349469641258,4781.695028543472,555.7638351917267,3862.0026140213013,32819,7353,25466,25466,0,31,7205000.0
7205,7205999,20.50968239478742,37.58585209089701,0.08235818031668984,4782.316591501236,555.8324680328369,3862.9629793167114,32884,7355,25529,25529,0,31,7206000.0
7206,7206999,20.51067788306691,37.587583692419926,0.08235997900037051,4783.1166779994965,555.9021036624908,3862.6619005203247,32887,7356,25531,25531,0,31,7207000.0
7207,7207999,20.51217684915529,37.589916606734874,0.08238118399911398,4783.518634319305,555.9694244861603,3864.2817811965942,32887,7356,25531,25531,0,31,7208000.0
7208,7208999,20.51424859152735,37.594016590677086,0.08241341505955924,4784.12303519249,556.0394072532654,3864.9347887039185,32889,7357,25532,25532,0,31,7209000.0
7209,7209999,20.516145520628108,37.59714375229982,0.08245404827845582,4784.491505384445,556.1086478233337,3866.736569404602,32890,7357,25533,25533,0,31,7210000.0
7210,7210999,20.518600719139577,37.60139658507906,0.0825083641768325,4784.998701810837,556.1751365661621,3867.8252000808716,32892,7358,25534,25534,0,31,7211000.0
7211,7211999,20.521059628193896,37.605593636512104,0.08255657856732268,4785.643357992172,556.2475473880768,3868.4180421829224,32895,7359,25536,25536,0,31,7212000.0
7212,7212999,20.52342295435076,37.60945039224064,0.08262863263851805,4786.039297580719,556.321667432785,3870.2265520095825,32895,7359,25536,25536,0,31,7213000.0
7213,7213999,20.525762028735322,37.61266426255995,0.08267504844068507,4786.704682350159,556.3947303295135,3870.7517518997192,32899,7361,25538,25538,0,31,7214000.0
7214,7214999,20.528370959888424,37.61680605774385,0.0827312952215532,4787.22909116745,556.4618189334869,3871.817105293274,32901,7362,25539,25539,0,31,7215000.0
7215,7215999,20.53117977281542,37.62515058184129,0.0827845762047964,4787.683709621429,556.5318942070007,3873.3097887039185,32905,7364,25541,25541,0,31,7216000.0
7216,7216999,20.53344094996982,37.62810100729081,0.08285559039957657,4788.404607534409,556.5992987155914,3873.533116340637,32921,7366,25555,25555,0,31,7217000.0
7217,7217999,20.53616712289248,37.632820286326904,0.08293666748747464,4789.365128993988,556.674712896347,3872.7662782669067,32923,7367,25556,25556,0,31,7218000.0
7218,7218999,20.53866693068324,37.63571847197505,0.08300394581819437,4789.809862136841,556.7423632144928,3874.3453645706177,32927,7369,25558,25558,0,31,7219000.0
7219,7219999,20.541385084171747,37.63954065851924,0.08307721192605966,4790.294588804245,556.8119330406189,3875.48131275177,32927,7369,25558,25558,0,31,7220000.0
7220,7220999,20.543531328808818,37.641793170301746,0.083129124274258,4790.666286230087,556.8793787956238,3877.258946418762,32927,7369,25558,25558,0,31,7221000.0
7221,7221999,20.54406798875443,37.64206354926494,0.0831033575176705,4791.45325255394,556.9477400779724,3877.3798723220825,32988,7373,25615,25615,0,31,7222000.0
7222,7222999,20.543814252360914,37.64163019974287,0.08308378219520873,4791.862521648407,557.0151464939117,3878.9000902175903,32992,7374,25618,25618,0,31,7223000.0
7223,7223999,20.543481833561017,37.64088848653126,0.0830695891908042,4812.665832519531,557.0816421508789,3881.4157915115356,32992,7374,25618,25618,0,31,7224000.0
7224,7224999,20.543371562201138,37.64027295589741,0.08305642051963213,4813.406404256821,557.1502537727356,3881.492657661438,32996,7376,25620,25620,0,31,7225000.0
7225,7225999,20.543301350224688,37.63965598413949,0.0830410293152073,4813.821707487106,557.2183935642242,3883.1310625076294,32999,7377,25622,25622,0,31,7226000.0
7226,7226999,20.543467958055295,37.639611668758704,0.08302247921725148,4814.387008190155,557.2863392829895,3884.1882066726685,33005,7380,25625,25625,0,31,7227000.0
7227,7227999,20.543508260462776,37.6391569534473,0.08301162582824073,4814.918733358383,557.3541586399078,3885.394772529602,33011,7382,25629,25629,0,31,7228000.0
7228,7228999,20.543677539186348,37.6389047347641,0.08299710511844793,4815.690235137939,557.4243259429932,3885.429455757141,33017,7385,25632,25632,0,31,7229000.0
7229,7229999,20.544086313164026,37.63969012708132,0.08297976934807705,4816.109449863434,557.4933726787567,3887.0582551956177,33019,7386,25633,25633,0,31,7230000.0
7230,7230999,20.54437537678349,37.63930161215309,0.08297071116453303,4816.901244878769,557.563488483429,3886.919140815735,33022,7387,25635,25635,0,31,7231000.0
7231,7231999,20.544832535213008,37.63940396062962,0.08295899533802442,4817.794902801514,557.6358971595764,3886.276249885559,33024,7388,25636,25636,0,31,7232000.0
7232,7232999,20.545159478890504,37.639178906362055,0.08294825656816018,4818.50666975975,557.7039568424225,3886.345181465149,33026,7389,25637,25637,0,31,7233000.0
7233,7233999,20.545493253693085,37.638945800967996,0.0829364902312194,4818.932572364807,557.772093296051,3887.9330263137817,33029,7390,25639,25639,0,31,7234000.0
7234,7234999,20.545991273624885,37.639110853222704,0.08292849987155371,4819.554881811142,557.8432409763336,3888.6100511550903,33031,7391,25640,25640,0,31,7235000.0
7235,7235999,20.54623016711004,37.638505955684415,0.08292041142780737,4820.106470823288,557.9116516113281,3889.6757860183716,33031,7391,25640,25640,0,31,7236000.0
7236,7236999,20.546904824919118,37.638652576416646,0.08291454253487374,4820.806265592575,557.9840683937073,3889.9825563430786,33038,7394,25644,25644,0,31,7237000.0
7237,7237999,20.547220808759437,37.63804804191053,0.0829106845532076,4821.413211345673,558.056220293045,3890.5776414871216,33038,7394,25644,25644,0,31,7238000.0
7238,7238999,20.54739307215039,37.637227147923156,0.08291102861135957,4822.136675834656,558.1240894794464,3890.826672554016,33042,7396,25646,25646,0,31,7239000.0
7239,7239999,20.547326555419136,37.636560474304,0.08288867822153445,4822.796593904495,558.1938672065735,3891.415150642395,33068,7399,25669,25669,0,31,7240000.0
7240,7240999,20.54712522076198,37.63673544952823,0.08286931512722717,4823.260679483414,558.2628839015961,3892.960629463196,33078,7400,25678,25678,0,31,7241000.0
7241,7241999,20.546648129188345,37.63607365494523,0.08286252147855444,4823.790756940842,558.3323616981506,3894.03201007843,33080,7401,25679,25679,0,31,7242000.0
7242,7242999,20.546393815857964,37.635782290483554,0.08285186486091578,4824.400377750397,558.4027683734894,3894.651188850403,33091,7402,25689,25689,0,31,7243000.0
7243,7243999,20.54608441508864,37.635550129975314,0.08284333080943018,4824.9435086250305,558.4717574119568,3895.71284198761,33108,7404,25704,25704,0,31,7244000.0
7244,7244999,20.545824429620968,37.63483441692655,0.08284156841927426,4825.412814378738,558.5427165031433,3897.2072343826294,33110,7405,25705,25705,0,31,7245000.0
7245,7245999,20.54557460155458,37.634138172667996,0.08283705949606612,4825.849493741989,558.6147780418396,3898.838276863098,33116,7407,25709,25709,0,31,7246000.0
7246,7246999,20.54556403191607,37.63390044943696,0.082830473659807,4826.363273859024,558.6838529109955,3899.9914979934692,33119,7408,25711,25711,0,31,7247000.0
7247,7247999,20.545487773835777,37.633336389162004,0.08282456468539723,4826.85110449791,558.7538461685181,3901.1668825149536,33119,7408,25711,25711,0,31,7248000.0
7248,7248999,20.545775826947565,37.63355796654462,0.08282377290924126,4827.243478775024,558.8268268108368,3902.9732027053833,33120,7408,25712,25712,0,31,7249000.0
7249,7249999,20.54610232313379,37.63392293919361,0.08281993491047446,4827.989614486694,558.896918296814,3902.977849006653,33124,7410,25714,25714,0,31,7250000.0
7250,7250999,20.546541828390573,37.63559955166239,0.08281093890299096,4828.802685499191,558.9664809703827,3902.5448122024536,33127,7411,25716,25716,0,31,7251000.0
7251,7251999,20.546743433615294,37.635365603103075,0.0828127958585595,4829.456537485123,559.0375030040741,3902.9162645339966,33127,7411,25716,25716,0,31,7252000.0
7252,7252999,20.5472070777345,37.63535569169324,0.08282000189404914,4830.121669769287,559.1075160503387,3903.4146242141724,33129,7412,25717,25717,0,31,7253000.0
7253,7253999,20.5476096698839,37.63502417786495,0.08282556402923813,4830.409557342529,559.1751494407654,3905.5445833206177,33129,7412,25717,25717,0,31,7254000.0
7254,7254999,20.548292523140397,37.63538255747423,0.08283075599309475,4830.898362159729,559.2445895671844,3906.634404182434,33129,7412,25717,25717,0,31,7255000.0
7255,7255999,20.54888267365397,37.63538125465774,0.08283530890861679,4831.416415452957,559.312864780426,3907.7172594070435,33131,7413,25718,25718,0,31,7256000.0
7256,7256999,20.54973309872711,37.6361788849058,0.08283245320282162,4832.194014310837,559.3835597038269,3907.651036262512,33133,7414,25719,25719,0,31,7257000.0
7257,7257999,20.55048630152475,37.637047593781354,0.08283465297743031,4832.960308790207,559.4542598724365,3907.4414110183716,33133,7414,25719,25719,0,31,7258000.0
7258,7258999,20.55104366041005,37.638163568316244,0.08281472050954342,4833.1167867183685,559.5221681594849,3910.549962043762,33167,7414,25753,25753,0,31,7259000.0
7259,7259999,20.55132806168327,37.63935513025625,0.08281667642538959,4833.362196683884,559.5863223075867,3912.983555793762,33169,7414,25755,25755,0,31,7260000.0
7260,7260999,20.551275246437395,37.640105136070275,0.08281302313413474,4833.677104711533,559.6515688896179,3915.1826753616333,33176,7415,25761,25761,0,31,7261000.0
7261,7261999,20.551125458778948,37.63933314739479,0.08280632850847602,4834.3699333667755,559.7178454399109,3915.6196489334106,33192,7419,25773,25773,0,31,7262000.0
7262,7262999,20.551243908068123,37.639230838052924,0.08279868354344155,4834.975651025772,559.7838411331177,3916.4680681228638,33198,7421,25777,25777,0,31,7263000.0
7263,7263999,20.551254373510417,37.638647050920234,0.08279546307626351,4835.520580530167,559.8493411540985,3917.6298723220825,33202,7423,25779,25779,0,31,7264000.0
7264,7264999,20.551296477980248,37.63832559799374,0.08279533621532431,4836.229463815689,559.9156105518341,3917.7392320632935,33204,7424,25780,25780,0,31,7265000.0
7265,7265999,20.551254200768927,37.638254933057134,0.08278919943545504,4836.864157438278,559.9819386005402,3918.279210090637,33213,7426,25787,25787,0,31,7266000.0
7266,7266999,20.55163227539241,37.64049022017088,0.08277692899762146,4837.641149282455,560.0497741699219,3918.201298713684,33213,7426,25787,25787,0,31,7267000.0
7267,7267999,20.551968499838782,37.64052080460499,0.08277322489740457,4838.265280723572,560.116222858429,3918.7389421463013,33216,7427,25789,25789,0,31,7268000.0
7268,7268999,20.552390589558048,37.641069404571894,0.0827677629384338,4838.904810428619,560.1829996109009,3919.2659120559692,33220,7429,25791,25791,0,31,7269000.0
7269,7269999,20.552816895755594,37.641272064016036,0.0827686973699665,4839.388618707657,560.2493193149567,3920.3857316970825,33220,7429,25791,25791,0,31,7270000.0
7270,7270999,20.55348895144099,37.64165149513455,0.08277013209921757,4839.914110422134,560.31551861763,3921.251461982727,33222,7430,25792,25792,0,31,7271000.0
7271,7271999,20.554009462661988,37.64173675682982,0.08277901433699741,4840.7232093811035,560.3819782733917,3921.0454454421997,33226,7432,25794,25794,0,31,7272000.0
7272,7272999,20.554766389244914,37.64279613064873,0.0827920116555727,4841.023149013519,560.4484632015228,3923.1945009231567,33226,7432,25794,25794,0,31,7273000.0
7273,7273999,20.55597195871152,37.644431115642135,0.0828005049503675,4841.849773406982,560.5153625011444,3922.983494758606,33230,7434,25796,25796,0,31,7274000.0
7274,7274999,20.556910555858877,37.64548120561241,0.082801319894792,4842.545973300934,560.5829446315765,3923.308346748352,33232,7435,25797,25797,0,31,7275000.0
7275,7275999,20.557118229427175,37.64524969559164,0.08278606673706879,4843.111398935318,560.6495714187622,3924.8909120559692,33241,7436,25805,25805,0,31,7276000.0
7276,7276999,20.55756089748323,37.64719153396684,0.08275333928970185,4843.7712507247925,560.7192821502686,3926.4168977737427,33245,7437,25808,25808,0,31,7277000.0
7277,7277999,20.557653751473435,37.64727761052034,0.08273750104951794,4844.760236740112,560.7885105609894,3926.2533922195435,33249,7437,25812,25812,0,31,7278000.0
7278,7278999,20.557724029026684,37.64719846293626,0.08272748383100148,4845.886656999588,560.8601484298706,3925.8078813552856,33274,7440,25834,25834,0,31,7279000.0
7279,7279999,20.557961006049876,37.64741553596691,0.08271584005426047,4846.6163601875305,560.9314134120941,3927.217427253723,33275,7440,25835,25835,0,31,7280000.0
7280,7280999,20.558181471210467,37.64760948906323,0.0827083516486472,4847.638569355011,561.0017983913422,3927.310238838196,33278,7441,25837,25837,0,31,7281000.0
7281,7281999,20.558283204884322,37.6476752253939,0.08269977083902258,4848.766419410706,561.0747802257538,3926.7848329544067,33283,7443,25840,25840,0,31,7282000.0
7282,7282999,20.55842284770355,37.64768048272198,0.08270331319642577,4849.412164926529,561.1447899341583,3928.640133857727,33285,7444,25841,25841,0,31,7283000.0
7283,7283999,20.55913410110609,37.648929545564826,0.08269889642317829,4850.191513538361,561.2150852680206,3930.018292427063,33296,7445,25851,25851,0,31,7284000.0
7284,7284999,20.559780023206244,37.649986224230275,0.08270591638001012,4851.706849575043,561.2890167236328,3927.5866441726685,33301,7447,25854,25854,0,31,7285000.0
7285,7285999,20.560323010884844,37.65068680898265,0.08270890529851715,4852.697809457779,561.3603703975677,3927.6213884353638,33303,7448,25855,25855,0,31,7286000.0
7286,7286999,20.56117934622246,37.65191748548607,0.08271901952956096,4853.30451965332,561.4343340396881,3929.563801765442,33303,7448,25855,25855,0,31,7287000.0
7287,7287999,20.56214803409564,37.65298722844451,0.08274150655130541,4853.990795850754,561.5044157505035,3930.8851594924927,33318,7449,25869,25869,0,31,7288000.0
7288,7288999,20.56350605672887,37.654998781682536,0.08275263034748026,4854.503354310989,561.5755033493042,3933.511410713196,33318,7449,25869,25869,0,31,7289000.0
7289,7289999,20.56495544492067,37.65832521919701,0.08277349536716205,4855.3028774261475,561.6464099884033,3934.8243227005005,33320,7450,25870,25870,0,31,7290000.0
7290,7290999,20.56621553828443,37.659455587999624,0.08277726565288934,4856.39235496521,561.7176780700684,3934.3105363845825,33321,7450,25871,25871,0,31,7291000.0
7291,7291999,20.567617808689914,37.66115390827397,0.08281331061977659,4857.025687456131,561.7895243167877,3936.25426197052,33321,7450,25871,25871,0,31,7292000.0
7292,7292999,20.569050318046028,37.66262500026272,0.08282931039318442,4858.168618679047,561.8629012107849,3935.5815782546997,33324,7452,25872,25872,0,31,7293000.0
7293,7293999,20.569432533678356,37.66235067557036,0.0828413226725101,4858.779645442963,561.9347405433655,3937.6455507278442,33336,7452,25884,25884,0,31,7294000.0
7294,7294999,20.56922034937994,37.662147744913355,0.08282795948551014,4859.112307310104,562.0038135051727,3940.5210466384888,33342,7452,25890,25890,0,31,7295000.0
7295,7295999,20.569128706731835,37.662126777364655,0.08281599054496436,4859.671993970871,562.07501912117,3942.6062440872192,33345,7453,25892,25892,0,31,7296000.0
7296,7296999,20.568965068345037,37.661909846357496,0.08280457686365172,4860.373980283737,562.1458899974823,3944.116635322571,33348,7454,25894,25894,0,31,7297000.0
7297,7297999,20.568920142292008,37.66119162683663,0.0827924010994413,4861.559215545654,562.2154505252838,3943.19908618927,33356,7457,25899,25899,0,31,7298000.0
7298,7298999,20.56916443760576,37.661575609720735,0.08278566260991094,4862.424223423004,562.2846510410309,3944.0975999832153,33370,7459,25911,25911,0,31,7299000.0
7299,7299999,20.569226677237204,37.661142526092824,0.08277789043770312,4863.31444311142,562.3556907176971,3945.0683031082153,33384,7461,25923,25923,0,31,7300000.0
7300,7300999,20.569375123588475,37.66056130102762,0.08277476081896507,4864.482688426971,562.4269244670868,3944.6754655838013,33386,7462,25924,25924,0,31,7301000.0
7301,7301999,20.569711883667523,37.66045309261809,0.0827679082294892,4865.480875492096,562.4997792243958,3945.1516542434692,33389,7463,25926,25926,0,31,7302000.0
7302,7302999,20.570328852063863,37.66112970047578,0.0827609049339052,4866.618428707123,562.5713303089142,3945.26842212677,33393,7465,25928,25928,0,31,7303000.0
7303,7303999,20.57093845582331,37.66167993772275,0.08276108824595418,4867.548665523529,562.6436178684235,3945.965641975403,33395,7466,25929,25929,0,31,7304000.0
7304,7304999,20.571682794901264,37.66182511468122,0.08275888279034216,4868.674653053284,562.7154693603516,3945.826313972473,33397,7467,25930,25930,0,31,7305000.0
7305,7305999,20.57240533706239,37.66248459477155,0.08276030226123743,4869.618899106979,562.7856657505035,3946.5445528030396,33399,7468,25931,25931,0,31,7306000.0
7306,7306999,20.573193892987216,37.663054820351,0.0827578934027281,4870.456215143204,562.8579580783844,3947.8601121902466,33399,7468,25931,25931,0,31,7307000.0
7307,7307999,20.574103058676116,37.66376273935569,0.08275932468669156,4871.147394895554,562.9314053058624,3949.770260810852,33399,7468,25931,25931,0,31,7308000.0
7308,7308999,20.57535175163524,37.664809316572594,0.08277445241204529,4872.182598829269,563.003987789154,3950.0135774612427,33401,7469,25932,25932,0,31,7309000.0
7309,7309999,20.576357602745126,37.66531374364582,0.08278607767171609,4873.431120157242,563.0788216590881,3949.5851335525513,33403,7470,25933,25933,0,31,7310000.0
7310,7310999,20.577753287890985,37.66732630581636,0.0827946257257185,4874.855711221695,563.1513249874115,3947.957158088684,33405,7471,25934,25934,0,31,7311000.0
7311,7311999,20.57898737364999,37.668525210531804,0.08280839872769186,4875.671616077423,563.2245202064514,3949.2558336257935,33405,7471,25934,25934,0,31,7312000.0
7312,7312999,20.58070404252629,37.671250653540135,0.08282004883008487,4876.299096107483,563.2970104217529,3951.697880744934,33407,7472,25935,25935,0,31,7313000.0
7313,7313999,20.581822682730845,37.672275712601525,0.08283167867061403,4877.888241767883,563.3701903820038,3948.939763069153,33411,7474,25937,25937,0,31,7314000.0
7314,7314999,20.58182912826093,37.672271683648944,0.08280651932277161,4878.610903739929,563.4396057128906,3950.412533760071,33431,7477,25954,25954,0,31,7315000.0
7315,7315999,20.5813769565095,37.67144544866418,0.0827994362285972,4879.478564977646,563.5095961093903,3950.798321723938,33433,7477,25956,25956,0,31,7316000.0
7316,7316999,20.58097269043935,37.67088825313206,0.08278756360592021,4880.465108394623,563.5809683799744,3950.8957948684692,33437,7478,25959,25959,0,31,7317000.0
7317,7317999,20.580392403942778,37.66952400240562,0.08278196915331115,4881.422425985336,563.6540558338165,3951.112973213196,33441,7480,25961,25961,0,31,7318000.0
7318,7318999,20.58012441024967,37.66954461319566,0.0827707421066326,4882.170871973038,563.7240693569183,3952.4363145828247,33455,7481,25974,25974,0,31,7319000.0
7319,7319999,20.579901446526314,37.668691412981794,0.0827644377375587,4882.909144163132,563.7969698905945,3953.947445869446,33471,7484,25987,25987,0,31,7320000.0
7320,7320999,20.579427232496947,37.667627703732244,0.08276092850984196,4883.611161708832,563.8693981170654,3955.957661628723,33473,7485,25988,25988,0,31,7321000.0
7321,7321999,20.579163050990505,37.666795534109944,0.08275753585651557,4884.54416179657,563.9434204101562,3956.69575214386,33475,7486,25989,25989,0,31,7322000.0
7322,7322999,20.579174708856637,37.666474482643274,0.08276190465943478,4885.34267950058,564.0159430503845,3958.0741090774536,33475,7486,25989,25989,0,31,7323000.0
7323,7323999,20.57929719729045,37.66615830416015,0.08275715708000464,4886.023116350174,564.087569475174,3960.036946296692,33475,7486,25989,25989,0,31,7324000.0
7324,7324999,20.579593786074355,37.6671871001439,0.08275921403476783,4887.34187912941,564.1607351303101,3958.8879137039185,33479,7488,25991,25991,0,31,7325000.0
7325,7325999,20.579685180526557,37.66843891838306,0.08274265153285132,4888.470787525177,564.2327456474304,3958.2935457229614,33483,7490,25993,25993,0,31,7326000.0
7326,7326999,20.579913502066756,37.66815129906972,0.08274560476718251,4889.13579082489,564.306131362915,3960.2487382888794,33483,7490,25993,25993,0,31,7327000.0
7327,7327999,20.580350792055565,37.670263499792185,0.08273623889241255,4890.31707406044,564.3800196647644,3959.5895051956177,33487,7492,25995,25995,0,31,7328000.0
7328,7328999,20.580724462223664,37.670193220309685,0.08273835271132879,4891.295486688614,564.453916311264,3959.7814378738403,33494,7493,26001,26001,0,31,7329000.0
7329,7329999,20.58098307646589,37.66997412543623,0.08273952744142632,4892.072508573532,564.5289423465729,3961.0881547927856,33494,7493,26001,26001,0,31,7330000.0
7330,7330999,20.581578908646243,37.67127272363869,0.08273193903360865,4892.87815284729,564.6005482673645,3962.4950914382935,33494,7493,26001,26001,0,31,7331000.0
7331,7331999,20.582278501582326,37.67190998023887,0.08273177371658613,4894.127400159836,564.6754429340363,3961.872227668762,33498,7495,26003,26003,0,31,7332000.0
7332,7332999,20.582834784506467,37.6719743813877,0.08273253870922836,4895.3095626831055,564.7515468597412,3961.253415107727,33500,7496,26004,26004,0,31,7333000.0
7333,7333999,20.583389085912177,37.6718002220293,0.08273176443000174,4896.4738392829895,564.8241543769836,3960.700352668762,33514,7498,26016,26016,0,31,7334000.0
7334,7334999,20.583861451961074,37.67274951822783,0.08269574652732248,4897.442255020142,564.8947949409485,3960.9333238601685,33534,7499,26035,26035,0,31,7335000.0
7335,7335999,20.583362517827915,37.672217218786216,0.08267438449333109,4898.125369787216,564.9626288414001,3962.5335664749146,33539,7500,26039,26039,0,31,7336000.0
7336,7336999,20.58306694716408,37.673636834832266,0.08266018381648343,4899.04810667038,565.0302655696869,3963.1971254348755,33544,7501,26043,26043,0,31,7337000.0
7337,7337999,20.583007804477493,37.67501424673393,0.0826428064662823,4899.913434743881,565.0988342761993,3963.5718507766724,33549,7503,26046,26046,0,31,7338000.0
7338,7338999,20.5830356583188,37.67608653433511,0.08263409543762446,4900.725600481033,565.1680326461792,3964.7067766189575,33558,7504,26054,26054,0,31,7339000.0
7339,7339999,20.583346810229873,37.67833697858401,0.08261498819686841,4901.424679517746,565.2369270324707,3966.3963289260864,33558,7504,26054,26054,0,31,7340000.0
7340,7340999,20.58335399385848,37.67856156539106,0.08262268227967295,4902.553822278976,565.3080093860626,3965.9276399612427,33562,7506,26056,26056,0,31,7341000.0
7341,7341999,20.583379663103326,37.6789023747398,0.0826050713885692,4903.2412650585175,565.3782343864441,3967.8551301956177,33562,7506,26056,26056,0,31,7342000.0
7342,7342999,20.58347062061064,37.67952573752946,0.08259598680858904,4904.1252727508545,565.4520201683044,3969.193760871887,33566,7507,26059,26059,0,31,7343000.0
7343,7343999,20.583817327818746,37.68048032827937,0.08260404965665302,4905.5205228328705,565.5218803882599,3967.5646562576294,33572,7509,26063,26063,0,31,7344000.0
7344,7344999,20.584194503393526,37.68146371725107,0.08260234668943056,4906.17592215538,565.5940186977386,3969.4918031692505,33572,7509,26063,26063,0,31,7345000.0
7345,7345999,20.584767775272624,37.68285648453474,0.0825870454826646,4907.285475730896,565.6629958152771,3969.30455493927,33572,7509,26063,26063,0,31,7346000.0
7346,7346999,20.584862211177846,37.68267437028571,0.08258134384733729,4908.097754001617,565.7329452037811,3970.4805269241333,33576,7511,26065,26065,0,31,7347000.0
7347,7347999,20.585407402234058,37.683755588886434,0.0825898825793826,4908.896404981613,565.802384853363,3971.898518562317,33638,7512,26126,26126,0,31,7348000.0
7348,7348999,20.586075336385882,37.68496523440546,0.08257184772175807,4909.786740541458,565.8734614849091,3972.8621110916138,33638,7512,26126,26126,0,31,7349000.0
7349,7349999,20.586383534495884,37.68509481475889,0.08257129172893751,4910.695465564728,565.9445989131927,3973.826916694641,33639,7513,26126,26126,0,31,7350000.0
7350,7350999,20.587088498062037,37.68598906655622,0.08256725786100338,4912.168762683868,566.0149548053741,3971.8045167922974,33647,7517,26130,26130,0,31,7351000.0
7351,7351999,20.58781025144808,37.68653917487242,0.0825597120120295,4913.170902967453,566.0845367908478,3972.053418159485,33649,7518,26131,26131,0,31,7352000.0
7352,7352999,20.588467696896096,37.68713396367768,0.08256538236329714,4913.996778249741,566.1554646492004,3973.1143159866333,33663,7520,26143,26143,0,31,7353000.0
7353,7353999,20.589246344811915,37.68767196214747,0.08256003164091752,4914.646103620529,566.227664232254,3975.074131965637,33663,7520,26143,26143,0,31,7354000.0
7354,7354999,20.590209315302634,37.6887988305944,0.0825459280961034,4915.393962621689,566.2968699932098,3976.5844316482544,33670,7520,26150,26150,0,31,7355000.0
7355,7355999,20.589908164807657,37.688683304181716,0.08252937578677355,4916.285409212112,566.3660018444061,3976.9628953933716,33672,7521,26151,26151,0,31,7356000.0
7356,7356999,20.590077497313427,37.68951385616369,0.08250929791410011,4917.048484802246,566.4362287521362,3977.8526735305786,33673,7521,26152,26152,0,31,7357000.0
7357,7357999,20.59029373693561,37.68998984261408,0.08249349157701469,4917.865728378296,566.505980014801,3978.7305727005005,33678,7523,26155,26155,0,31,7358000.0
7358,7358999,20.59045443505764,37.690569954693075,0.08247635098879502,4918.460680961609,566.5765445232391,3980.6620988845825,33678,7523,26155,26155,0,31,7359000.0
7359,7359999,20.590415955830753,37.69039370166771,0.08246565174528431,4919.302385091782,566.6473422050476,3981.45348072052,33678,7523,26155,26155,0,31,7360000.0
7360,7360999,20.591309523205393,37.69573771212896,0.08242262998797278,4920.620721101761,566.7186114788055,3979.849278450012,33687,7525,26162,26162,0,31,7361000.0
7361,7361999,20.592135099244054,37.696809140691514,0.08240741620721193,4921.828384637833,566.7909343242645,3978.920491218567,33701,7527,26174,26174,0,31,7362000.0
7362,7362999,20.592964762994132,37.69806068763776,0.08239265514610206,4922.646565437317,566.8636250495911,3980.038456916809,33703,7529,26174,26174,0,31,7363000.0
7363,7363999,20.593940548726582,37.6987501696974,0.08238118086378354,4923.436136484146,566.9355828762054,3981.399067878723,33703,7529,26174,26174,0,31,7364000.0
7364,7364999,20.595177814042184,37.70080548741732,0.08237464567357955,4925.038780927658,567.007972240448,3978.891629219055,33715,7535,26180,26180,0,31,7365000.0
7365,7365999,20.596028853329486,37.70115472526604,0.08236817232505578,4925.81565284729,567.0822143554688,3980.163228034973,33717,7536,26181,26181,0,31,7366000.0
7366,7366999,20.597206662606123,37.70277721875932,0.08236638666231089,4926.944326639175,567.1552095413208,3979.665654182434,33717,7536,26181,26181,0,31,7367000.0
7367,7367999,20.59847859089787,37.70407807681398,0.08236996693741871,4927.67666888237,567.2262785434723,3980.976284980774,33735,7538,26197,26197,0,31,7368000.0
7368,7368999,20.59952487151048,37.704677675185415,0.08238363002770543,4928.1199333667755,567.298056602478,3983.8307161331177,33735,7538,26197,26197,0,31,7369000.0
7369,7369999,20.601139862549864,37.70690814002341,0.08240508173509975,4928.664374828339,567.3705689907074,3986.4506883621216,33735,7538,26197,26197,0,31,7370000.0
7370,7370999,20.602468561108065,37.707936757620566,0.08242398702394693,4929.554965734482,567.4423968791962,3987.1835832595825,33735,7538,26197,26197,0,31,7371000.0
7371,7371999,20.603428466989936,37.708388104070785,0.08244418306669044,4930.597655296326,567.5168604850769,3987.270421028137,33747,7539,26208,26208,0,31,7372000.0
7372,7372999,20.603851571623732,37.70871386594966,0.08243471702785354,4931.280277729034,567.5906207561493,3989.1965761184692,33762,7540,26222,26222,0,31,7373000.0
7373,7373999,20.60388008914573,37.71056428126872,0.08241350532135316,4932.1955490112305,567.6681091785431,3990.2056398391724,33776,7541,26235,26235,0,31,7374000.0
7374,7374999,20.603777184846972,37.7097714663382,0.08241251363597035,4932.928344011307,567.7458789348602,3991.3242692947388,33781,7543,26238,26238,0,31,7375000.0
7375,7375999,20.603766453430175,37.70953864243856,0.08240689688633485,4933.774233341217,567.8227002620697,3992.0771532058716,33783,7544,26239,26239,0,31,7376000.0
7376,7376999,20.603705948432168,37.7095232302316,0.08240887626259663,4934.527620792389,567.9013209342957,3993.4515199661255,33785,7545,26240,26240,0,31,7377000.0
7377,7377999,20.60411627829786,37.71123828359324,0.08239685347264447,4935.4783890247345,567.9807481765747,3994.0233812332153,33787,7546,26241,26241,0,31,7378000.0
7378,7378999,20.604398528771323,37.71133874392136,0.0823989360401357,4936.662187099457,568.0607347488403,3993.1891145706177,33789,7547,26242,26242,0,31,7379000.0
7379,7379999,20.60490754756497,37.71173153844633,0.08239175315757163,4937.459698915482,568.1396815776825,3994.5727891921997,33791,7548,26243,26243,0,31,7380000.0
7380,7380999,20.605332388671457,37.71200108607471,0.08239758391282515,4938.474929094315,568.2188329696655,3994.6148500442505,33793,7549,26244,26244,0,31,7381000.0
7381,7381999,20.606174234178177,37.714149524644306,0.08239501804465355,4939.561347723007,568.3003859519958,3994.623661994934,33799,7552,26247,26247,0,31,7382000.0
7382,7382999,20.606684240254197,37.71439421557081,0.08240025117648775,4940.859425783157,568.3829426765442,3993.958737373352,33804,7554,26250,26250,0,31,7383000.0
7383,7383999,20.607222271029947,37.71651813286984,0.08239248630478702,4941.802960634232,568.4656369686127,3994.3971223831177,33807,7556,26251,26251,0,31,7384000.0
7384,7384999,20.60791822922327,37.7168581174354,0.0823894001841885,4942.459480047226,568.5468213558197,3996.3500032424927,33807,7556,26251,26251,0,31,7385000.0
7385,7385999,20.608699155403833,37.71724583735481,0.08238491059804409,4943.475947141647,568.6285307407379,3996.4048280715942,33807,7556,26251,26251,0,31,7386000.0
7386,7386999,20.6093174869203,37.71731902042143,0.08238112038575274,4944.434625148773,568.7085123062134,3996.6321229934692,33809,7557,26252,26252,0,31,7387000.0
7387,7387999,20.610230039993166,37.717725952245004,0.08237512127919444,4945.239179611206,568.7925870418549,3997.925503730774,33809,7557,26252,26252,0,31,7388000.0
7388,7388999,20.61100259088906,37.71974127079721,0.08236815388058927,4946.384291648865,568.8731775283813,3997.453351020813,33809,7557,26252,26252,0,31,7389000.0
7389,7389999,20.611891545717118,37.72018144055484,0.08237135193910905,4947.167371511459,568.9559876918793,3998.7587175369263,33823,7558,26265,26265,0,31,7390000.0
7390,7390999,20.612648142046645,37.72018081774165,0.08237667296857021,4947.80283164978,569.0382487773895,4000.742558479309,33825,7559,26266,26266,0,31,7391000.0
7391,7391999,20.61292635005256,37.720983594659366,0.0823680547119876,4948.113446474075,569.1095819473267,4004.207501411438,33845,7559,26286,26286,0,31,7392000.0
7392,7392999,20.6125281766709,37.7211314685345,0.08235936478626005,4948.452212095261,569.1749219894409,4007.0244340896606,33848,7559,26289,26289,0,31,7393000.0
7393,7393999,20.611875777523537,37.72000914474502,0.08235622471950299,4948.978932380676,569.2397997379303,4009.17524433136,33848,7559,26289,26289,0,31,7394000.0
7394,7394999,20.61139593148814,37.719968530205065,0.08235176077267681,4950.429082632065,569.307207107544,4007.1777391433716,33880,7565,26315,26315,0,31,7395000.0
7395,7395999,20.61120335519297,37.71992368733071,0.08234348168146954,4951.032716035843,569.3735735416412,4009.2195558547974,33880,7565,26315,26315,0,31,7396000.0
7396,7396999,20.610908834480206,37.719219753980965,0.0823379997257,4952.095964431763,569.4448816776276,4009.5810441970825,33884,7567,26317,26317,0,31,7397000.0
7397,7397999,20.61065416190639,37.7181747877789,0.08233748754558334,4952.939349651337,569.5114886760712,4010.4831590652466,33886,7568,26318,26318,0,31,7398000.0
7398,7398999,20.61043698234258,37.71731090155292,0.08233634773152676,4953.917744874954,569.5788547992706,4010.909848213196,33890,7570,26320,26320,0,31,7399000.0
7399,7399999,20.61037324889188,37.716883236230686,0.0823298201819751,4954.896396160126,569.6475191116333,4011.2702989578247,33890,7570,26320,26320,0,31,7400000.0
7400,7400999,20.610577351607215,37.71712576360192,0.08232408648753453,4955.351162672043,569.7158622741699,4014.4333696365356,33890,7570,26320,26320,0,31,7401000.0
7401,7401999,20.61092921393315,37.71768695416837,0.0823213037806596,4956.819135427475,569.7859494686127,4012.2791109085083,33892,7571,26321,26321,0,31,7402000.0
7402,7402999,20.611238138930375,37.71816599479869,0.08233340531655953,4957.960953474045,569.8571448326111,4011.645215034485,33898,7574,26324,26324,0,31,7403000.0
7403,7403999,20.611300355597475,37.718011896931905,0.08234152060228783,4958.768473625183,569.9246225357056,4012.922261238098,33902,7576,26326,26326,0,31,7404000.0
7404,7404999,20.61190859217744,37.71968263349893,0.08235504965429508,4959.376093387604,569.9941956996918,4015.1218156814575,33904,7577,26327,26327,0,31,7405000.0
7405,7405999,20.61274157238528,37.7217706820804,0.08235362103023836,4960.4368278980255,570.0641932487488,4015.122700691223,33908,7579,26329,26329,0,31,7406000.0
7406,7406999,20.613611559042855,37.724606334484676,0.08238883659585061,4961.321326971054,570.1329030990601,4016.414532661438,33970,7580,26390,26390,0,31,7407000.0
7407,7407999,20.61476533819307,37.726853333104714,0.08241570822122002,4962.626796960831,570.203366279602,4015.219449043274,33972,7581,26391,26391,0,31,7408000.0
7408,7408999,20.616429152167715,37.7332597542453,0.08240354826868468,4963.60363650322,570.2721965312958,4015.5190324783325,33974,7582,26392,26392,0,31,7409000.0
7409,7409999,20.617439454054644,37.735260267774706,0.08240474814120635,4964.243573665619,570.3387291431427,4017.466191291809,33986,7583,26403,26403,0,31,7410000.0
7410,7410999,20.617993203985744,37.73609286329754,0.082402662942205,4965.422555446625,570.4093465805054,4016.6064348220825,33988,7584,26404,26404,0,31,7411000.0
7411,7411999,20.618014716917752,37.73741017676621,0.08238165795243979,4966.117643356323,570.4792387485504,4018.1561098098755,34003,7586,26417,26417,0,31,7412000.0
7412,7412999,20.617330735735553,37.7361511367304,0.08237801068650386,4967.001100540161,570.5477921962738,4018.524235725403,34004,7586,26418,26418,0,31,7413000.0
7413,7413999,20.616672780227013,37.735140931932484,0.08237547358621145,4967.893025159836,570.6190028190613,4018.9438905715942,34021,7588,26433,26433,0,31,7414000.0
7414,7414999,20.61614118953863,37.73418669930778,0.08236997238397681,4968.403782129288,570.6887466907501,4021.139859199524,34021,7588,26433,26433,0,31,7415000.0
7415,7415999,20.615827188561745,37.734776184587716,0.0823597996788098,4969.099410057068,570.7589492797852,4023.0242738723755,34024,7589,26435,26435,0,31,7416000.0
7416,7416999,20.615513547711465,37.73385178805318,0.08235451355193579,4970.007949113846,570.8290112018585,4023.724789619446,34028,7591,26437,26437,0,31,7417000.0
7417,7417999,20.6153155911123,37.73318167914645,0.08235660155362212,4970.651262760162,570.9001276493073,4025.696789741516,34030,7592,26438,26438,0,31,7418000.0
7418,7418999,20.615037980801866,37.73235305222078,0.08235784293263726,4971.437733411789,570.9717690944672,4027.058835029602,34030,7592,26438,26438,0,31,7419000.0
7419,7419999,20.61481509552953,37.73148914476546,0.08236591594696707,4972.582980632782,571.0458459854126,4026.7422761917114,34030,7592,26438,26438,0,31,7420000.0
7420,7420999,20.61496319557975,37.73152117423313,0.08235922001782747,4973.891910076141,571.1180589199066,4025.4802598953247,34034,7594,26440,26440,0,31,7421000.0
7421,7421999,20.61486780198367,37.73089963538655,0.08235715205061134,4974.89537024498,571.1897568702698,4025.626965522766,34036,7595,26441,26441,0,31,7422000.0
7422,7422999,20.615154116446735,37.73107801973279,0.08235184002717943,4975.663987636566,571.2595252990723,4026.931576728821,34038,7596,26442,26442,0,31,7423000.0
7423,7423999,20.615579541901617,37.73305651676184,0.08235430530782717,4976.766504526138,571.3308341503143,4026.618100166321,34040,7597,26443,26443,0,31,7424000.0
7424,7424999,20.616114904503984,37.73339091602001,0.0823595393728318,4977.404146909714,571.4035499095917,4028.5867433547974,34040,7597,26443,26443,0,31,7425000.0
7425,7425999,20.616360864961923,37.73338448342803,0.0823646238824095,4978.453808307648,571.4778966903687,4028.562108039856,34040,7597,26443,26443,0,31,7426000.0
7426,7426999,20.61716551295359,37.73433691992102,0.08236875693020762,4979.251340866089,571.5504767894745,4029.802357673645,34042,7598,26444,26444,0,31,7427000.0
7427,7427999,20.617516173393366,37.73429789660395,0.08237917523272131,4980.306435823441,571.6228067874908,4029.8279237747192,34044,7599,26445,26445,0,31,7428000.0
7428,7428999,20.617918214844963,37.73519479694309,0.08238153291535233,4981.2793180942535,571.693531036377,4030.290066719055,34050,7602,26448,26448,0,31,7429000.0
7429,7429999,20.61815147530632,37.73501359045461,0.08238265431536262,4982.368992328644,571.7673425674438,4030.4506120681763,34054,7604,26450,26450,0,31,7430000.0
7430,7430999,20.61799508783065,37.7347993473697,0.08237062818830942,4982.7744262218475,571.8369514942169,4033.3376512527466,34074,7604,26470,26470,0,31,7431000.0
7431,7431999,20.616969798126632,37.732868829379086,0.08237638177189532,4983.497148990631,571.9068336486816,4034.368565559387,34077,7605,26472,26472,0,31,7432000.0
7432,7432999,20.616279950506193,37.73343098384091,0.08236617043859085,4983.9164083004,571.974002122879,4037.0913667678833,34079,7605,26474,26474,0,31,7433000.0
7433,7433999,20.61555112489233,37.732436662699776,0.08236455068939552,4984.941825866699,572.0436425209045,4037.3119020462036,34090,7608,26482,26482,0,31,7434000.0
7434,7434999,20.615028691640227,37.73154515110108,0.08236023513656088,4986.107760667801,572.113950252533,4036.934681892395,34114,7613,26501,26501,0,31,7435000.0
7435,7435999,20.614418224660614,37.730133133549245,0.0823613085293251,4986.945160150528,572.1841523647308,4038.1635637283325,34114,7613,26501,26501,0,31,7436000.0
7436,7436999,20.613642931062895,37.7286359130586,0.08236277094407674,4987.613347053528,572.2552664279938,4040.1947832107544,34114,7613,26501,26501,0,31,7437000.0
7437,7437999,20.613061012654956,37.727463512204224,0.0823633777566406,4989.03386592865,572.3264100551605,4038.803822517395,34118,7615,26503,26503,0,31,7438000.0
7438,7438999,20.6124748244545,37.726336346647535,0.08236637542825476,4989.974585056305,572.3965578079224,4039.6039094924927,34120,7616,26504,26504,0,31,7439000.0
7439,7439999,20.61191943156958,37.725380553919194,0.08236831136081257,4991.001955747604,572.4674100875854,4039.993000984192,34127,7618,26509,26509,0,31,7440000.0
7440,7440999,20.611104332329088,37.72368195771102,0.08237888919017011,4991.994487047195,572.5411832332611,4040.4441118240356,34129,7619,26510,26510,0,31,7441000.0
7441,7441999,20.610514403300485,37.72240432240689,0.08238252917458488,4993.111399173737,572.6131825447083,4040.2705278396606,34133,7621,26512,26512,0,31,7442000.0
7442,7442999,20.609952998033943,37.72138380273388,0.08238569130163154,4994.144140720367,572.6864111423492,4040.3548707962036,34133,7621,26512,26512,0,31,7443000.0
7443,7443999,20.609233915720225,37.71983142125357,0.08239220118289503,4995.054700136185,572.7591552734375,4040.9742708206177,34135,7622,26513,26513,0,31,7444000.0
7444,7444999,20.60857761150578,37.71837031473243,0.08239711266087524,4995.982234954834,572.8317270278931,4041.510640144348,34137,7623,26514,26514,0,31,7445000.0
7445,7445999,20.60787291555562,37.7168036299511,0.08239940799393997,4996.8277180194855,572.902503490448,4042.7577333450317,34139,7624,26515,26515,0,31,7446000.0
7446,7446999,20.607340514270476,37.71544090447089,0.08240331733119644,4998.031183242798,572.9735078811646,4041.9769563674927,34141,7625,26516,26516,0,31,7447000.0
7447,7447999,20.606601050544185,37.71381615177788,0.08240557914809665,4998.843987703323,573.0456414222717,4043.2743577957153,34143,7626,26517,26517,0,31,7448000.0
7448,7448999,20.605868018752826,37.71237031628336,0.08240902604922384,4999.720991611481,573.1176583766937,4043.9230165481567,34158,7627,26531,26531,0,31,7449000.0
7449,7449999,20.605223492789243,37.71140288984164,0.08240666572600264,5000.494307518005,573.1885623931885,4045.2587175369263,34169,7629,26540,26540,0,31,7450000.0
7450,7450999,20.604535309418157,37.70992145169353,0.08240512030708003,5001.473127126694,573.2581028938293,4045.1175508499146,34175,7631,26544,26544,0,31,7451000.0
7451,7451999,20.60405616280672,37.70878530903556,0.08239706773090505,5002.008248567581,573.3277552127838,4047.120297431946,34176,7631,26545,26545,0,31,7452000.0
7452,7452999,20.60356152529436,37.70781594709424,0.08238878167140318,5002.956985235214,573.3988037109375,4047.372715950012,34181,7633,26548,26548,0,31,7453000.0
7453,7453999,20.60299718161861,37.706548817284194,0.08238368960115716,5003.702560663223,573.4687774181366,4048.6805849075317,34196,7634,26562,26562,0,31,7454000.0
7454,7454999,20.602620514985112,37.70563588480439,0.08238143544382615,5004.360695838928,573.5404515266418,4050.2174882888794,34199,7635,26564,26564,0,31,7455000.0
7455,7455999,20.60219337876634,37.704367421657885,0.0823797225445535,5004.998640537262,573.616857290268,4052.2238359451294,34201,7636,26565,26565,0,31,7456000.0
7456,7456999,20.601830950024254,37.703579047180696,0.0823772122777997,5005.885671138763,573.6890218257904,4052.927067756653,34203,7637,26566,26566,0,31,7457000.0
7457,7457999,20.60153699867001,37.70359849923516,0.08236946899222664,5006.6636254787445,573.7613914012909,4054.227063179016,34205,7638,26567,26567,0,31,7458000.0
7458,7458999,20.601330385112245,37.703273025814184,0.0823755132160755,5007.807820796967,573.8352148532867,4053.7780351638794,34209,7640,26569,26569,0,31,7459000.0
7459,7459999,20.60093137154328,37.70217902302068,0.0823752429789607,5008.613687992096,573.9070875644684,4055.009259223938,34211,7641,26570,26570,0,31,7460000.0
7460,7460999,20.600671670224486,37.70148630365485,0.08237749747711942,5009.590982437134,573.9791731834412,4055.124119758606,34211,7641,26570,26570,0,31,7461000.0
7461,7461999,20.600352850420663,37.700591761743595,0.08237294171849208,5010.414080858231,574.0509514808655,4056.392590522766,34213,7642,26571,26571,0,31,7462000.0
7462,7462999,20.600159091176053,37.70001064670652,0.08237836599393467,5011.331159830093,574.12220287323,4057.0641298294067,34215,7643,26572,26572,0,31,7463000.0
7463,7463999,20.600121537027636,37.69945875890799,0.08238401762156178,5012.712083339691,574.1965277194977,4055.1763124465942,34219,7645,26574,26574,0,31,7464000.0
7464,7464999,20.59998989258185,37.69895711361687,0.08238410274238561,5013.363400697708,574.2675538063049,4057.1207094192505,34219,7645,26574,26574,0,31,7465000.0
7465,7465999,20.600278825197,37.698906187615215,0.08237964759766692,5014.4733917713165,574.3414387702942,4056.8485078811646,34220,7645,26575,26575,0,31,7466000.0
7466,7466999,20.600778162711915,37.700121984912386,0.08236953989694784,5015.770557403564,574.4164884090424,4055.5612077713013,34226,7648,26578,26578,0,31,7467000.0
7467,7467999,20.601019322851663,37.69999369697439,0.0823653019259295,5016.407694101334,574.4889817237854,4057.4796571731567,34226,7648,26578,26578,0,31,7468000.0
7468,7468999,20.600943979997414,37.69922713837465,0.08236420249432941,5017.443081617355,574.5651652812958,4057.5343141555786,34226,7648,26578,26578,0,31,7469000.0
7469,7469999,20.600807508942232,37.698303198529075,0.08235520682748032,5018.054023504257,574.6349401473999,4059.720311164856,34244,7649,26595,26595,0,31,7470000.0
7470,7470999,20.600330732377554,37.69939863245226,0.0823449656329408,5018.7647540569305,574.7041146755219,4060.7588472366333,34248,7650,26598,26598,0,31,7471000.0
7471,7471999,20.59952951194832,37.69820933316191,0.08234667977820465,5019.3859803676605,574.771826505661,4062.5538606643677,34250,7651,26599,26599,0,31,7472000.0
7472,7472999,20.59897488581424,37.69706609903453,0.08234691824351748,5019.932070493698,574.839203119278,4064.9115495681763,34251,7651,26600,26600,0,31,7473000.0
7473,7473999,20.598667059470742,37.69720594589519,0.08234474405981784,5021.12924861908,574.9097664356232,4064.248745918274,34258,7652,26606,26606,0,31,7474000.0
7474,7474999,20.598233683392046,37.696071740251504,0.08234691760762913,5021.678864002228,574.9784078598022,4066.7020540237427,34260,7653,26607,26607,0,31,7475000.0
7475,7475999,20.59787728093859,37.69551534573285,0.0823455515247058,5023.306903362274,575.0506694316864,4063.761082649231,34275,7657,26618,26618,0,31,7476000.0
7476,7476999,20.59770666528329,37.694898487984034,0.08234492602235699,5023.93944311142,575.1184804439545,4065.6295137405396,34275,7657,26618,26618,0,31,7477000.0
7477,7477999,20.597912666687623,37.695551204328446,0.08234329885561609,5024.703826189041,575.1911313533783,4067.1277284622192,34275,7657,26618,26618,0,31,7478000.0
7478,7478999,20.59797773569928,37.69540500073388,0.08234504879474114,5025.4191653728485,575.2614333629608,4069.0761003494263,34275,7657,26618,26618,0,31,7479000.0
7479,7479999,20.598265206180578,37.69554089469957,0.08235099035415705,5026.667361021042,575.33416223526,4068.6016969680786,34291,7661,26630,26630,0,31,7480000.0
7480,7480999,20.59846202583961,37.69570158373441,0.08235541651710132,5027.962908506393,575.4032340049744,4067.5325288772583,34295,7663,26632,26632,0,31,7481000.0
7481,7481999,20.598568138015327,37.695500633780995,0.08235926882755273,5029.142189502716,575.4739906787872,4067.0071306228638,34297,7664,26633,26633,0,31,7482000.0
7482,7482999,20.598685721521132,37.69551344253638,0.08235847894484527,5030.128797292709,575.5453507900238,4067.160397529602,34297,7664,26633,26633,0,31,7483000.0
7483,7483999,20.598797305670143,37.69516668646444,0.08236384184930223,5031.018008470535,575.6187903881073,4068.127034187317,34297,7664,26633,26633,0,31,7484000.0
7484,7484999,20.598966587948002,37.69499218595155,0.08236995166913463,5031.736439466476,575.6896016597748,4069.99880695343,34299,7665,26634,26634,0,31,7485000.0
7485,7485999,20.598931724281254,37.69431532169633,0.08237188545935259,5032.428195714951,575.7597525119781,4071.875630378723,34315,7666,26649,26649,0,31,7486000.0
7486,7486999,20.59924505054227,37.69436018324564,0.08236821995347687,5033.24574303627,575.831139087677,4073.22301197052,34317,7667,26650,26650,0,31,7487000.0
7487,7487999,20.599167715635375,37.69347189434822,0.08236500435189398,5034.513033390045,575.9053370952606,4072.2534227371216,34322,7668,26654,26654,0,31,7488000.0
7488,7488999,20.598949096019805,37.69253469598657,0.08236098136916714,5035.42262840271,575.9780929088593,4073.215886116028,34324,7669,26655,26655,0,31,7489000.0
7489,7489999,20.598567855013776,37.69138173796365,0.08236154848798893,5036.216109514236,576.0472133159637,4074.231213569641,34331,7670,26661,26661,0,31,7490000.0
7490,7490999,20.597643584163645,37.689706126734265,0.08237075729058418,5036.953971862793,576.1151721477509,4075.227551460266,34333,7670,26663,26663,0,31,7491000.0
7491,7491999,20.59676887376138,37.687937610479025,0.08238128732243055,5037.692080259323,576.1827509403229,4076.5670824050903,34335,7671,26664,26664,0,31,7492000.0
7492,7492999,20.595996778740044,37.68677108795122,0.08238677316025356,5038.39212679863,576.2507121562958,4077.9207735061646,34335,7671,26664,26664,0,31,7493000.0
7493,7493999,20.595075899098227,37.68509700560344,0.08239595671664135,5039.24383854866,576.3326017856598,4078.707600593567,34357,7674,26683,26683,0,31,7494000.0
7494,7494999,20.594185839596257,37.683609315491616,0.08240071489696843,5039.5625557899475,576.4029836654663,4082.0503129959106,34359,7674,26685,26685,0,31,7495000.0
7495,7495999,20.593082330214532,37.681724095418815,0.08241370239950097,5040.302211284637,576.4738235473633,4083.4731645584106,34359,7674,26685,26685,0,31,7496000.0
7496,7496999,20.59211564425831,37.68000476322922,0.08242533717144762,5041.031365633011,576.5439274311066,4084.805577278137,34362,7675,26687,26687,0,31,7497000.0
7497,7497999,20.591173208365557,37.67848457041945,0.08243618365057925,5042.05388879776,576.6152296066284,4084.870244026184,34364,7676,26688,26688,0,31,7498000.0
7498,7498999,20.590158960195524,37.67668702521405,0.08244904427642885,5042.901382923126,576.6855776309967,4085.6111574172974,34364,7676,26688,26688,0,31,7499000.0
7499,7499999,20.589269085184988,37.67504652231924,0.08246159640608863,5043.872868299484,576.7581517696381,4085.888150215149,34366,7677,26689,26689,0,31,7500000.0
7500,7500999,20.588227844716215,37.67339627177841,0.0824762232327848,5044.620464086533,576.8290810585022,4087.4010820388794,34366,7677,26689,26689,0,31,7501000.0
7501,7501999,20.58745550917307,37.67204459315521,0.0824894638207112,5045.745009899139,576.9032714366913,4086.83083820343,34366,7677,26689,26689,0,31,7502000.0
7502,7502999,20.586675670386196,37.67124100284762,0.08250473017839499,5046.737270832062,576.9780609607697,4086.873158454895,34366,7677,26689,26689,0,31,7503000.0
7503,7503999,20.585984208603602,37.670762799201775,0.08251480516148213,5047.348500967026,577.050656080246,4088.7659425735474,34366,7677,26689,26689,0,31,7504000.0
7504,7504999,20.585035339643927,37.66897507826723,0.08253121290971766,5048.663750886917,577.1225681304932,4087.003514289856,34366,7677,26689,26689,0,31,7505000.0
7505,7505999,20.584285700258448,37.66807247166381,0.08253904804755074,5049.022387504578,577.1941378116608,4090.2881898880005,34374,7677,26697,26697,0,31,7506000.0
7506,7506999,20.5837204524431,37.66792484054891,0.08253743123861645,5049.424672842026,577.269847869873,4093.010754585266,34379,7678,26701,26701,0,31,7507000.0
7507,7507999,20.582883239254297,37.66630543137918,0.08254725018168063,5050.0974287986755,577.3480241298676,4094.56773853302,34397,7680,26717,26717,0,31,7508000.0
7508,7508999,20.58209829725251,37.66498578656552,0.08255540534396366,5050.747591257095,577.424642086029,4096.2993059158325,34399,7681,26718,26718,0,31,7509000.0
7509,7509999,20.58129377813249,37.66369871847406,0.08256404924578353,5051.696648359299,577.5033311843872,4096.551930427551,34404,7683,26721,26721,0,31,7510000.0
7510,7510999,20.58046723531916,37.66213069150963,0.08256611226658161,5052.643109798431,577.5827496051788,4097.007687568665,34408,7685,26723,26723,0,31,7511000.0
7511,7511999,20.579518617543044,37.66035775432993,0.08257040472867261,5053.4764087200165,577.6666021347046,4098.192097663879,34410,7686,26724,26724,0,31,7512000.0
7512,7512999,20.57882887649715,37.65913088908996,0.08256972161230447,5054.15124797821,577.7464680671692,4100.1750383377075,34414,7688,26726,26726,0,31,7513000.0
7513,7513999,20.578352477727353,37.65841554514595,0.08256451455485714,5054.81534075737,577.8289642333984,4102.226559638977,34415,7688,26727,26727,0,31,7514000.0
7514,7514999,20.577724523671392,37.657189381592964,0.08256001731611129,5055.861091136932,577.9088313579559,4102.307950019836,34417,7689,26728,26728,0,31,7515000.0
7515,7515999,20.577227230751706,37.656110648605484,0.08255653588845113,5056.794123649597,577.9913463592529,4103.069172859192,34419,7690,26729,26729,0,31,7516000.0
7516,7516999,20.57664825542326,37.65499105733403,0.08255132553188371,5058.062495470047,578.0731854438782,4101.987805366516,34421,7691,26730,26730,0,31,7517000.0
7517,7517999,20.576291993989273,37.65398747838201,0.08254754238656115,5059.09015417099,578.1561172008514,4102.133206367493,34423,7692,26731,26731,0,31,7518000.0
7518,7518999,20.575859567066498,37.65289097850992,0.08254309496257617,5059.864934206009,578.2399396896362,4103.7368516922,34423,7692,26731,26731,0,31,7519000.0
7519,7519999,20.57568900923354,37.65293874458325,0.08253423201905519,5060.8384873867035,578.3207986354828,4104.421383857727,34423,7692,26731,26731,0,31,7520000.0
7520,7520999,20.575500433980267,37.6521189122873,0.08252554501676401,5061.83075428009,578.405793428421,4105.058835029602,34427,7694,26733,26733,0,31,7521000.0
7521,7521999,20.575109315607545,37.65115191206216,0.08251973242604027,5062.934369802475,578.4905281066895,4105.011311531067,34429,7695,26734,26734,0,31,7522000.0
7522,7522999,20.574801446649467,37.64991463427871,0.08251430804598459,5063.992693662643,578.5733327865601,4105.270565986633,34431,7696,26735,26735,0,31,7523000.0
7523,7523999,20.574348295237805,37.6485689105704,0.08251103844557672,5065.0529618263245,578.6581754684448,4105.330723762512,34431,7696,26735,26735,0,31,7524000.0
7524,7524999,20.574005366772973,37.64825885447293,0.08249106663565242,5065.846901655197,578.7281594276428,4106.47472858429,34468,7699,26769,26769,0,31,7525000.0
7525,7525999,20.57331079634325,37.64741034287436,0.08249037234752932,5066.380168676376,578.795432806015,4108.7285051345825,34472,7700,26772,26772,0,31,7526000.0
7526,7526999,20.572632243045916,37.64650379672105,0.0824905338141011,5067.345217466354,578.8641686439514,4109.047818183899,34477,7702,26775,26775,0,31,7527000.0
7527,7527999,20.571859525657523,37.64493945403203,0.08249369009889995,5067.839907169342,578.9317669868469,4111.746289253235,34479,7702,26777,26777,0,31,7528000.0
7528,7528999,20.571317245990304,37.643811739689326,0.08249602165836545,5068.500214338303,578.9992802143097,4113.823468208313,34481,7703,26778,26778,0,31,7529000.0
7529,7529999,20.570829145290304,37.64262562684832,0.08249192611111678,5069.908843278885,579.0682027339935,4112.326573371887,34489,7707,26782,26782,0,31,7530000.0
7530,7530999,20.570033178847034,37.64094522406411,0.08249242181470007,5092.254063129425,579.1438529491425,4113.645398139954,34491,7708,26783,26783,0,31,7531000.0
7531,7531999,20.569481748049853,37.639640585932376,0.0824905820384253,5093.175131082535,579.2130181789398,4114.394696235657,34505,7710,26795,26795,0,31,7532000.0
7532,7532999,20.56879615589953,37.63821064088632,0.08249087086304852,5094.075610876083,579.2816112041473,4115.12079334259,34505,7710,26795,26795,0,31,7533000.0
7533,7533999,20.56834157457725,37.637025979488484,0.08248757149766106,5095.310446977615,579.3518114089966,4114.527180671692,34511,7713,26798,26798,0,31,7534000.0
7534,7534999,20.56782736414639,37.63592248757207,0.08248248138126835,5095.966642618179,579.4200885295868,4116.517354011536,34512,7713,26799,26799,0,31,7535000.0
7535,7535999,20.567409683461403,37.634979069993605,0.0824813596411389,5097.063411951065,579.4907491207123,4116.353840827942,34512,7713,26799,26799,0,31,7536000.0
7536,7536999,20.567275838498883,37.635795472416014,0.08246890378143712,5097.963621377945,579.5624146461487,4117.08556842804,34514,7714,26800,26800,0,31,7537000.0
7537,7537999,20.567219483975133,37.63553270267922,0.08245962962538822,5098.882237911224,579.6333498954773,4117.722249031067,34516,7715,26801,26801,0,31,7538000.0
7538,7538999,20.567203401451223,37.63481295897252,0.0824505963862372,5100.044812440872,579.703937292099,4117.213063240051,34528,7716,26812,26812,0,31,7539000.0
7539,7539999,20.56724426539676,37.63429439449999,0.08244508019741792,5100.9381737709045,579.7732739448547,4118.050839424133,34530,7717,26813,26813,0,31,7540000.0
7540,7540999,20.56746606317534,37.6341342380681,0.0824409449455068,5102.0532195568085,579.8422787189484,4117.685971260071,34539,7720,26819,26819,0,31,7541000.0
7541,7541999,20.567344990980928,37.63348376494987,0.0824420779606655,5102.9669687747955,579.9101414680481,4118.23407459259,34543,7722,26821,26821,0,31,7542000.0
7542,7542999,20.56701828745492,37.63244879788168,0.08244459516421987,5103.888014554977,579.9784004688263,4118.9487199783325,34543,7722,26821,26821,0,31,7543000.0
7543,7543999,20.566576956240322,37.631295703947416,0.08243967585929346,5104.7323977947235,580.0486490726471,4119.886517524719,34551,7723,26828,26828,0,31,7544000.0
7544,7544999,20.566612106958683,37.632796352553946,0.08241317315668817,5105.514726400375,580.1159272193909,4121.061017036438,34553,7724,26829,26829,0,31,7545000.0
7545,7545999,20.566442390683953,37.632172367683864,0.08239552657759153,5106.193701505661,580.1846971511841,4122.570073127747,34556,7724,26832,26832,0,31,7546000.0
7546,7546999,20.56643045505059,37.63246719272045,0.08237143942033476,5107.286187410355,580.2547523975372,4122.09451007843,34561,7726,26835,26835,0,31,7547000.0
7547,7547999,20.56601156620979,37.63145926744063,0.08236439407332996,5108.42097735405,580.3249306678772,4121.338925361633,34568,7729,26839,26839,0,31,7548000.0
7548,7548999,20.565665757371026,37.630907056273884,0.08235241551402184,5109.282391786575,580.3945109844208,4122.037678718567,34570,7730,26840,26840,0,31,7549000.0
7549,7549999,20.565366606443785,37.63011151579137,0.08234500937509082,5109.905878305435,580.4651391506195,4123.847546577454,34571,7731,26840,26840,0,31,7550000.0
7550,7550999,20.56512644072539,37.62987006743759,0.08233414497977787,5110.635728597641,580.5347537994385,4125.207806587219,34571,7731,26840,26840,0,31,7551000.0
7551,7551999,20.564835650464,37.628906468756114,0.08233214965949176,5111.750217437744,580.6063120365143,4124.61535358429,34572,7732,26840,26840,0,31,7552000.0
7552,7552999,20.564640788647313,37.628500923881795,0.08232171544996747,5112.595516204834,580.6801416873932,4125.324513435364,34572,7732,26840,26840,0,31,7553000.0
7553,7553999,20.564333539930775,37.62765566409421,0.08231053318650428,5113.4389317035675,580.7515504360199,4126.01532459259,34573,7732,26841,26841,0,31,7554000.0
7554,7554999,20.564030920603678,37.62690448056386,0.08229974798994666,5114.345562696457,580.8249912261963,4126.66148853302,34575,7733,26842,26842,0,31,7555000.0
7555,7555999,20.56341678139887,37.62551714500739,0.08229975978412041,5115.246381044388,580.8975613117218,4127.197140693665,34576,7734,26842,26842,0,31,7556000.0
7556,7556999,20.563025672555966,37.624679354473614,0.08229244968834615,5115.992607355118,580.9685792922974,4128.522915840149,34576,7734,26842,26842,0,31,7557000.0
7557,7557999,20.562545949889852,37.623583698783165,0.0822872286588987,5117.2616193294525,581.0449559688568,4127.305691719055,34577,7735,26842,26842,0,31,7558000.0
7558,7558999,20.561861536342942,37.621998882650146,0.08228903044177072,5118.161806106567,581.1213777065277,4127.984745979309,34577,7735,26842,26842,0,31,7559000.0
7559,7559999,20.561450676227604,37.6210004071867,0.08228630819517702,5118.924334526062,581.1965756416321,4129.255772590637,34577,7735,26842,26842,0,31,7560000.0
7560,7560999,20.560713272920236,37.619422652569476,0.08228879453874671,5119.807109117508,581.271238565445,4129.892460823059,34577,7735,26842,26842,0,31,7561000.0
7561,7561999,20.55993712194997,37.6177526218575,0.08229316678276899,5120.732687950134,581.3455278873444,4130.428509712219,34578,7736,26842,26842,0,31,7562000.0
7562,7562999,20.559262727432774,37.61632529008957,0.08229411058113889,5121.785015583038,581.4192779064178,4130.4024477005005,34595,7736,26859,26859,0,31,7563000.0
7563,7563999,20.55861130157388,37.61545698175519,0.08228708151802844,5122.133983850479,581.4868681430817,4133.257840156555,34597,7736,26861,26861,0,31,7564000.0
7564,7564999,20.557899632720158,37.61434956023196,0.08227984226628704,5122.972297906876,581.5568795204163,4134.096859931946,34601,7738,26863,26863,0,31,7565000.0
7565,7565999,20.557346085152556,37.613066789541456,0.08227171538942168,5124.219596862793,581.6262423992157,4133.120297431946,34631,7742,26889,26889,0,31,7566000.0
7566,7566999,20.556552243626363,37.61156019304007,0.08227340658328164,5124.966938734055,581.6964204311371,4134.557240486145,34633,7743,26890,26890,0,31,7567000.0
7567,7567999,20.555906023287996,37.6101755547983,0.08227095899384695,5126.086869478226,581.7679681777954,4134.562817573547,34637,7745,26892,26892,0,31,7568000.0
7568,7568999,20.55503980243816,37.60844783583222,0.08227382075280232,5126.746268987656,581.8379511833191,4136.541546821594,34637,7745,26892,26892,0,31,7569000.0
7569,7569999,20.55428750567909,37.60711134779503,0.08227321084515793,5127.70755982399,581.9094762802124,4137.326260566711,34639,7746,26893,26893,0,31,7570000.0
7570,7570999,20.55358553501964,37.605978835077515,0.08226933869176312,5128.76399230957,581.9834821224213,4137.676716804504,34641,7747,26894,26894,0,31,7571000.0
7571,7571999,20.552761383432692,37.60426176648473,0.0822702411521159,5129.734293937683,582.054281949997,4138.33718585968,34645,7749,26896,26896,0,31,7572000.0
7572,7572999,20.552194128314397,37.60317939442951,0.08226306809475803,5130.66574215889,582.1255114078522,4139.060070991516,34647,7750,26897,26897,0,31,7573000.0
7573,7573999,20.551343742558867,37.601642749608395,0.0822601630319525,5131.8793025016785,582.1974647045135,4138.523549079895,34651,7752,26899,26899,0,31,7574000.0
7574,7574999,20.550567201527315,37.6004937509515,0.08225507805481358,5132.594438552856,582.2706038951874,4140.568615913391,34651,7752,26899,26899,0,31,7575000.0
7575,7575999,20.55000055330639,37.59926404199518,0.08225468322826013,5133.321252822876,582.346616268158,4142.499516487122,34651,7752,26899,26899,0,31,7576000.0
7576,7576999,20.54995201996205,37.60046582366406,0.08223787787743109,5134.555066823959,582.4228093624115,4141.9472551345825,34651,7752,26899,26899,0,31,7577000.0
7577,7577999,20.55051135449011,37.602398071214544,0.08222668079449214,5135.833086490631,582.4981241226196,4141.259434700012,34653,7753,26900,26900,0,31,7578000.0
7578,7578999,20.55097357223008,37.60529458048691,0.08220892982078787,5136.605333328247,582.5724821090698,4143.16685962677,34653,7753,26900,26900,0,31,7579000.0
7579,7579999,20.551706069170958,37.611600363830185,0.08218275805126918,5137.829795122147,582.6499712467194,4142.713376045227,34653,7753,26900,26900,0,31,7580000.0
7580,7580999,20.551752289435257,37.61314690032939,0.0821695808459253,5138.966361045837,582.7230260372162,4142.726201057434,34664,7754,26910,26910,0,31,7581000.0
7581,7581999,20.552084756108368,37.614928291891275,0.08215514655076006,5139.8594262599945,582.7976830005646,4144.005803108215,34669,7755,26914,26914,0,31,7582000.0
7582,7582999,20.551495063880196,37.61370840197388,0.08215236016964345,5140.556869268417,582.8677959442139,4145.55113697052,34675,7756,26919,26919,0,31,7583000.0
7583,7583999,20.551178790378177,37.61347148383239,0.0821451387573715,5141.450589418411,582.936074256897,4145.863926887512,34678,7757,26921,26921,0,31,7584000.0
7584,7584999,20.5509988214081,37.61305880914878,0.08214218604931534,5142.418299674988,583.0065817832947,4146.111035346985,34685,7759,26926,26926,0,31,7585000.0
7585,7585999,20.550582668349417,37.612378936478734,0.08214053951013134,5143.374606132507,583.0768344402313,4146.5051164627075,34702,7761,26941,26941,0,31,7586000.0
7586,7586999,20.550277524500174,37.61133485979051,0.08213792388368601,5143.922474384308,583.1492087841034,4148.5976457595825,34703,7761,26942,26942,0,31,7587000.0
7587,7587999,20.550213731136072,37.6108428323187,0.08213009163577101,5144.509210348129,583.2191631793976,4150.616192817688,34703,7761,26942,26942,0,31,7588000.0
7588,7588999,20.550295341858256,37.610665598741285,0.08212396090630247,5145.338265419006,583.2899053096771,4151.3533754348755,34704,7761,26943,26943,0,31,7589000.0
7589,7589999,20.550712983427275,37.61124452584732,0.08211388167324563,5146.113255262375,583.3604636192322,4152.395619392395,34707,7762,26945,26945,0,31,7590000.0
7590,7590999,20.55163671556542,37.613019293129156,0.08211077577989578,5146.634138584137,583.4318232536316,4154.972676277161,34707,7762,26945,26945,0,31,7591000.0
7591,7591999,20.552630071497155,37.614828184933316,0.08211120948203132,5147.523854732513,583.502843618393,4155.820210456848,34707,7762,26945,26945,0,31,7592000.0
7592,7592999,20.55354227252801,37.61654812893985,0.08212287655414663,5148.345119714737,583.5757591724396,4157.112080574036,34709,7763,26946,26946,0,31,7593000.0
7593,7593999,20.55479978153979,37.618887212645454,0.08213491790684124,5149.663374423981,583.6494076251984,4155.947331428528,34715,7766,26949,26949,0,31,7594000.0
7594,7594999,20.556329078998136,37.62161323448769,0.08215048931234092,5150.988238573074,583.7238321304321,4154.628987312317,34722,7770,26952,26952,0,31,7595000.0
7595,7595999,20.558206982240876,37.62502921338055,0.08219397341765633,5151.725977420807,583.7975990772247,4156.206364631653,34722,7770,26952,26952,0,31,7596000.0
7596,7596999,20.560186791082728,37.62851857725389,0.0822373055803014,5152.483472108841,583.8696756362915,4157.794232368469,34722,7770,26952,26952,0,31,7597000.0
7597,7597999,20.561926972835117,37.63088092017111,0.08226924394573631,5153.528560876846,583.9419188499451,4158.031002998352,34726,7772,26954,26954,0,31,7598000.0
7598,7598999,20.563476204548127,37.63288863936785,0.08229043327432695,5154.567350387573,584.0184226036072,4158.411953926086,34738,7773,26965,26965,0,31,7599000.0
7599,7599999,20.565310358730283,37.63529541918427,0.08230884121783844,5155.387335300446,584.0928950309753,4159.773190498352,34738,7773,26965,26965,0,31,7600000.0
7600,7600999,20.566474230388415,37.6366061891329,0.08231230438240555,5156.715502977371,584.1687462329865,4158.755711555481,34740,7774,26966,26966,0,31,7601000.0
7601,7601999,20.566811442056537,37.637434810297464,0.08227373812716432,5157.241947650909,584.2382380962372,4161.042126655579,34761,7774,26987,26987,0,31,7602000.0
7602,7602999,20.56624022924053,37.63656280530737,0.08226234002438404,5158.098813533783,584.306530714035,4161.867192268372,34767,7777,26990,26990,0,31,7603000.0
7603,7603999,20.565759858120124,37.63554654196683,0.08225442676730177,5158.856414794922,584.3817782402039,4163.333783149719,34774,7778,26996,26996,0,31,7604000.0
7604,7604999,20.56558162046593,37.6355763560172,0.08223950336128782,5159.788416624069,584.4501821994781,4163.752835273743,34791,7780,27011,27011,0,31,7605000.0
7605,7605999,20.5651961405783,37.63453985108317,0.08223299975196319,5160.474345445633,584.5199263095856,4165.421666145325,34796,7782,27014,27014,0,31,7606000.0
7606,7606999,20.564736167564007,37.63318758304977,0.08222774154598433,5160.9638657569885,584.5889081954956,4168.04194355011,34798,7783,27015,27015,0,31,7607000.0
7607,7607999,20.564164626277783,37.63174707270622,0.08222486772204196,5161.74808382988,584.6580619812012,4169.381505012512,34802,7785,27017,27017,0,31,7608000.0
7608,7608999,20.56375017111312,37.630909878448165,0.08221895300414694,5162.839924812317,584.7296664714813,4169.072461128235,34802,7785,27017,27017,0,31,7609000.0
7609,7609999,20.563445236148702,37.62980659414745,0.08221038151575866,5163.600054502487,584.8025789260864,4170.426152229309,34802,7785,27017,27017,0,31,7610000.0
7610,7610999,20.56292749352276,37.628558241451636,0.08220836904863116,5164.277076244354,584.8753204345703,4172.426716804504,34802,7785,27017,27017,0,31,7611000.0
7611,7611999,20.562532969411095,37.627399324144626,0.0822009081268763,5165.346111059189,584.9454951286316,4172.413395881653,34809,7788,27021,27021,0,31,7612000.0
7612,7612999,20.56221482895325,37.62660264854706,0.08219484442346281,5165.916084527969,585.0167851448059,4174.999943733215,34810,7788,27022,27022,0,31,7613000.0
7613,7613999,20.561968052666803,37.625795814898055,0.0821882943514648,5166.891738176346,585.0907030105591,4176.006161689758,34812,7789,27023,27023,0,31,7614000.0
7614,7614999,20.561817821978487,37.62506222895534,0.08218115163482353,5168.164447069168,585.1627581119537,4174.848713874817,34812,7789,27023,27023,0,31,7615000.0
7615,7615999,20.561872747935222,37.624429876717876,0.08217443329997243,5169.1642537117,585.2400920391083,4175.022747993469,34812,7789,27023,27023,0,31,7616000.0
7616,7616999,20.561995178836202,37.62389255315017,0.08217224745509588,5169.801077604294,585.3095755577087,4177.091862678528,34812,7789,27023,27023,0,31,7617000.0
7617,7617999,20.562505015995523,37.62414317114053,0.08216239542728687,5170.6625599861145,585.3831191062927,4178.318135261536,34816,7791,27025,27025,0,31,7618000.0
7618,7618999,20.562888030127148,37.62495397690674,0.08215321843957324,5171.66295170784,585.4585328102112,4179.294209480286,34818,7792,27026,27026,0,31,7619000.0
7619,7619999,20.5633709163138,37.62490315667588,0.08214584683410286,5172.762039422989,585.5340595245361,4179.409520149231,34820,7793,27027,27027,0,31,7620000.0
7620,7620999,20.563382727095174,37.62402117138954,0.08214174829960075,5173.962700128555,585.6078281402588,4178.86665058136,34822,7794,27028,27028,0,31,7621000.0
7621,7621999,20.562999069789168,37.62318484248655,0.08213161947878134,5174.6750664711,585.6776065826416,4180.407673835754,34831,7795,27036,27036,0,31,7622000.0
7622,7622999,20.562531625000748,37.62273100511615,0.08212369153321908,5175.469014406204,585.7488601207733,4181.4926652908325,34844,7796,27048,27048,0,31,7623000.0
7623,7623999,20.562060924924847,37.621442208104135,0.08211965869454396,5176.619727134705,585.8204102516174,4181.145215034485,34852,7798,27054,27054,0,31,7624000.0
7624,7624999,20.561809908738965,37.62113093990958,0.08211155984783047,5177.226365566254,585.8933107852936,4183.2009019851685,34853,7798,27055,27055,0,31,7625000.0
7625,7625999,20.561417961646743,37.62080131282314,0.08210230807491403,5178.2080998420715,585.964816570282,4183.37104511261,34856,7799,27057,27057,0,31,7626000.0
7626,7626999,20.561157096904005,37.62022382864284,0.08209328281968198,5179.17210650444,586.0366079807281,4183.628682136536,34857,7799,27058,27058,0,31,7627000.0
7627,7627999,20.560933559449573,37.61942530318468,0.08208441988838533,5179.9850730896,586.107038974762,4184.476223945618,34859,7800,27059,27059,0,31,7628000.0
7628,7628999,20.56107443266164,37.61950927961328,0.08207136055198694,5180.639954090118,586.178174495697,4186.478962898254,34861,7801,27060,27060,0,31,7629000.0
7629,7629999,20.561107704372663,37.61924924136945,0.082062333202788,5181.75719666481,586.2505865097046,4185.973858833313,34861,7801,27060,27060,0,31,7630000.0
7630,7630999,20.561647796863646,37.62007609238456,0.08204447823567451,5182.7004108428955,586.3231990337372,4186.472783088684,34865,7803,27062,27062,0,31,7631000.0
7631,7631999,20.56203592360992,37.620286228819,0.08203324624192587,5183.826434612274,586.3942630290985,4185.963994026184,34866,7804,27062,27062,0,31,7632000.0
7632,7632999,20.562829751821692,37.62180708878902,0.08202259097706233,5184.691898107529,586.4669647216797,4186.658329963684,34866,7804,27062,27062,0,31,7633000.0
7633,7633999,20.56345835621401,37.62263026399126,0.08201319499842186,5185.337976694107,586.538459777832,4188.62218952179,34880,7805,27075,27075,0,31,7634000.0
7634,7634999,20.56418190745289,37.62370438036644,0.0820022902689932,5186.186614751816,586.608155965805,4189.312970161438,34880,7805,27075,27075,0,31,7635000.0
7635,7635999,20.564617504052357,37.62402417033919,0.08200177935454378,5187.19517493248,586.6809766292572,4189.59378528595,34882,7806,27076,27076,0,31,7636000.0
7636,7636999,20.565091802927416,37.62460796120912,0.08198802807919381,5187.905330657959,586.7539978027344,4191.083188056946,34892,7806,27086,27086,0,31,7637000.0
7637,7637999,20.564972313801306,37.624957707510575,0.0819783683404417,5188.587997198105,586.8310544490814,4192.634846687317,34898,7807,27091,27091,0,31,7638000.0
7638,7638999,20.56485855245035,37.62507843219425,0.08196855431620509,5189.3762900829315,586.9086322784424,4193.612973213196,34901,7808,27093,27093,0,31,7639000.0
7639,7639999,20.564463973690323,37.62518680852597,0.08196204667122065,5190.204931974411,586.9881799221039,4194.3439836502075,34917,7810,27107,27107,0,31,7640000.0
7640,7640999,20.563859147632215,37.623771493291045,0.08196399595837944,5190.648269891739,587.0676419734955,4197.0817766189575,34918,7810,27108,27108,0,31,7641000.0
7641,7641999,20.563424284593875,37.62268950762666,0.08196253823644972,5191.411903142929,587.1464867591858,4198.44460773468,34920,7811,27109,27109,0,31,7642000.0
7642,7642999,20.562866670897833,37.62142096118609,0.08196022123309765,5192.4140038490295,587.2291827201843,4198.895825386047,34926,7814,27112,27112,0,31,7643000.0
7643,7643999,20.56228623279423,37.62006504808145,0.08196012521642182,5193.3253881931305,587.3098356723785,4199.914151191711,34931,7816,27115,27115,0,31,7644000.0
7644,7644999,20.561826485741616,37.619119481900306,0.08195956670616888,5194.127637386322,587.3893613815308,4201.221394538879,34934,7817,27117,27117,0,31,7645000.0
7645,7645999,20.56117882337021,37.6176917289072,0.0819591706177244,5195.031429767609,587.4712934494019,4201.927388191223,34936,7818,27118,27118,0,31,7646000.0
7646,7646999,20.56073792718078,37.61700779030332,0.08195551483883567,5195.784693002701,587.5514342784882,4203.360486030579,34936,7818,27118,27118,0,31,7647000.0
7647,7647999,20.560160968969882,37.615757679037486,0.0819533982883267,5196.642538070679,587.6338815689087,4204.702748298645,34938,7819,27119,27119,0,31,7648000.0
7648,7648999,20.55952618210379,37.61425741992985,0.08195376374883145,5197.842552661896,587.7166695594788,4204.32523059845,34947,7821,27126,27126,0,31,7649000.0
7649,7649999,20.55905809396723,37.61320595917487,0.08195136564499361,5198.811943531036,587.8021230697632,4205.100789070129,34949,7822,27127,27127,0,31,7650000.0
7650,7650999,20.55860086518295,37.61213271675757,0.0819496306131835,5199.86362361908,587.8833463191986,4204.794323921204,34951,7823,27128,27128,0,31,7651000.0
7651,7651999,20.55803463355352,37.61091244860652,0.08194780860089523,5200.790008068085,587.9646844863892,4205.538472175598,34953,7824,27129,27129,0,31,7652000.0
7652,7652999,20.557600057772888,37.609925945317244,0.08194435162025149,5201.513119697571,588.0477573871613,4207.450154304504,34955,7825,27130,27130,0,31,7653000.0
7653,7653999,20.55718897746744,37.60900349203077,0.08194237338901511,5202.810765743256,588.1321806907654,4206.1002016067505,34957,7826,27131,27131,0,31,7654000.0
7654,7654999,20.556679114914367,37.60781161416041,0.08194100172714125,5203.740128278732,588.2150535583496,4206.792241096497,34957,7826,27131,27131,0,31,7655000.0
7655,7655999,20.55686052107293,37.61126666882314,0.08191327997213094,5203.97833943367,588.2838268280029,4210.294888496399,34976,7826,27150,27150,0,31,7656000.0
7656,7656999,20.556656955447618,37.61116440422861,0.08190368026935546,5204.273804426193,588.3507480621338,4213.5900621414185,34977,7826,27151,27151,0,31,7657000.0
7657,7657999,20.5563871042243,37.611202832439425,0.08189916954266885,5205.545125722885,588.4174177646637,4212.555790901184,34995,7832,27163,27163,0,31,7658000.0
7658,7658999,20.55613827678911,37.61039170289914,0.08189342888512985,5206.4109263420105,588.4871413707733,4213.5547914505005,35009,7834,27175,27175,0,31,7659000.0
7659,7659999,20.55623454492093,37.61020230983471,0.0819073716755696,5206.829039335251,588.5559003353119,4216.806042671204,35009,7834,27175,27175,0,31,7660000.0
7660,7660999,20.5566677149214,37.61042798672958,0.08191859972286286,5208.344007015228,588.6254205703735,4214.9399156570435,35026,7837,27189,27189,0,31,7661000.0
7661,7661999,20.5572329553975,37.610956998557064,0.08192234316056934,5209.36256146431,588.6941974163055,4214.972111701965,35033,7840,27193,27193,0,31,7662000.0
7662,7662999,20.557938460647588,37.61160533915957,0.08194934308892743,5210.192793369293,588.7628769874573,4216.182286262512,35037,7842,27195,27195,0,31,7663000.0
7663,7663999,20.55842084307647,37.61201409760296,0.08196206525778471,5211.266486644745,588.8327360153198,4216.200764656067,35043,7845,27198,27198,0,31,7664000.0
7664,7664999,20.55923129662856,37.61254368332501,0.0819831819196406,5212.233276605606,588.9007532596588,4216.498211860657,35047,7847,27200,27200,0,31,7665000.0
7665,7665999,20.559982645589244,37.61359055439558,0.08201375102954012,5213.194889307022,588.9717111587524,4217.192364692688,35053,7850,27203,27203,0,31,7666000.0
7666,7666999,20.56121156181402,37.61574354075774,0.08203604182974322,5214.25226354599,589.0426273345947,4217.291127204895,35055,7851,27204,27204,0,31,7667000.0
7667,7667999,20.561939441983426,37.61615405327258,0.08207390178837204,5215.10689496994,589.1138105392456,4218.035420417786,35055,7851,27204,27204,0,31,7668000.0
7668,7668999,20.563660998940744,37.61897622512365,0.08210349101955727,5215.731426954269,589.1832299232483,4219.994519233704,35056,7851,27205,27205,0,31,7669000.0
7669,7669999,20.564788254718625,37.62027515448121,0.08214505637148162,5216.169425010681,589.2536323070526,4223.178105354309,35056,7851,27205,27205,0,31,7670000.0
7670,7670999,20.56631574468955,37.622484561019526,0.08219053580016322,5217.495940923691,589.32479596138,4222.019551277161,35070,7853,27217,27217,0,31,7671000.0
7671,7671999,20.568159768908693,37.625892581591444,0.08223147157637967,5218.90776348114,589.3932795524597,4219.742527961731,35074,7855,27219,27219,0,31,7672000.0
7672,7672999,20.569925687132752,37.62827058947875,0.08227420617447001,5219.706337213516,589.4620299339294,4221.040425300598,35076,7856,27220,27220,0,31,7673000.0
7673,7673999,20.57156782807499,37.63036223033034,0.08230415957289094,5220.800808429718,589.5316891670227,4220.969876289368,35080,7858,27222,27222,0,31,7674000.0
7674,7674999,20.572538580268297,37.631390860036575,0.08229961368737992,5221.411321401596,589.6005308628082,4223.249661445618,35082,7858,27224,27224,0,31,7675000.0
7675,7675999,20.572292447218533,37.630761402139825,0.08229694016809841,5222.422549724579,589.6697454452515,4222.991353034973,35085,7859,27226,27226,0,31,7676000.0
7676,7676999,20.5721252964894,37.63042896230671,0.08229769282100696,5223.425521373749,589.7398133277893,4222.7612657547,35085,7859,27226,27226,0,31,7677000.0
7677,7677999,20.572191095931405,37.630476575047425,0.08229256343272118,5224.1327040195465,589.8102240562439,4224.069073677063,35088,7860,27228,27228,0,31,7678000.0
7678,7678999,20.57207835621919,37.62980896851962,0.082286898968156,5224.883106231689,589.8798940181732,4225.30675983429,35103,7861,27242,27242,0,31,7679000.0
7679,7679999,20.572284506530906,37.6296111817188,0.08229897539174436,5225.204851865768,589.9507739543915,4228.685017585754,35104,7861,27243,27243,0,31,7680000.0
7680,7680999,20.572492990655785,37.62913588130731,0.0823058552224839,5226.326557397842,590.0228323936462,4228.134030342102,35108,7863,27245,27245,0,31,7681000.0
7681,7681999,20.572680876331585,37.629118882051145,0.08231293200545908,5227.047999382019,590.0932321548462,4229.513089179993,35108,7863,27245,27245,0,31,7682000.0
7682,7682999,20.573046531291332,37.629256393427156,0.08232788844651551,5227.789747238159,590.163551568985,4230.961758613586,35120,7864,27256,27256,0,31,7683000.0
7683,7683999,20.573823287401986,37.63028300458408,0.08234403424736336,5228.363612413406,590.2362570762634,4233.537686347961,35120,7864,27256,27256,0,31,7684000.0
7684,7684999,20.574424749419375,37.63064792076337,0.08237182057832781,5229.597834825516,590.3083896636963,4232.706868171692,35120,7864,27256,27256,0,31,7685000.0
7685,7685999,20.57509182325369,37.63110077004507,0.08239817886255485,5230.64160990715,590.3797001838684,4232.702961921692,35124,7866,27258,27258,0,31,7686000.0
7686,7686999,20.57566276213563,37.63123218946851,0.08242695720871973,5231.522493124008,590.451896905899,4233.3984117507935,35124,7866,27258,27258,0,31,7687000.0
7687,7687999,20.576685954039107,37.632307867047594,0.0824705180183185,5232.525493383408,590.5274198055267,4233.5566148757935,35124,7866,27258,27258,0,31,7688000.0
7688,7688999,20.57777933681233,37.633199452236425,0.082510722631981,5233.50839138031,590.5997092723846,4234.092114448547,35136,7867,27269,27269,0,31,7689000.0
7689,7689999,20.578595083540318,37.633989610532176,0.08254995589102254,5234.797863006592,590.670446395874,4232.911778450012,35140,7869,27271,27271,0,31,7690000.0
7690,7690999,20.57954436885148,37.63468133540036,0.08258360622752925,5235.679311275482,590.7424235343933,4233.584767341614,35142,7870,27272,27272,0,31,7691000.0
7691,7691999,20.58019601217444,37.63469758300928,0.082614805230381,5236.312568664551,590.8152430057526,4235.706753730774,35142,7870,27272,27272,0,31,7692000.0
7692,7692999,20.580475785255647,37.6341596403746,0.08263385011591451,5237.383898258209,590.8896465301514,4235.7548570632935,35142,7870,27272,27272,0,31,7693000.0
7693,7693999,20.580351496570348,37.63354976183843,0.0826239040856579,5238.170125961304,590.9630832672119,4236.7641496658325,35161,7871,27290,27290,0,31,7694000.0
7694,7694999,20.579768483391238,37.63397379405232,0.08261319768196318,5238.69820022583,591.032546043396,4238.892254829407,35166,7872,27294,27294,0,31,7695000.0
7695,7695999,20.579307006363628,37.633691058700265,0.08260974700483215,5239.264376878738,591.1008639335632,4241.049817085266,35168,7873,27295,27295,0,31,7696000.0
7696,7696999,20.57872224866609,37.63250176708112,0.08260475705402881,5240.134043931961,591.1720387935638,4242.01476764679,35170,7874,27296,27296,0,31,7697000.0
7697,7697999,20.578159929669688,37.631455144380624,0.08259923406840497,5240.910858392715,591.2421505451202,4243.601483345032,35174,7876,27298,27298,0,31,7698000.0
7698,7698999,20.57779203521743,37.63037297595272,0.08259312116430273,5241.849859237671,591.3129177093506,4244.306721687317,35176,7877,27299,27299,0,31,7699000.0
7699,7699999,20.577394212422774,37.62914582469281,0.08259126683529372,5242.795534849167,591.3828611373901,4245.087613105774,35178,7878,27300,27300,0,31,7700000.0
7700,7700999,20.577026861847024,37.6280307145332,0.08258864262193177,5243.808609724045,591.4543967247009,4245.602330207825,35184,7881,27303,27303,0,31,7701000.0
7701,7701999,20.577057567098255,37.6280510070182,0.08258468210091452,5245.055928468704,591.5263223648071,4244.70649433136,35193,7885,27308,27308,0,31,7702000.0
7702,7702999,20.57725139703402,37.627879383905714,0.08257942088435821,5245.980335235596,591.5976848602295,4245.433468818665,35195,7886,27309,27309,0,31,7703000.0
7703,7703999,20.57722602556381,37.62760573380861,0.08257451621713441,5246.794708251953,591.6680252552032,4246.617337226868,35199,7888,27311,27311,0,31,7704000.0
7704,7704999,20.577412713375704,37.627751305340915,0.08257418267695427,5247.7341685295105,591.7402222156525,4247.419087409973,35201,7889,27312,27312,0,31,7705000.0
7705,7705999,20.5776150778603,37.62773424225647,0.08257647624999376,5248.775518417358,591.8131155967712,4247.376622200012,35203,7890,27313,27313,0,31,7706000.0
7706,7706999,20.578292893559404,37.628708847630456,0.08258355820925756,5249.53196310997,591.8836054801941,4248.761258125305,35203,7890,27313,27313,0,31,7707000.0
7707,7707999,20.578854629771303,37.629264710320626,0.0825861094211866,5250.703306913376,591.9545333385468,4247.93753528595,35205,7891,27314,27314,0,31,7708000.0
7708,7708999,20.579685788535823,37.63010264773246,0.08258985975789068,5251.345464229584,592.0274097919464,4249.8764543533325,35205,7891,27314,27314,0,31,7709000.0
7709,7709999,20.580742696225585,37.631305352728624,0.0825840675538384,5252.351973772049,592.1028459072113,4250.211827278137,35205,7891,27314,27314,0,31,7710000.0
7710,7710999,20.581320578313324,37.631509213149414,0.08257801522099395,5253.518280982971,592.1783409118652,4249.7599992752075,35207,7892,27315,27315,0,31,7711000.0
7711,7711999,20.58194810447596,37.63222183659286,0.08256587308898933,5254.691500902176,592.2545959949493,4249.24026966095,35209,7893,27316,27316,0,31,7712000.0
7712,7712999,20.581951963422224,37.631438148578205,0.08255509793252258,5255.403168439865,592.3288676738739,4250.735127449036,35215,7893,27322,27322,0,31,7713000.0
7713,7713999,20.581793190399367,37.631800587170375,0.08252764910300758,5256.22759437561,592.3986124992371,4251.53404712677,35229,7896,27333,27333,0,31,7714000.0
7714,7714999,20.5816578594671,37.63158693585178,0.0825016402297355,5257.000052928925,592.4676990509033,4252.389798164368,35229,7896,27333,27333,0,31,7715000.0
7715,7715999,20.581472093922592,37.631052997507304,0.08247995335343905,5257.777851819992,592.5382051467896,4253.667790412903,35231,7897,27334,27334,0,31,7716000.0
7716,7716999,20.581039137410958,37.629991372524564,0.08246530939183849,5258.777966976166,592.610790014267,4253.7267961502075,35233,7898,27335,27335,0,31,7717000.0
7717,7717999,20.581059734458876,37.62994193476703,0.08244317048783556,5259.657997131348,592.6818106174469,4254.260403633118,35237,7900,27337,27337,0,31,7718000.0
7718,7718999,20.580654620085557,37.628776210773985,0.08243031793581823,5260.525215148926,592.7540912628174,4254.977765083313,35237,7900,27337,27337,0,31,7719000.0
7719,7719999,20.58051496192992,37.62807546348633,0.08241662173398867,5261.257045984268,592.8263876438141,4256.291592597961,35237,7900,27337,27337,0,31,7720000.0
7720,7720999,20.58017508251766,37.627036820056716,0.0824056603394826,5262.023690462112,592.8988251686096,4257.578724861145,35237,7900,27337,27337,0,31,7721000.0
7721,7721999,20.579920280831644,37.62609624314398,0.08239501513941128,5263.1069622039795,592.9725775718689,4257.306767463684,35241,7902,27339,27339,0,31,7722000.0
7722,7722999,20.579711666073678,37.62519274670846,0.08238033852525439,5264.273265838623,593.046905040741,4256.681324958801,35245,7904,27341,27341,0,31,7723000.0
7723,7723999,20.579363477837422,37.62417361517606,0.08236878483518495,5265.4443991184235,593.1209154129028,4256.035290718079,35253,7906,27347,27347,0,31,7724000.0
7724,7724999,20.579057740214907,37.62324208613161,0.082358700507565,5266.096813201904,593.19269323349,4257.972958564758,35254,7907,27347,27347,0,31,7725000.0
7725,7725999,20.579021291113715,37.62285056844557,0.08234627171196862,5267.016986370087,593.2661273479462,4258.64936542511,35256,7908,27348,27348,0,31,7726000.0
7726,7726999,20.578987877303852,37.622701129395644,0.08233160346333757,5268.163810491562,593.3422167301178,4258.131970405579,35270,7910,27360,27360,0,31,7727000.0
7727,7727999,20.5790262034841,37.622134831382255,0.082319258564991,5269.159873962402,593.4181320667267,4258.558560371399,35270,7910,27360,27360,0,31,7728000.0
7728,7728999,20.57898882603947,37.62151690319412,0.08231055482548233,5270.263909101486,593.4908177852631,4258.145268440247,35286,7911,27375,27375,0,31,7729000.0
7729,7729999,20.57913218465474,37.62107168973296,0.08230212966112183,5270.786959409714,593.5649502277374,4260.752682685852,35286,7911,27375,27375,0,31,7730000.0
7730,7730999,20.578965402977584,37.620111962791256,0.08229669382959803,5271.652491092682,593.6425609588623,4261.974667549133,35290,7913,27377,27377,0,31,7731000.0
7731,7731999,20.578740333902882,37.61899810814924,0.08228861502412121,5272.443952798843,593.7156226634979,4263.325360298157,35290,7913,27377,27377,0,31,7732000.0
7732,7732999,20.578412749749237,37.617908096662134,0.08228294747554599,5273.623678684235,593.7871825695038,4262.4890031814575,35320,7915,27405,27405,0,31,7733000.0
7733,7733999,20.577699596104857,37.616281841933684,0.08227965521242331,5274.266412258148,593.854620218277,4264.125752449036,35327,7917,27410,27410,0,31,7734000.0
7734,7734999,20.576937788476194,37.6147890307275,0.08227522411817101,5274.96219420433,593.9244472980499,4265.6298723220825,35331,7919,27412,27412,0,31,7735000.0
7735,7735999,20.576498634506514,37.614199905829146,0.08226788013262842,5275.702580690384,593.992552280426,4267.328190803528,35334,7920,27414,27414,0,31,7736000.0
7736,7736999,20.576180987900237,37.61343063380644,0.08225989108107956,5276.76856470108,594.0613770484924,4267.2697496414185,35337,7921,27416,27416,0,31,7737000.0
7737,7737999,20.57584625616689,37.61319157762045,0.08225137787687231,5277.890276193619,594.1310677528381,4267.041569709778,35344,7922,27422,27422,0,31,7738000.0
7738,7738999,20.575523751935737,37.612831971192755,0.08224438811930468,5278.6353442668915,594.2013189792633,4268.35516834259,35346,7923,27423,27423,0,31,7739000.0
7739,7739999,20.575425362151567,37.61300359932609,0.08223576885283412,5279.293607950211,594.2706775665283,4270.226582527161,35348,7924,27424,27424,0,31,7740000.0
7740,7740999,20.57527715767185,37.612898721259064,0.08223193508334325,5279.950684309006,594.3413817882538,4272.278874397278,35348,7924,27424,27424,0,31,7741000.0
7741,7741999,20.57528906908592,37.61393650408319,0.08222423301731141,5281.120010375977,594.4124855995178,4271.8793687820435,35350,7925,27425,27425,0,31,7742000.0
7742,7742999,20.575632837699956,37.61547020699384,0.08221149683973028,5282.307047367096,594.4830968379974,4271.487210273743,35356,7928,27428,27428,0,31,7743000.0
7743,7743999,20.575675651683603,37.615417424144724,0.0822075391053596,5283.231360673904,594.551370382309,4272.015667915344,35358,7929,27429,27429,0,31,7744000.0
7744,7744999,20.575727113108332,37.61545304588428,0.08221237499958867,5283.812247037888,594.6268486976624,4274.5883531570435,35358,7929,27429,27429,0,31,7745000.0
7745,7745999,20.576333293365014,37.617355911156004,0.08221610094317633,5284.734667539597,594.7000980377197,4275.238057136536,35358,7929,27429,27429,0,31,7746000.0
7746,7746999,20.576735011868948,37.61919461233639,0.08221320901258589,5285.706983566284,594.7715675830841,4275.770443916321,35361,7931,27430,27430,0,31,7747000.0
7747,7747999,20.57713034274991,37.61947962283251,0.08220955121908469,5286.515727519989,594.8428072929382,4277.067578315735,35363,7932,27431,27431,0,31,7748000.0
7748,7748999,20.577895074257764,37.6205606453547,0.08219674218719508,5287.568991184235,594.9138422012329,4277.281476020813,35367,7934,27433,27433,0,31,7749000.0
7749,7749999,20.57849509455493,37.620828850155135,0.08219714002110967,5288.782554149628,594.9859499931335,4276.72846698761,35371,7936,27435,27435,0,31,7750000.0
7750,7750999,20.579198489902367,37.621211775390385,0.0821963637601385,5289.9010989665985,595.0577709674835,4276.4771547317505,35373,7937,27436,27436,0,31,7751000.0
7751,7751999,20.579493814950236,37.621089694955266,0.08219876761402023,5291.305923938751,595.1298747062683,4274.623059272766,35377,7939,27438,27438,0,31,7752000.0
7752,7752999,20.579372235394995,37.620707999572076,0.08218993398914076,5292.101395368576,595.2001211643219,4275.624775886536,35388,7940,27448,27448,0,31,7753000.0
7753,7753999,20.579015277393307,37.62015857104836,0.08218548166508699,5292.791961193085,595.2682161331177,4277.014821052551,35391,7941,27450,27450,0,31,7754000.0
7754,7754999,20.57859171013677,37.619061167173804,0.08218422654520752,5293.623400688171,595.336722612381,4277.890225410461,35394,7942,27452,27452,0,31,7755000.0
7755,7755999,20.578205854912408,37.61811939426043,0.08218105066590309,5294.775235652924,595.406590461731,4277.453427314758,35422,7947,27475,27475,0,31,7756000.0
7756,7756999,20.577658609615497,37.61684028102574,0.08218187778905683,5295.199014425278,595.4761462211609,4280.170536994934,35425,7948,27477,27477,0,31,7757000.0
7757,7757999,20.57718374494864,37.61569643369107,0.08218353781883825,5295.568669080734,595.5482490062714,4283.463948249817,35426,7948,27478,27478,0,31,7758000.0
7758,7758999,20.5766118308546,37.61436329866258,0.08218232506987933,5296.322875261307,595.6194796562195,4284.8604555130005,35426,7948,27478,27478,0,31,7759000.0
7759,7759999,20.57619773489729,37.61331274672377,0.08217880208119221,5297.330585241318,595.6900591850281,4285.091290473938,35429,7949,27480,27480,0,31,7760000.0
7760,7760999,20.575930636785333,37.61251257766942,0.08217783984737481,5298.32662320137,595.7601580619812,4285.214825630188,35429,7949,27480,27480,0,31,7761000.0
7761,7761999,20.575670376588857,37.611424403092535,0.08217432169137073,5299.212484836578,595.8316407203674,4285.99816608429,35429,7949,27480,27480,0,31,7762000.0
7762,7762999,20.57538300414975,37.6103572012995,0.08216977193711195,5300.370684146881,595.9031615257263,4285.411137580872,35434,7951,27483,27483,0,31,7763000.0
7763,7763999,20.57524033444212,37.60953488768097,0.0821669681506153,5301.380279541016,595.9778962135315,4285.616902351379,35434,7951,27483,27483,0,31,7764000.0
7764,7764999,20.575004672578476,37.60839094121251,0.08216308740083511,5302.270476818085,596.0535032749176,4286.282971382141,35434,7951,27483,27483,0,31,7765000.0
7765,7765999,20.574647021724143,37.60715986245838,0.08216190434537252,5303.214465141296,596.1258308887482,4286.88586139679,35438,7953,27485,27485,0,31,7766000.0
7766,7766999,20.57437127564509,37.6058974568091,0.08215884642031124,5304.212804079056,596.1965551376343,4287.026326179504,35450,7954,27496,27496,0,31,7767000.0
7767,7767999,20.57388696741926,37.60539417275471,0.0821577327975962,5305.02253818512,596.2686967849731,4288.359387397766,35450,7954,27496,27496,0,31,7768000.0
7768,7768999,20.57461635754247,37.608051361576585,0.08215717088825603,5305.64755654335,596.3469107151031,4290.126675605774,35468,7955,27513,27513,0,31,7769000.0
7769,7769999,20.57491991568873,37.60868783525134,0.08218173764909276,5306.377672195435,596.4242610931396,4291.449299812317,35476,7956,27520,27520,0,31,7770000.0
7770,7770999,20.575062094352724,37.60902333700712,0.08214821900108416,5307.118013381958,596.5017545223236,4292.94615650177,35480,7958,27522,27522,0,31,7771000.0
7771,7771999,20.57568935728926,37.6104428051773,0.08215019424224435,5307.9305164813995,596.5792014598846,4293.866436958313,35480,7958,27522,27522,0,31,7772000.0
7772,7772999,20.576401827272754,37.612386446429326,0.08212668632186348,5309.361317873001,596.6607823371887,4292.210942268372,35486,7961,27525,27525,0,31,7773000.0
7773,7773999,20.576960580431937,37.613084782417886,0.0821267734975506,5310.227602005005,596.7391755580902,4292.976620674133,35488,7962,27526,27526,0,31,7774000.0
7774,7774999,20.577862485960154,37.614563535988324,0.08212325446074598,5311.42737030983,596.8185639381409,4292.150403022766,35495,7965,27530,27530,0,31,7775000.0
7775,7775999,20.579132087208393,37.618602076874424,0.08210609334815822,5312.036120176315,596.897759437561,4294.144742012024,35495,7965,27530,27530,0,31,7776000.0
7776,7776999,20.580186956056565,37.620281912660055,0.08210230340577784,5313.418489933014,597.1432571411133,4296.1572008132935,35497,7966,27531,27531,0,31,7777000.0
7777,7777999,20.58165358816507,37.62216731846499,0.08210149052752369,5315.359699964523,597.3061344623566,4296.616765022278,35502,7969,27533,27533,0,31,7778000.0
7778,7778999,20.583454716110257,37.62517894341034,0.08208178738661909,5317.6693658828735,597.6026477813721,4298.597950935364,35502,7969,27533,27533,0,31,7779000.0
7779,7779999,20.58520321339547,37.628170219408474,0.08206677348661096,5320.056368350983,597.8918952941895,4300.532841682434,35502,7969,27533,27533,0,31,7780000.0
7780,7780999,20.587208942442718,37.63172256172012,0.08204116628730496,5321.057387590408,597.9834315776825,4301.455403327942,35502,7969,27533,27533,0,31,7781000.0
7781,7781999,20.588901986050814,37.63428953655813,0.08202920130794877,5322.4820902347565,598.0732924938202,4300.334408760071,35505,7971,27534,27534,0,31,7782000.0
7782,7782999,20.591127091730737,37.63794020628208,0.08201417545731715,5324.120944023132,598.1634595394135,4297.882992744446,35509,7973,27536,27536,0,31,7783000.0
7783,7783999,20.59295643112424,37.63996268445743,0.08200827354069351,5324.949497699738,598.2534174919128,4299.234333992004,35515,7974,27541,27541,0,31,7784000.0
7784,7784999,20.595004506721974,37.64270722706922,0.08202466882857118,5325.658269882202,598.3444385528564,4301.137227058411,35515,7974,27541,27541,0,31,7785000.0
7785,7785999,20.596544742279658,37.644364602015045,0.08202936664763938,5326.65198802948,598.4369170665741,4301.847851753235,35517,7975,27542,27542,0,31,7786000.0
7786,7786999,20.59649567404488,37.64342739559246,0.08203067664044739,5326.925583600998,598.5138266086578,4305.345112800598,35536,7975,27561,27561,0,31,7787000.0
7787,7787999,20.59597646609195,37.642440075332445,0.0820275380142661,5327.331617116928,598.5857095718384,4308.108380317688,35538,7975,27563,27563,0,31,7788000.0
7788,7788999,20.59537365178084,37.641473270520464,0.08202518125240399,5328.1637279987335,598.6585938930511,4309.495610237122,35540,7976,27564,27564,0,31,7789000.0
7789,7789999,20.595003918338747,37.64090929927702,0.08202127421584615,5329.092013835907,598.7307789325714,4310.302304267883,35544,7978,27566,27566,0,31,7790000.0
7790,7790999,20.59449479580612,37.63963669611214,0.08201947026942846,5329.805830717087,598.804603099823,4312.150456428528,35546,7979,27567,27567,0,31,7791000.0
7791,7791999,20.594356110463234,37.639005737631315,0.08201302799975352,5331.000241518021,598.8788750171661,4311.982029914856,35554,7983,27571,27571,0,31,7792000.0
7792,7792999,20.594587551425423,37.6389523633384,0.08201387127295323,5331.71164560318,598.951907157898,4313.895092964172,35558,7985,27573,27573,0,31,7793000.0
7793,7793999,20.595072332733285,37.640218427257594,0.08201755760084228,5333.370564222336,599.0256900787354,4311.576619148254,35576,7989,27587,27587,0,31,7794000.0
7794,7794999,20.59530335410389,37.640219643533804,0.08202875197027049,5334.426989555359,599.1008493900299,4311.817753791809,35591,7991,27600,27600,0,31,7795000.0
7795,7795999,20.59593509273269,37.640982564915944,0.08204572877668204,5335.046543836594,599.1745491027832,4314.122372627258,35593,7992,27601,27601,0,31,7796000.0
7796,7796999,20.59684789756261,37.64398609696619,0.08204679807577886,5336.226493835449,599.2529509067535,4314.058690071106,35597,7994,27603,27603,0,31,7797000.0
7797,7797999,20.597243181385775,37.644171037944005,0.08207873140577948,5337.135576963425,599.3278279304504,4314.9863176345825,35597,7994,27603,27603,0,31,7798000.0
7798,7798999,20.59768631667097,37.64451325114953,0.08209910338967041,5338.12371301651,599.4042265415192,4315.697522163391,35599,7995,27604,27604,0,31,7799000.0
7799,7799999,20.598140915015748,37.644910544875295,0.08210843991910788,5338.95853805542,599.4794118404388,4317.171353340149,35600,7995,27605,27605,0,31,7800000.0
7800,7800999,20.599071465336287,37.64630259951687,0.08212078333117967,5340.1635909080505,599.5562925338745,4316.656338691711,35600,7995,27605,27605,0,31,7801000.0
7801,7801999,20.599638540844136,37.646880173957435,0.08213356110465708,5341.298286676407,599.6325240135193,4316.555088996887,35604,7997,27607,27607,0,31,7802000.0
7802,7802999,20.600089450906765,37.64675218152715,0.08214187301331033,5343.580568552017,599.7959713935852,4317.113087654114,35606,7998,27608,27608,0,31,7803000.0
7803,7803999,20.60085298387504,37.64798518864679,0.08213543232521203,5344.639444351196,599.8666467666626,4317.088040351868,35610,8000,27610,27610,0,31,7804000.0
7804,7804999,20.601249100749513,37.64774965509018,0.08212378326532133,5345.358539581299,599.941294670105,4318.984639167786,35612,8001,27611,27611,0,31,7805000.0
7805,7805999,20.60124554717342,37.64762785489351,0.08212061365557954,5346.525322198868,600.0131421089172,4318.473698616028,35622,8003,27619,27619,0,31,7806000.0
7806,7806999,20.600624914755038,37.64899925431111,0.08210837208108335,5347.172114372253,600.0824801921844,4320.229268074036,35625,8004,27621,27621,0,31,7807000.0
7807,7807999,20.6000193049692,37.64822331402288,0.08210197706579536,5347.953825950623,600.1526529788971,4321.173916816711,35652,8006,27646,27646,0,31,7808000.0
7808,7808999,20.599271510398932,37.646705331513424,0.08210415110633296,5348.821506261826,600.2237462997437,4321.967923164368,35667,8009,27658,27658,0,31,7809000.0
7809,7809999,20.59862321384056,37.645264009764546,0.08209610322463545,5349.429879188538,600.2961723804474,4323.952954292297,35667,8009,27658,27658,0,31,7810000.0
7810,7810999,20.59825444444362,37.644463437674894,0.08208833474035859,5350.175121545792,600.3697483539581,4325.293889045715,35667,8009,27658,27658,0,31,7811000.0
7811,7811999,20.59819661043662,37.64385973071747,0.08207276491584592,5351.10059595108,600.4404647350311,4326.072583198547,35671,8011,27660,27660,0,31,7812000.0
7812,7812999,20.598671657328335,37.64405322526068,0.0820598881778678,5351.9008576869965,600.5119481086731,4327.296063423157,35676,8013,27663,27663,0,31,7813000.0
7813,7813999,20.599110009978872,37.64472060192522,0.08205622739350871,5353.000821352005,600.5858416557312,4327.342923164368,35684,8017,27667,27667,0,31,7814000.0
7814,7814999,20.59990428337055,37.64576910383665,0.08205809224674754,5353.93510890007,600.6601719856262,4328.245762825012,35695,8018,27677,27677,0,31,7815000.0
7815,7815999,20.600806519926476,37.64748373587688,0.08206186925476489,5355.277109861374,600.7332968711853,4327.114956855774,35701,8021,27680,27680,0,31,7816000.0
7816,7816999,20.601421627274135,37.64829114233767,0.08207979369349117,5356.362457513809,600.8062610626221,4327.351620674133,35712,8022,27690,27690,0,31,7817000.0
7817,7817999,20.601840859813056,37.6486705939904,0.08210558590452999,5357.737708091736,600.8800754547119,4325.593388557434,35716,8024,27692,27692,0,31,7818000.0
7818,7818999,20.602471593821726,37.650480283931614,0.08212470699490093,5358.635583400726,600.9539098739624,4326.294034004211,35720,8026,27694,27694,0,31,7819000.0
7819,7819999,20.603313040117868,37.651902075136746,0.08214593426836048,5359.039216995239,601.0256259441376,4329.493008613586,35720,8026,27694,27694,0,31,7820000.0
7820,7820999,20.603876299836177,37.652284118673585,0.08214876627890921,5359.735572338104,601.0978050231934,4331.425221443176,35720,8026,27694,27694,0,31,7821000.0
7821,7821999,20.6045814273953,37.653480510570674,0.08216097208195616,5360.781660318375,601.176903963089,4331.8187074661255,35722,8027,27695,27695,0,31,7822000.0
7822,7822999,20.605429785884862,37.65504177863487,0.08216727285161951,5361.799712181091,601.2560713291168,4332.43085193634,35724,8028,27696,27696,0,31,7823000.0
7823,7823999,20.606225764575733,37.65657091860869,0.08215955558253629,5363.107994556427,601.3332164287567,4331.286313056946,35724,8028,27696,27696,0,31,7824000.0
7824,7824999,20.60645938588486,37.65721277141535,0.08213447315233713,5363.594700098038,601.405149936676,4333.610318183899,35741,8028,27713,27713,0,31,7825000.0
7825,7825999,20.606366016469963,37.65680103823439,0.08212006703219299,5363.9918439388275,601.4754345417023,4336.5179262161255,35743,8028,27715,27715,0,31,7826000.0
7826,7826999,20.60627438162042,37.65597018332276,0.0821076673827863,5364.5438232421875,601.5458490848541,4339.110188484192,35745,8029,27716,27716,0,31,7827000.0
7827,7827999,20.6061000036862,37.65537182869363,0.08209204946289284,5365.84544301033,601.6175501346588,4337.966847419739,35764,8034,27730,27730,0,31,7828000.0
7828,7828999,20.605974915660283,37.65484315751087,0.08208019350730045,5366.5505084991455,601.6890807151794,4339.899914741516,35764,8034,27730,27730,0,31,7829000.0
7829,7829999,20.605745950094015,37.65376526261882,0.08207363429152681,5367.5088431835175,601.762458562851,4340.300488471985,35764,8034,27730,27730,0,31,7830000.0
7830,7830999,20.605441485861824,37.65262975221784,0.08206764392989352,5368.280866861343,601.8323283195496,4341.641903877258,35764,8034,27730,27730,0,31,7831000.0
7831,7831999,20.605196961257427,37.65168776874086,0.0820620049362143,5369.360643148422,601.9037342071533,4341.94477558136,35768,8036,27732,27732,0,31,7832000.0
7832,7832999,20.605106839939616,37.65110158713115,0.08205177655790108,5370.357874393463,601.9780008792877,4342.615834236145,35770,8037,27733,27733,0,31,7833000.0
7833,7833999,20.6050259383632,37.65038040299866,0.08205109277554712,5371.621659755707,602.0498313903809,4341.7290391922,35778,8041,27737,27737,0,31,7834000.0
7834,7834999,20.60462335213547,37.64929026266734,0.08205235285080248,5372.610634803772,602.1242339611053,4342.257885932922,35780,8042,27738,27738,0,31,7835000.0
7835,7835999,20.604244368873857,37.64814823460058,0.0820505855710576,5373.926344871521,602.1982800960541,4340.702305793762,35780,8042,27738,27738,0,31,7836000.0
7836,7836999,20.604009025964707,37.647127887448185,0.08205008106978573,5374.668541908264,602.2729279994965,4342.053967475891,35780,8042,27738,27738,0,31,7837000.0
7837,7837999,20.603646264733754,37.64598347432609,0.08204807393627667,5375.570287704468,602.3452732563019,4342.92645740509,35780,8042,27738,27738,0,31,7838000.0
7838,7838999,20.6034186412202,37.64508948016089,0.08204441657191208,5376.401445150375,602.4203345775604,4344.14318561554,35782,8043,27739,27739,0,31,7839000.0
7839,7839999,20.603142594446638,37.64396739407839,0.08204255583805753,5377.070207118988,602.49205327034,4346.059620857239,35782,8043,27739,27739,0,31,7840000.0
7840,7840999,20.60272960137421,37.642731843180094,0.08204283521302191,5378.51660990715,602.5670440196991,4344.224293708801,35784,8044,27740,27740,0,31,7841000.0
7841,7841999,20.602250782980267,37.64148339909738,0.08204078205426169,5379.524334192276,602.6441767215729,4344.314869880676,35784,8044,27740,27740,0,31,7842000.0
7842,7842999,20.60173302636279,37.64071638103675,0.08203879094040767,5380.234316825867,602.717036485672,4346.174580574036,35786,8045,27741,27741,0,31,7843000.0
7843,7843999,20.601487039248855,37.642151878031456,0.08203199280671758,5380.842285633087,602.7860951423645,4348.4881410598755,35791,8045,27746,27746,0,31,7844000.0
7844,7844999,20.601170479738546,37.641550977832196,0.0820258072592095,5381.790823936462,602.8549621105194,4348.471646308899,35797,8048,27749,27749,0,31,7845000.0
7845,7845999,20.600884882145607,37.641421305719255,0.08202635729119023,5383.0937168598175,602.9243566989899,4346.97358417511,35805,8052,27753,27753,0,31,7846000.0
7846,7846999,20.600886571436405,37.64199200824428,0.08202202247464108,5383.824821710587,602.9952013492584,4348.361615180969,35809,8054,27755,27755,0,31,7847000.0
7847,7847999,20.601339793631965,37.64328248185751,0.0820162261665105,5384.562599658966,603.0655512809753,4349.711491584778,35811,8055,27756,27756,0,31,7848000.0
7848,7848999,20.601601694704396,37.64369576411405,0.0820130281708028,5385.465572595596,603.137877702713,4350.245427131653,35813,8056,27757,27757,0,31,7849000.0
7849,7849999,20.60241561247962,37.6454891724507,0.08201465672457675,5386.420795202255,626.025710105896,4350.723515510559,35813,8056,27757,27757,0,31,7850000.0
7850,7850999,20.603396766627053,37.64730063963246,0.08202429571198322,5387.6032519340515,626.0995831489563,4350.298642158508,35817,8058,27759,27759,0,31,7851000.0
7851,7851999,20.60470640331812,37.64997441118535,0.08201846502244647,5388.503161907196,626.1742084026337,4351.1629457473755,35817,8058,27759,27759,0,31,7852000.0
7852,7852999,20.60645011740718,37.6543719835097,0.08202441451730791,5389.79176068306,626.247903585434,4350.022480964661,35821,8060,27761,27761,0,31,7853000.0
7853,7853999,20.608888631253695,37.66310429548042,0.08203844938080262,5390.585144519806,626.3235533237457,4351.40815448761,35821,8060,27761,27761,0,31,7854000.0
7854,7854999,20.61102360161942,37.668218662197965,0.08206807802347926,5391.676919698715,626.3995759487152,4351.336651802063,35825,8062,27763,27763,0,31,7855000.0
7855,7855999,20.612285800316634,37.66989313598615,0.08208793770571687,5392.691255807877,626.4733633995056,4351.586956977844,35825,8062,27763,27763,0,31,7856000.0
7856,7856999,20.614582897463407,37.674637924769165,0.08213625850143003,5393.924992799759,626.5486118793488,4350.792546272278,35845,8065,27780,27780,0,31,7857000.0
7857,7857999,20.616348265384165,37.678495029688335,0.08217177979245138,5394.807016611099,626.6216578483582,4351.452786445618,35847,8066,27781,27781,0,31,7858000.0
7858,7858999,20.618159006050632,37.68110555894934,0.08218945646210285,5395.955783128738,626.6947958469391,4350.86526966095,35852,8069,27783,27783,0,31,7859000.0
7859,7859999,20.62041919904865,37.68504997963365,0.08221809945880976,5396.583703756332,626.7686948776245,4352.9714250564575,35852,8069,27783,27783,0,31,7860000.0
7860,7860999,20.622498767357598,37.68858832019133,0.0822419866965588,5397.452406167984,626.8429646492004,4353.679699897766,35852,8069,27783,27783,0,31,7861000.0
7861,7861999,20.624430282336355,37.691685820452754,0.08226118779492664,5398.104575872421,626.9174273014069,4355.625546455383,35852,8069,27783,27783,0,31,7862000.0
7862,7862999,20.62553472619937,37.692822675373314,0.08223495371475464,5398.618526935577,626.9843058586121,4357.922619819641,35873,8069,27804,27804,0,31,7863000.0
7863,7863999,20.626873346584603,37.69577637172515,0.08221533543481285,5399.102913141251,627.0489773750305,4360.299557685852,35880,8070,27810,27810,0,31,7864000.0
7864,7864999,20.62801366635205,37.69787044098506,0.08220798149389708,5399.831433534622,627.1132915019989,4361.665486335754,35890,8073,27817,27817,0,31,7865000.0
7865,7865999,20.629246843799244,37.69962015377889,0.08220437035014982,5400.290235042572,627.1774842739105,4364.548283576965,35897,8074,27823,27823,0,31,7866000.0
7866,7866999,20.630156319428306,37.700513097181194,0.08220483846629933,5401.179057836533,627.241941690445,4365.515866279602,35902,8076,27826,27826,0,31,7867000.0
7867,7867999,20.631426636835535,37.70240523267599,0.08219903713996135,5402.447879552841,627.30859375,4364.511944770813,35908,8079,27829,27829,0,31,7868000.0
7868,7868999,20.63231452480113,37.70272593451939,0.08220299825116606,5403.1923570632935,627.3739395141602,4365.868680000305,35911,8080,27831,27831,0,31,7869000.0
7869,7869999,20.6333154706928,37.70332290567322,0.08221405428857276,5403.700138092041,627.4376096725464,4368.47829914093,35912,8080,27832,27832,0,31,7870000.0
7870,7870999,20.63457124581684,37.70479431663777,0.08222409800361907,5404.641386270523,627.5048379898071,4369.173733711243,35915,8081,27834,27834,0,31,7871000.0
7871,7871999,20.63586982804271,37.70645055622609,0.08224899511758099,5405.532208919525,627.5700311660767,4370.011609077454,35917,8082,27835,27835,0,31,7872000.0
7872,7872999,20.63733400962801,37.70821229001867,0.08226749827543767,5406.315393447876,627.6355798244476,4371.447232246399,35917,8082,27835,27835,0,31,7873000.0
7873,7873999,20.638893439516877,37.710200327115594,0.08228095012659642,5407.259665727615,627.701979637146,4372.255673408508,35933,8083,27850,27850,0,31,7874000.0
7874,7874999,20.64082223136991,37.71489527719418,0.082302684340265,5408.2084674835205,627.7691497802734,4372.849255561829,35935,8084,27851,27851,0,31,7875000.0
7875,7875999,20.642687065111335,37.71896465658568,0.08230934647710897,5409.270527839661,627.8365702629089,4373.154339790344,35937,8085,27852,27852,0,31,7876000.0
7876,7876999,20.644573724723408,37.72168679881498,0.08233311440898994,5410.955085039139,627.9036011695862,4370.1098985672,35960,8089,27871,27871,0,31,7877000.0
7877,7877999,20.646314527123717,37.723922439837594,0.08235549733131287,5411.57896566391,627.9703438282013,4372.045948982239,35960,8089,27871,27871,0,31,7878000.0
7878,7878999,20.648219244211017,37.7265757048556,0.08238818979604545,5412.684225797653,628.0361108779907,4372.009037971497,35964,8091,27873,27873,0,31,7879000.0
7879,7879999,20.649890098487916,37.72858220672021,0.0824203818797895,5413.608722448349,628.1035141944885,4372.784245491028,35966,8092,27874,27874,0,31,7880000.0
7880,7880999,20.65103628423732,37.72943141525305,0.08243023399791993,5414.313920021057,628.1687228679657,4374.690365791321,35966,8092,27874,27874,0,31,7881000.0
7881,7881999,20.651759374843493,37.72977482560401,0.08241077458958745,5415.190742492676,628.2321722507477,4375.092778205872,35982,8093,27889,27889,0,31,7882000.0
7882,7882999,20.651830059117405,37.72929591353614,0.08238745231061606,5415.682049036026,628.2960820198059,4377.234181404114,35985,8093,27892,27892,0,31,7883000.0
7883,7883999,20.65178457542785,37.729249806961896,0.0823769142450198,5416.189314126968,628.36048412323,4379.827000617981,35990,8093,27897,27897,0,31,7884000.0
7884,7884999,20.65155077477885,37.72851913216403,0.08236865829612672,5417.210928201675,628.4260492324829,4380.2039613723755,35998,8096,27902,27902,0,31,7885000.0
7885,7885999,20.651334862146605,37.72767422685639,0.08235999048957732,5418.013889789581,628.4933109283447,4381.628849983215,36003,8098,27905,27905,0,31,7886000.0
7886,7886999,20.651173289556183,37.72674797879308,0.08235245669612268,5419.243838787079,628.5600254535675,4380.69900226593,36009,8100,27909,27909,0,31,7887000.0
7887,7887999,20.651443660490838,37.72696764597739,0.0823414009565625,5419.889052152634,628.627717256546,4382.66685962677,36011,8101,27910,27910,0,31,7888000.0
7888,7888999,20.651391968459563,37.72628922986197,0.08233108260168909,5420.73033952713,628.6933913230896,4384.066334724426,36015,8103,27912,27912,0,31,7889000.0
7889,7889999,20.651662182078095,37.726004823793595,0.082324684683447,5421.551210641861,628.7587122917175,4385.424618721008,36027,8104,27923,27923,0,31,7890000.0
7890,7890999,20.651802519906287,37.72727629319656,0.08230988455670496,5422.530948162079,628.8267178535461,4386.273159980774,36029,8105,27924,27924,0,31,7891000.0
7891,7891999,20.65194103814245,37.72681896365969,0.08230608357892832,5423.589745044708,628.8954703807831,4386.686444282532,36029,8105,27924,27924,0,31,7892000.0
7892,7892999,20.652102176298285,37.72628500031012,0.0823029240316907,5424.521271467209,628.9615294933319,4387.751851081848,36029,8105,27924,27924,0,31,7893000.0
7893,7893999,20.65212906161553,37.72540991428228,0.0822992611562392,5425.487088680267,629.0304913520813,4388.374051094055,36029,8105,27924,27924,0,31,7894000.0
7894,7894999,20.652147380214615,37.72459039503054,0.0822960391248364,5426.343699455261,629.0972166061401,4389.623822212219,36031,8106,27925,27925,0,31,7895000.0
7895,7895999,20.651974069095868,37.72335251358753,0.08229715633374213,5427.429316043854,629.169055223465,4389.820942878723,36031,8106,27925,27925,0,31,7896000.0
7896,7896999,20.65180054297945,37.72209433846961,0.0822960888809312,5428.5609703063965,629.2379293441772,4389.736012458801,36033,8107,27926,27926,0,31,7897000.0
7897,7897999,20.651954688151367,37.721768704321356,0.08227831182567147,5429.43785738945,629.3038051128387,4390.432499885559,36059,8109,27950,27950,0,31,7898000.0
7898,7898999,20.651903616357124,37.72180978394934,0.08225371068790788,5429.95449090004,629.3671913146973,4392.575619697571,36066,8110,27956,27956,0,31,7899000.0
7899,7899999,20.65193452011818,37.721053684367114,0.08222979188786395,5430.657222986221,629.4341630935669,4394.320004463196,36071,8111,27960,27960,0,31,7900000.0
7900,7900999,20.651974832227754,37.720695138996284,0.08221371516137299,5431.482983112335,629.5012242794037,4395.635411262512,36078,8114,27964,27964,0,31,7901000.0
7901,7901999,20.651971018143037,37.71985056123375,0.0821987435110495,5432.263666391373,629.5694706439972,4397.220685005188,36080,8115,27965,27965,0,31,7902000.0
7902,7902999,20.65218087466377,37.719627096763894,0.08218486743994435,5433.470713376999,629.6368532180786,4396.850293159485,36098,8119,27979,27979,0,31,7903000.0
7903,7903999,20.652389678417325,37.71934963250541,0.08217885039112316,5434.650319337845,629.7031528949738,4396.441250801086,36107,8122,27985,27985,0,31,7904000.0
7904,7904999,20.652959479034582,37.72005854177338,0.08216980546108055,5435.578621149063,629.7717461585999,4397.259198188782,36109,8123,27986,27986,0,31,7905000.0
7905,7905999,20.653892570344915,37.721180362696614,0.082185683584444,5436.506041765213,629.8383946418762,4398.0835313797,36111,8124,27987,27987,0,31,7906000.0
7906,7906999,20.654744679455032,37.72493895657596,0.082192274343588,5437.305476903915,629.9057238101959,4399.541890144348,36111,8124,27987,27987,0,31,7907000.0
7907,7907999,20.65592589571114,37.728710160570344,0.08219718744419258,5438.0630123615265,629.9722805023193,4401.348477363586,36113,8125,27988,27988,0,31,7908000.0
7908,7908999,20.656847408029282,37.72994241599343,0.08219383227886434,5439.301048755646,630.0389111042023,4400.843754768372,36126,8127,27999,27999,0,31,7909000.0
7909,7909999,20.658102908311033,37.73228726673155,0.08219453637231877,5440.280228614807,630.104793548584,4401.5788469314575,36130,8129,28001,28001,0,31,7910000.0
7910,7910999,20.659344782558158,37.73423735049733,0.082187855752206,5441.430882692337,630.1748349666595,4401.523510932922,36132,8130,28002,28002,0,31,7911000.0
7911,7911999,20.661412245367,37.74750376234357,0.08216070824887955,5442.492522954941,630.2417631149292,4401.470845222473,36134,8131,28003,28003,0,31,7912000.0
7912,7912999,20.663162159974792,37.75054870130344,0.08217008244465585,5443.325361967087,630.3090145587921,4402.837529182434,36136,8132,28004,28004,0,31,7913000.0
7913,7913999,20.665424277728583,37.75468219332284,0.08218603444267158,5444.511319637299,630.3776412010193,4402.279858589172,36136,8132,28004,28004,0,31,7914000.0
7914,7914999,20.66708500156285,37.7574723463075,0.08219861251658578,5445.585613012314,630.4485080242157,4402.326024055481,36138,8133,28005,28005,0,31,7915000.0
7915,7915999,20.667335224593064,37.75738191251075,0.08219322776890636,5446.073175430298,630.5142648220062,4404.748913764954,36150,8133,28017,28017,0,31,7916000.0
7916,7916999,20.66710307574499,37.756818074205704,0.08218327909641077,5446.424675941467,630.5788199901581,4407.716938972473,36152,8133,28019,28019,0,31,7917000.0
7917,7917999,20.666940606487312,37.756154895036815,0.08217399799209613,5447.396649122238,630.6449584960938,4408.08327960968,36158,8134,28024,28024,0,31,7918000.0
7918,7918999,20.667194244154604,37.756480717367666,0.0821676935376402,5448.082036018372,630.712034702301,4410.154065132141,36160,8135,28025,28025,0,31,7919000.0
7919,7919999,20.667419380915934,37.75638699913604,0.08216489182748643,5448.910032272339,630.7801730632782,4411.2798891067505,36162,8136,28026,28026,0,31,7920000.0
7920,7920999,20.667778841292836,37.75634057554864,0.08216015559497591,5449.798175096512,630.8466212749481,4412.097943305969,36164,8137,28027,28027,0,31,7921000.0
7921,7921999,20.668185778008144,37.75632278224373,0.08216027700009854,5450.88699555397,630.9132509231567,4411.884564399719,36166,8138,28028,28028,0,31,7922000.0
7922,7922999,20.66907794203403,37.75743820648403,0.08216303425554727,5451.446825265884,630.9779992103577,4414.43687915802,36168,8139,28029,28029,0,31,7923000.0
7923,7923999,20.67010345312818,37.75881983019107,0.08215450208854469,5452.391118764877,631.0444128513336,4415.3484926223755,36168,8139,28029,28029,0,31,7924000.0
7924,7924999,20.670889250604038,37.7594339256288,0.08217245180461064,5453.408697605133,631.1109530925751,4415.594822883606,36168,8139,28029,28029,0,31,7925000.0
7925,7925999,20.671870532655877,37.7603544615604,0.08218498813675268,5454.197772026062,631.176685333252,4416.923542976379,36168,8139,28029,28029,0,31,7926000.0
7926,7926999,20.673136264217927,37.76416383304235,0.08218351266481227,5454.983183383942,631.2429873943329,4418.448712348938,36170,8140,28030,28030,0,31,7927000.0
7927,7927999,20.674290618906607,37.76526893047675,0.08220168354761337,5456.09225153923,631.3095624446869,4418.282292366028,36174,8142,28032,28032,0,31,7928000.0
7928,7928999,20.675616835967947,37.76679627975463,0.08220909035844026,5457.141829967499,631.3781366348267,4418.748478889465,36178,8144,28034,28034,0,31,7929000.0
7929,7929999,20.676860491993732,37.7692897423076,0.0822143601453551,5458.1561625003815,631.4436190128326,4418.93182849884,36178,8144,28034,28034,0,31,7930000.0
7930,7930999,20.678014456984293,37.77035984111985,0.08222517612797109,5459.072115898132,631.5092513561249,4419.616810798645,36178,8144,28034,28034,0,31,7931000.0
7931,7931999,20.6793994827522,37.77307971657247,0.08223185473898709,5460.319781303406,631.5791826248169,4418.628010749817,36178,8144,28034,28034,0,31,7932000.0
7932,7932999,20.68024584559211,37.77317069531859,0.08224240704244212,5461.0050892829895,631.643477678299,4420.4882707595825,36180,8145,28035,28035,0,31,7933000.0
7933,7933999,20.68077673669811,37.77394603033153,0.08222469992075021,5462.064178943634,631.7093484401703,4420.261075019836,36192,8145,28047,28047,0,31,7934000.0
7934,7934999,20.680548927596956,37.77339550880436,0.08221385297380546,5462.295614480972,631.7723414897919,4423.645924568176,36194,8145,28049,28049,0,31,7935000.0
7935,7935999,20.680245530392508,37.77287774406077,0.08220460263819729,5463.1031222343445,631.8367428779602,4424.547238349915,36198,8146,28052,28052,0,31,7936000.0
7936,7936999,20.680278639622315,37.77261318572165,0.0821978277744555,5463.535751819611,631.9001853466034,4427.242115974426,36198,8146,28052,28052,0,31,7937000.0
7937,7937999,20.68016684114252,37.77201597406687,0.08219146397456767,5464.24970126152,631.9647023677826,4428.85671710968,36200,8147,28053,28053,0,31,7938000.0
7938,7938999,20.680256311866213,37.77190760300862,0.08218099725740369,5465.143980979919,632.0301694869995,4429.47082233429,36202,8148,28054,28054,0,31,7939000.0
7939,7939999,20.68013524851138,37.77108399922395,0.0821763925866359,5466.0820960998535,632.0965542793274,4430.233456611633,36204,8149,28055,28055,0,31,7940000.0
7940,7940999,20.68006978022163,37.770333321332274,0.08217620643514112,5467.031222105026,632.161712884903,4430.853909492493,36208,8151,28057,28057,0,31,7941000.0
7941,7941999,20.68035452998953,37.77302369210589,0.08216041960608134,5468.258465766907,632.2289760112762,4430.174313545227,36219,8154,28065,28065,0,31,7942000.0
7942,7942999,20.680717955350993,37.77293387444487,0.08215762970828311,5469.183393001556,632.2959189414978,4430.873738288879,36221,8155,28066,28066,0,31,7943000.0
7943,7943999,20.681276457899905,37.77487314596516,0.08214800034129921,5470.171854019165,632.3657793998718,4431.258694648743,36221,8155,28066,28066,0,31,7944000.0
7944,7944999,20.68217728591282,37.77758608373568,0.08213473809244476,5470.725741386414,632.4319190979004,4433.823010444641,36221,8155,28066,28066,0,31,7945000.0
7945,7945999,20.68346073713961,37.77936406292552,0.08213388366267338,5471.629322528839,632.5008041858673,4434.67524433136,36221,8155,28066,28066,0,31,7946000.0
7946,7946999,20.684650309300146,37.780850926773496,0.08214101566191312,5472.767731428146,632.5666723251343,4434.558888435364,36223,8156,28067,28067,0,31,7947000.0
7947,7947999,20.68627573137476,37.78283158309833,0.08215295278284629,5473.544752836227,632.6357688903809,4436.5132875442505,36223,8156,28067,28067,0,31,7948000.0
7948,7948999,20.687812754065206,37.78432522588384,0.08216431949321545,5474.783120393753,632.7029044628143,4435.929867744446,36234,8159,28075,28075,0,31,7949000.0
7949,7949999,20.689466882193486,37.78749592355701,0.08217757358787137,5475.89066529274,632.7709636688232,4435.957089424133,36236,8160,28076,28076,0,31,7950000.0
7950,7950999,20.69051669947079,37.787974140791164,0.08219000155858813,5477.055806875229,632.8378338813782,4435.365979194641,36238,8161,28077,28077,0,31,7951000.0
7951,7951999,20.690783334094125,37.78724371127832,0.08218670577967557,5478.087349891663,632.9037654399872,4435.609791755676,36243,8161,28082,28082,0,31,7952000.0
7952,7952999,20.690766921938188,37.78702925300408,0.08217156281630977,5478.541023015976,632.9681124687195,4437.974385261536,36263,8162,28101,28101,0,31,7953000.0
7953,7953999,20.690754229549196,37.78734007363588,0.08216620105464512,5479.198023080826,633.0318253040314,4439.492207527161,36266,8163,28103,28103,0,31,7954000.0
7954,7954999,20.690960533155007,37.7872789601777,0.08215830060310791,5479.889397382736,633.0954782962799,4441.098561286926,36270,8165,28105,28105,0,31,7955000.0
7955,7955999,20.691351373123954,37.78792439789667,0.0821482729116273,5480.848895788193,633.1619839668274,4441.479207038879,36270,8165,28105,28105,0,31,7956000.0
7956,7956999,20.692013396750053,37.78919634821891,0.08214742646371431,5481.430073022842,633.2263576984406,4443.690632820129,36271,8165,28106,28106,0,31,7957000.0
7957,7957999,20.692834188040763,37.79069340433135,0.08214680522101947,5482.240058898926,633.2915880680084,4444.978177070618,36273,8166,28107,28107,0,31,7958000.0
7958,7958999,20.69345716550852,37.79150357506051,0.08214703171280635,5483.073250055313,633.3580114841461,4446.129811286926,36277,8168,28109,28109,0,31,7959000.0
7959,7959999,20.693786287770475,37.791664343813586,0.08214503143970264,5484.282620668411,633.4242415428162,4445.507626533508,36283,8171,28112,28112,0,31,7960000.0
7960,7960999,20.694504954685712,37.79293048607306,0.08215303878149849,5485.277831792831,633.4914872646332,4445.595273017883,36285,8172,28113,28113,0,31,7961000.0
7961,7961999,20.695158808568436,37.79508306987627,0.0821474248132622,5486.133052349091,633.5569415092468,4446.431729316711,36285,8172,28113,28113,0,31,7962000.0
7962,7962999,20.69593816494199,37.79666641591806,0.08214316944230127,5486.928895711899,633.6223475933075,4447.916569709778,36290,8173,28117,28117,0,31,7963000.0
7963,7963999,20.69633319178497,37.79731971497186,0.08213973712235989,5488.182398080826,633.6913588047028,4447.381505012512,36292,8174,28118,28118,0,31,7964000.0
7964,7964999,20.69748040118729,37.8012554797554,0.08213707536974002,5489.025515317917,633.7573029994965,4448.636746406555,36296,8176,28120,28120,0,31,7965000.0
7965,7965999,20.698166400037906,37.80227673517091,0.08213154907636444,5489.852323293686,633.825644493103,4449.9958238601685,36296,8176,28120,28120,0,31,7966000.0
7966,7966999,20.699198345132764,37.80358255776388,0.0821197980175633,5491.122015953064,633.8947973251343,4448.8270082473755,36296,8176,28120,28120,0,31,7967000.0
7967,7967999,20.70040564381131,37.806401925793885,0.08211350936464423,5491.9504199028015,633.9618697166443,4450.07905292511,36298,8177,28121,28121,0,31,7968000.0
7968,7968999,20.701244844533072,37.80734534225218,0.08210912100266199,5492.881711483002,634.0312557220459,4450.747891426086,36298,8177,28121,28121,0,31,7969000.0
7969,7969999,20.70149112507438,37.80809843143575,0.08208906259462034,5493.6384382247925,634.0981738567352,4451.829495429993,36307,8177,28130,28130,0,31,7970000.0
7970,7970999,20.70140871178549,37.807628847975366,0.08208022778386082,5493.98050737381,634.1612524986267,4454.691815376282,36309,8177,28132,28132,0,31,7971000.0
7971,7971999,20.701203400999333,37.80728962196991,0.08206994073870122,5494.788040161133,634.2296938896179,4455.741871833801,36314,8179,28135,28135,0,31,7972000.0
7972,7972999,20.700920485818433,37.80611289150448,0.08206266892180147,5495.368285417557,634.2961850166321,4458.173832893372,36316,8180,28136,28136,0,31,7973000.0
7973,7973999,20.700557361195713,37.80497880783071,0.08205655201295525,5496.5971076488495,634.3667373657227,4457.659497261047,36350,8184,28166,28166,0,31,7974000.0
7974,7974999,20.700288410548122,37.804091776723965,0.08205268034950852,5497.529903173447,634.4344108104706,4458.519551277161,36356,8187,28169,28169,0,31,7975000.0
7975,7975999,20.69994387644503,37.803179294400586,0.08204923333146763,5498.46205830574,634.4993467330933,4459.030552864075,36362,8189,28173,28173,0,31,7976000.0
7976,7976999,20.699600959877852,37.80210671347481,0.08204568797978529,5499.159171819687,634.5655899047852,4460.9726305007935,36364,8190,28174,28174,0,31,7977000.0
7977,7977999,20.699323909418684,37.803191081551034,0.0820333348095168,5500.388021945953,634.6321051120758,4460.600781440735,36370,8192,28178,28178,0,31,7978000.0
7978,7978999,20.69895844598024,37.80226942689727,0.08202784873613511,5501.391766548157,634.6975846290588,4460.6917543411255,36370,8192,28178,28178,0,31,7979000.0
7979,7979999,20.698517943130252,37.80096757644568,0.08202316937149357,5502.396737575531,634.763379573822,4460.793622016907,36370,8192,28178,28178,0,31,7980000.0
7980,7980999,20.698453699899662,37.80057000938604,0.0820158829276133,5503.355831861496,634.8360567092896,4461.340725898743,36372,8193,28179,28179,0,31,7981000.0
7981,7981999,20.69837025002662,37.80156948244257,0.08200237104571895,5504.381074666977,634.9044353961945,4461.522870063782,36374,8194,28180,28180,0,31,7982000.0
7982,7982999,20.698034418080688,37.80033887918148,0.08200035454751153,5505.141875505447,634.9716575145721,4462.933667182922,36374,8194,28180,28180,0,31,7983000.0
7983,7983999,20.69790315719126,37.79971324547714,0.08199743557069405,5506.240854978561,635.0389432907104,4462.955212593079,36376,8195,28181,28181,0,31,7984000.0
7984,7984999,20.697744476515023,37.79879902397923,0.08199291984682622,5506.913819551468,635.1065800189972,4464.912899971008,36376,8195,28181,28181,0,31,7985000.0
7985,7985999,20.697538056661937,37.79774595385413,0.08198897929373428,5508.14875459671,635.1761658191681,4464.298161506653,36382,8198,28184,28184,0,31,7986000.0
7986,7986999,20.697238383799366,37.796362322972676,0.08198669107667855,5509.170584201813,635.2436256408691,4464.391278266907,36382,8198,28184,28184,0,31,7987000.0
7987,7987999,20.697078085724858,37.79530251085493,0.08198533496885652,5510.104027509689,635.3132228851318,4465.0723695755005,36382,8198,28184,28184,0,31,7988000.0
7988,7988999,20.696659687675904,37.79397944068016,0.08198571023338175,5511.175361394882,635.3820624351501,4465.127552986145,36382,8198,28184,28184,0,31,7989000.0
7989,7989999,20.696358423720334,37.79278836813136,0.08197023641155832,5511.8513770103455,635.4482522010803,4466.716099739075,36404,8199,28205,28205,0,31,7990000.0
7990,7990999,20.696255030123158,37.79210023022358,0.08193948972137188,5512.273412466049,635.5119068622589,4469.540692329407,36407,8200,28207,28207,0,31,7991000.0
7991,7991999,20.69591793863854,37.79091691367668,0.08192450217530967,5513.0322279930115,635.5778906345367,4470.958668708801,36410,8201,28209,28209,0,31,7992000.0
7992,7992999,20.696031602459893,37.790371962733914,0.08189459606314642,5513.780121564865,635.6433482170105,4472.814045906067,36420,8203,28217,28217,0,31,7993000.0
7993,7993999,20.695895765992482,37.789718736914914,0.08187987525012408,5514.852298736572,635.7111852169037,4473.363484382629,36424,8205,28219,28219,0,31,7994000.0
7994,7994999,20.69608140152705,37.7892946459937,0.08186011007393934,5515.789582252502,635.7780544757843,4473.747654914856,36426,8206,28220,28220,0,31,7995000.0
7995,7995999,20.69628315759448,37.78884604977479,0.08185168054987468,5516.486643314362,635.846926689148,4475.692631721497,36428,8207,28221,28221,0,31,7996000.0
7996,7996999,20.696306710652294,37.788084145086984,0.08184297467437973,5517.067530155182,635.913578748703,4478.267880439758,36428,8207,28221,28221,0,31,7997000.0
7997,7997999,20.696610634942193,37.78801807119322,0.08183288275618583,5518.459781885147,635.9804570674896,4476.755948066711,36440,8210,28230,28230,0,31,7998000.0
7998,7998999,20.69674195607856,37.78753083928396,0.08182185840952594,5519.4583241939545,636.0482149124146,4476.884083747864,36446,8213,28233,28233,0,31,7999000.0
7999,7999999,20.69697283647306,37.78696762428516,0.08181057582258522,5520.4940094947815,636.1158215999603,4477.139401435852,36448,8214,28234,28234,0,31,8000000.0
8000,8000999,20.69714308763542,37.7864642861881,0.0818085187935994,5521.0757575035095,636.1841089725494,4479.819821357727,36479,8215,28264,28264,0,31,8001000.0
8001,8001999,20.6972785364732,37.78612713760586,0.08180350304783945,5522.246874570847,636.2516770362854,4479.298481941223,36479,8215,28264,28264,0,31,8002000.0
8002,8002999,20.69757382310535,37.785940218742326,0.08179385923232152,5523.348538398743,636.3190143108368,4479.153973579407,36479,8215,28264,28264,0,31,8003000.0
8003,8003999,20.697589982160093,37.78512428042867,0.08178586076655725,5524.300438642502,636.3865170478821,4479.942471504211,36479,8215,28264,28264,0,31,8004000.0
8004,8004999,20.697983858444076,37.78469373744315,0.08177197070793096,5524.921635627747,636.4548168182373,4482.473538398743,36479,8215,28264,28264,0,31,8005000.0
8005,8005999,20.69836655985319,37.78421791376785,0.08176019184478756,5526.301079750061,636.523847579956,4481.278485298157,36481,8216,28265,28265,0,31,8006000.0
8006,8006999,20.698513240746955,37.78341611333542,0.08175255575362528,5527.51390337944,636.5929052829742,4480.730397224426,36493,8217,28276,28276,0,31,8007000.0
8007,8007999,20.69868473970343,37.78259842635609,0.08174431680532723,5528.556513547897,636.6613318920135,4480.771306037903,36493,8217,28276,28276,0,31,8008000.0
8008,8008999,20.69863202952112,37.78157341208869,0.08173574886991741,5529.573128938675,636.7286746501923,4480.804814338684,36493,8217,28276,28276,0,31,8009000.0
8009,8009999,20.6983689867602,37.780444405219725,0.08172145793113794,5530.127121925354,636.7935993671417,4482.676289558411,36506,8217,28289,28289,0,31,8010000.0
8010,8010999,20.69780815634539,37.77926918393684,0.08171737108867994,5530.480735778809,636.8583371639252,4485.5400133132935,36508,8217,28291,28291,0,31,8011000.0
8011,8011999,20.69727810013711,37.778234395128145,0.08171538160205505,5530.988211154938,636.9251005649567,4488.056775093079,36508,8217,28291,28291,0,31,8012000.0
8012,8012999,20.696659293256314,37.77684972764215,0.08171565795791658,5531.793979644775,636.9908955097198,4489.18940448761,36520,8218,28302,28302,0,31,8013000.0
8013,8013999,20.69599006361664,37.77558287195034,0.08171580522523048,5532.540422677994,637.0560524463654,4490.726231575012,36524,8220,28304,28304,0,31,8014000.0
8014,8014999,20.695277997767192,37.774193826307126,0.08171644347401408,5533.755528688431,637.122528553009,4490.296193122864,36533,8224,28309,28309,0,31,8015000.0
8015,8015999,20.694683402323108,37.773052994514146,0.0817162718093074,5534.948046922684,637.1909148693085,4489.63244342804,36541,8228,28313,28313,0,31,8016000.0
8016,8016999,20.694287889593035,37.77234459187234,0.08171298419473194,5535.348983764648,637.256373167038,4492.8879137039185,36541,8228,28313,28313,0,31,8017000.0
8017,8017999,20.693773106182558,37.7712959073047,0.08171288979388536,5536.17781662941,637.3229608535767,4494.140988349915,36543,8229,28314,28314,0,31,8018000.0
8018,8018999,20.69325327580364,37.77033615656011,0.0817124123770443,5537.037885665894,637.389814376831,4495.442349433899,36547,8231,28316,28316,0,31,8019000.0
8019,8019999,20.692746665176465,37.769249235117094,0.08171322826181815,5538.137236595154,637.4567022323608,4495.630383491516,36575,8232,28343,28343,0,31,8020000.0
8020,8020999,20.692620033161834,37.77040047123309,0.08170019493334513,5539.4138152599335,637.5264208316803,4494.653080940247,36577,8233,28344,28344,0,31,8021000.0
8021,8021999,20.692103421634723,37.768977503590094,0.0817014890439236,5540.567315340042,637.5921387672424,4494.144642829895,36579,8234,28345,28345,0,31,8022000.0
8022,8022999,20.692028729989193,37.7706668413978,0.08169126745644828,5541.248509883881,637.6589317321777,4496.043942451477,36581,8235,28346,28346,0,31,8023000.0
8023,8023999,20.69174341948615,37.76990285731722,0.08169072858375925,5542.21347784996,637.7305133342743,4496.687039375305,36583,8236,28347,28347,0,31,8024000.0
8024,8024999,20.69127137256053,37.768464208488744,0.08169550594196195,5543.257123708725,637.7978241443634,4496.729329109192,36585,8237,28348,28348,0,31,8025000.0
8025,8025999,20.69089427163164,37.768641096877936,0.08166131034809054,5543.601442098618,637.8654613494873,4499.816967964172,36596,8237,28359,28359,0,31,8026000.0
8026,8026999,20.690204918790364,37.76788072985226,0.0816620309955417,5544.507345676422,637.9326341152191,4500.280858039856,36601,8239,28362,28362,0,31,8027000.0
8027,8027999,20.689557924851382,37.76695082546911,0.08166001709523407,5545.224209547043,638.0001354217529,4501.855969429016,36605,8241,28364,28364,0,31,8028000.0
8028,8028999,20.68879314377565,37.765675979557166,0.08166330894785923,5546.456137180328,638.0683128833771,4501.292950630188,36611,8244,28367,28367,0,31,8029000.0
8029,8029999,20.688215915556505,37.76474929771116,0.08166220183767203,5546.8319301605225,638.1336889266968,4504.574345588684,36611,8244,28367,28367,0,31,8030000.0
8030,8030999,20.687472485359123,37.763348938839684,0.08166472125084512,5547.755993127823,638.2012660503387,4505.368123054504,36615,8246,28369,28369,0,31,8031000.0
8031,8031999,20.68705424317545,37.76324967493022,0.08165674738308826,5548.56266784668,638.2679462432861,4506.878308296204,36619,8248,28371,28371,0,31,8032000.0
8032,8032999,20.68690633374583,37.76343888665465,0.08164517135455307,5549.396126508713,638.3331935405731,4507.854496955872,36621,8249,28372,28372,0,31,8033000.0
8033,8033999,20.686756776009126,37.763643625316185,0.08163527863643139,5550.108088970184,638.4014508724213,4509.787358283997,36623,8250,28373,28373,0,31,8034000.0
8034,8034999,20.686628110344806,37.76326224256783,0.0816319728395235,5551.346989154816,638.4720876216888,4509.137806892395,36625,8251,28374,28374,0,31,8035000.0
8035,8035999,20.68679418152864,37.763700274516026,0.08162244897705828,5552.325161218643,638.541276216507,4509.96356678009,36625,8251,28374,28374,0,31,8036000.0
8036,8036999,20.68718402855743,37.763978154927834,0.08161387066254244,5553.775394201279,638.6080527305603,4508.127461433411,36633,8255,28378,28378,0,31,8037000.0
8037,8037999,20.687626657575358,37.764660452106746,0.08160745994354923,5554.797654867172,638.6781923770905,4508.513958930969,36635,8256,28379,28379,0,31,8038000.0
8038,8038999,20.688772928564,37.767431455402,0.08159525415580038,5555.5142958164215,638.7518339157104,4510.458180427551,36635,8256,28379,28379,0,31,8039000.0
8039,8039999,20.689399328858507,37.76824578201251,0.08158897509918916,5556.243697881699,638.8187415599823,4512.408917427063,36645,8257,28388,28388,0,31,8040000.0
8040,8040999,20.690448942845514,37.769546413074565,0.08159147005768763,5557.48123383522,638.8898124694824,4511.800724983215,36657,8258,28399,28399,0,31,8041000.0
8041,8041999,20.69122079883972,37.77018859412961,0.08159139960125528,5558.748110532761,638.9585072994232,4510.731274604797,36657,8258,28399,28399,0,31,8042000.0
8042,8042999,20.69184243196509,37.77059560934258,0.08158988642792175,5559.332790136337,639.0273990631104,4513.25141620636,36657,8258,28399,28399,0,31,8043000.0
8043,8043999,20.691963157932268,37.77056434228367,0.08157910412835412,5559.947858810425,639.0925598144531,4515.491475105286,36673,8259,28414,28414,0,31,8044000.0
8044,8044999,20.691972214271917,37.772761160085004,0.08155144179741591,5560.409215211868,639.158281326294,4518.035489082336,36678,8260,28418,28418,0,31,8045000.0
8045,8045999,20.69148490449342,37.77303083113385,0.08154374924243557,5561.120375871658,639.2239995002747,4519.57440662384,36683,8262,28421,28421,0,31,8046000.0
8046,8046999,20.69131322328489,37.77414632021904,0.08152662135798727,5561.873711109161,639.2881321907043,4520.933659553528,36689,8265,28424,28424,0,31,8047000.0
8047,8047999,20.690913019641496,37.7736077868705,0.08152053960064531,5562.514624595642,639.356850862503,4523.076085090637,36689,8265,28424,28424,0,31,8048000.0
8048,8048999,20.690617378942186,37.77268434878416,0.08151417895175739,5563.421268224716,639.4234251976013,4523.986889839172,36691,8266,28425,28425,0,31,8049000.0
8049,8049999,20.69035160897282,37.77197916428177,0.0815046607970511,5564.602767944336,639.4897999763489,4523.303540229797,36694,8267,28427,28427,0,31,8050000.0
8050,8050999,20.690094161875784,37.771189444191045,0.08150396464474985,5565.1111307144165,639.5547540187836,4525.8554582595825,36696,8268,28428,28428,0,31,8051000.0
8051,8051999,20.68989178180777,37.77070203308405,0.08149620154531612,5565.794496297836,639.6200997829437,4527.769902229309,36698,8269,28429,28429,0,31,8052000.0
8052,8052999,20.68964279196865,37.7703153396142,0.08149153390719333,5566.810364246368,639.6874895095825,4528.214436531067,36698,8269,28429,28429,0,31,8053000.0
8053,8053999,20.689454635268564,37.7698345192241,0.0814881940567711,5567.490940093994,639.7527530193329,4529.98929309845,36698,8269,28429,28429,0,31,8054000.0
8054,8054999,20.689523885540606,37.77012854854942,0.08148176792857942,5568.655529499054,639.8204584121704,4529.595875740051,36698,8269,28429,28429,0,31,8055000.0
8055,8055999,20.689734404075526,37.77045350544759,0.08148091225909027,5569.850111722946,639.8889262676239,4528.767643928528,36700,8270,28430,28430,0,31,8056000.0
8056,8056999,20.689891858490213,37.7702573192807,0.08147973788029561,5570.64754152298,639.9602501392365,4530.0848207473755,36702,8271,28431,28431,0,31,8057000.0
8057,8057999,20.690269446975122,37.770486182598916,0.08147657225490335,5571.539430141449,640.0294849872589,4531.329495429993,36706,8273,28433,28433,0,31,8058000.0
8058,8058999,20.690791516528275,37.77188308593213,0.08148068674686959,5572.642634868622,640.0999093055725,4531.412114143372,36710,8275,28435,28435,0,31,8059000.0
8059,8059999,20.691574601079047,37.77476166354375,0.08147591509659713,5573.683123588562,640.1670961380005,4531.541867256165,36712,8276,28436,28436,0,31,8060000.0
8060,8060999,20.69201029615023,37.77500326879442,0.0814825878175015,5574.83543920517,640.2361054420471,4531.1237535476685,36712,8276,28436,28436,0,31,8061000.0
8061,8061999,20.692418065762237,37.77497454315225,0.08149206472716508,5575.627484321594,640.3060319423676,4532.407269477844,36712,8276,28436,28436,0,31,8062000.0
8062,8062999,20.692403865948155,37.7743470252297,0.08149141652164815,5576.739727735519,640.3734362125397,4532.283528327942,36712,8276,28436,28436,0,31,8063000.0
8063,8063999,20.692811870598455,37.7750035999298,0.08145800700392103,5577.389468431473,640.4384772777557,4533.889691352844,36731,8277,28454,28454,0,31,8064000.0
8064,8064999,20.69322834951202,37.77581682322454,0.08143675284807339,5577.769447803497,640.5040197372437,4536.727917671204,36734,8277,28457,28457,0,31,8065000.0
8065,8065999,20.69345196735377,37.77577373479359,0.08142108819461225,5578.197504281998,640.5703299045563,4539.60826587677,36735,8277,28458,28458,0,31,8066000.0
8066,8066999,20.693823419498067,37.775529799055015,0.0814022217142708,5578.744620800018,640.6370785236359,4542.2009019851685,36737,8278,28459,28459,0,31,8067000.0
8067,8067999,20.69442517906121,37.77593354637421,0.08139957505432482,5579.589393615723,640.7034358978271,4543.3019914627075,36743,8281,28462,28462,0,31,8068000.0
8068,8068999,20.695249949851906,37.77745931925086,0.08140448513896792,5580.522810220718,640.769942522049,4543.978909492493,36750,8283,28467,28467,0,31,8069000.0
8069,8069999,20.69661948674014,37.77995837675711,0.08141520196020513,5584.088854074478,640.9200675487518,4544.244992256165,36757,8285,28472,28472,0,31,8070000.0
8070,8070999,20.697913962598587,37.78212745796981,0.08144574165212681,5585.446057319641,641.0658645629883,4546.196591377258,36757,8285,28472,28472,0,31,8071000.0
8071,8071999,20.69971428021189,37.78584493951833,0.08149153171766743,5587.704571962357,641.2113645076752,4545.723408699036,36761,8287,28474,28474,0,31,8072000.0
8072,8072999,20.701828172452903,37.78997258960444,0.08154430888985464,5588.771486997604,641.285089969635,4546.281544685364,36765,8289,28476,28476,0,31,8073000.0
8073,8073999,20.70407936622877,37.79411007038477,0.0815971898272646,5590.435405254364,641.4069097042084,4546.598729133606,36765,8289,28476,28476,0,31,8074000.0
8074,8074999,20.70583789777789,37.79751579451775,0.08165764208743431,5592.58359837532,641.5290191173553,4545.893429756165,36773,8291,28482,28482,0,31,8075000.0
8075,8075999,20.70799205552346,37.802517172090205,0.0817091036710419,5593.878122806549,641.6316564083099,4547.050656318665,36779,8294,28485,28485,0,31,8076000.0
8076,8076999,20.710319374697683,37.80835520837254,0.08178408460138475,5595.89720416069,641.7346787452698,4546.449345588684,36797,8298,28499,28499,0,31,8077000.0
8077,8077999,20.712976774474097,37.81356231075761,0.08184833508552203,5597.300239086151,641.8305494785309,4547.258870124817,36797,8298,28499,28499,0,31,8078000.0
8078,8078999,20.715897752074387,37.82160033559263,0.08193262616476349,5598.60001039505,641.9381132125854,4548.58279132843,36797,8298,28499,28499,0,31,8079000.0
8079,8079999,20.719032725257073,37.82819828782263,0.08201398531968807,5599.921518325806,642.044840335846,4549.304348945618,36799,8299,28500,28500,0,31,8080000.0
8080,8080999,20.72021098196944,37.82920082233251,0.08203283946240703,5601.340421199799,642.1545915603638,4550.379979133606,36814,8300,28514,28514,0,31,8081000.0
8081,8081999,20.721214227034384,37.83225632277738,0.08201167790182873,5601.73583483696,642.2667367458344,4553.753193855286,36817,8300,28517,28517,0,31,8082000.0
8082,8082999,20.721988291174156,37.834017228051266,0.08200535797924258,5602.791829824448,642.3595440387726,4554.713040351868,36822,8302,28520,28520,0,31,8083000.0
8083,8083999,20.722949379230666,37.8363682983196,0.08198616510491197,5604.152911424637,642.45880818367,4555.527173042297,36829,8305,28524,28524,0,31,8084000.0
8084,8084999,20.7238868968254,37.837872415388354,0.08197179119803955,5605.112001419067,642.5662925243378,4558.008717536926,36830,8305,28525,28525,0,31,8085000.0
8085,8085999,20.724723255289792,37.839917369040556,0.08195345513958086,5606.326510190964,642.6757867336273,4559.554127693176,36830,8305,28525,28525,0,31,8086000.0
8086,8086999,20.725393450942462,37.84062119335593,0.08195368497567512,5607.865334033966,642.7738013267517,4559.748791694641,36832,8306,28526,28526,0,31,8087000.0
8087,8087999,20.72613187637309,37.84129979336208,0.08194461744956028,5609.163317680359,642.8848526477814,4561.3298082351685,36832,8306,28526,28526,0,31,8088000.0
8088,8088999,20.727036419943737,37.84235561628537,0.08194216828301493,5610.545914649963,642.9790277481079,4561.513195991516,36832,8306,28526,28526,0,31,8089000.0
8089,8089999,20.728170948543546,37.84412314940896,0.08194100234774804,5612.054858446121,643.0792899131775,4561.629269599915,36836,8308,28528,28528,0,31,8090000.0
8090,8090999,20.729387165271085,37.84594903155816,0.08194145056071633,5612.991758108139,643.1659698486328,4563.593167304993,36838,8308,28530,28530,0,31,8091000.0
8091,8091999,20.73090003242738,37.85068571928606,0.08193243407120065,5614.458683013916,643.2806613445282,4564.319180488586,36839,8308,28531,28531,0,31,8092000.0
8092,8092999,20.731918011717926,37.85162776625383,0.08193404843342766,5615.813204050064,643.3743212223053,4565.260830879211,36839,8308,28531,28531,0,31,8093000.0
8093,8093999,20.733368356174022,37.85444085203016,0.08193070987256779,5617.471798181534,643.4677381515503,4564.984936714172,36845,8311,28534,28534,0,31,8094000.0
8094,8094999,20.735114866547978,37.85773218730231,0.08194166566726957,5619.266055345535,643.5831522941589,4564.988728523254,36850,8312,28538,28538,0,31,8095000.0
8095,8095999,20.736965552041205,37.86184707572815,0.0819435611714977,5621.309186458588,643.7003316879272,4564.608326911926,36856,8315,28541,28541,0,31,8096000.0
8096,8096999,20.738820352732574,37.865483447914556,0.0819534742349799,5622.437772274017,643.7931914329529,4565.636036872864,36868,8316,28552,28552,0,31,8097000.0
8097,8097999,20.740444532175754,37.868181740816595,0.08195755532963511,5623.655235528946,643.8900148868561,4566.948903083801,36868,8316,28552,28552,0,31,8098000.0
8098,8098999,20.742131811362263,37.87086063238554,0.08197427355724907,5625.468160390854,644.0020372867584,4567.208165168762,36868,8316,28552,28552,0,31,8099000.0
8099,8099999,20.74336119241764,37.87287102375484,0.08192413625951944,5626.104593515396,644.0908446311951,4569.613835334778,36882,8316,28566,28566,0,31,8100000.0
8100,8100999,20.743467280755095,37.87255084057203,0.08188408899079658,5626.928513050079,644.1933233737946,4571.240849494934,36885,8317,28568,28568,0,31,8101000.0
8101,8101999,20.74366246838872,37.87259733940072,0.08185538493408384,5627.889909029007,644.3033695220947,4573.372014045715,36887,8318,28569,28569,0,31,8102000.0
8102,8102999,20.744130340557202,37.87296364071305,0.08181391174574393,5629.278451919556,644.400768995285,4573.972935676575,36904,8321,28583,28583,0,31,8103000.0
8103,8103999,20.744298511414595,37.87245970823051,0.08179379559024913,5630.64203453064,644.5083889961243,4574.723187446594,36908,8323,28585,28585,0,31,8104000.0
8104,8104999,20.744683923598426,37.872872199829324,0.08173796543277778,5631.493960618973,644.6175713539124,4577.50182056427,36908,8323,28585,28585,0,31,8105000.0
8105,8105999,20.744659104144723,37.87292989148986,0.08170486343502392,5632.873648405075,644.7327315807343,4578.767987251282,36910,8324,28586,28586,0,31,8106000.0
8106,8106999,20.745064085244252,37.87273179461616,0.0816586277114335,5633.891347408295,644.8197619915009,4580.242611885071,36913,8325,28588,28588,0,31,8107000.0
8107,8107999,20.74555852280801,37.87325218775645,0.08161127364171161,5635.508482217789,644.9236543178558,4580.540280342102,36915,8326,28589,28589,0,31,8108000.0
8108,8108999,20.745587213473325,37.87253240751495,0.08159313549264502,5637.433272123337,645.0399804115295,4580.455815315247,36915,8326,28589,28589,0,31,8109000.0
8109,8109999,20.745949552394713,37.872377291898665,0.081565596869418,5638.81467795372,645.1538844108582,4581.906376838684,36917,8327,28590,28590,0,31,8110000.0
8110,8110999,20.746168400654156,37.871961051329315,0.08155576738262205,5640.623091459274,645.2342710494995,4580.198773384094,36922,8329,28593,28593,0,31,8111000.0
8111,8111999,20.746455464179725,37.871623473071594,0.08154299752295413,5641.669330120087,645.3217220306396,4581.521466255188,36925,8330,28595,28595,0,31,8112000.0
8112,8112999,20.746794151848395,37.871626501413246,0.08153128633974771,5642.8622610569,645.4239399433136,4582.857579231262,36925,8330,28595,28595,0,31,8113000.0
8113,8113999,20.746960358334594,37.871097791384564,0.08152457829941673,5644.185965061188,645.520055770874,4583.578900337219,36927,8331,28596,28596,0,31,8114000.0
8114,8114999,20.747286712766886,37.87072774881141,0.08151895396055997,5645.603196382523,645.6048529148102,4583.29584980011,36934,8334,28600,28600,0,31,8115000.0
8115,8115999,20.747539284315504,37.87024411173173,0.08151859179881471,5647.223012924194,645.686625957489,4582.185429573059,36936,8335,28601,28601,0,31,8116000.0
8116,8116999,20.747955850401475,37.87122470368313,0.08151136850436447,5648.434311628342,645.7715065479279,4582.635273933411,36938,8336,28602,28602,0,31,8117000.0
8117,8117999,20.748185315349122,37.87050063502994,0.08150616170485314,5649.68088388443,645.8619158267975,4583.144680976868,36940,8337,28603,28603,0,31,8118000.0
8118,8118999,20.748562499611246,37.87003238488164,0.08149772945684408,5650.653008699417,645.9454953670502,4584.458401679993,36940,8337,28603,28603,0,31,8119000.0
8119,8119999,20.74904686686794,37.872081391177545,0.08145494909157946,5651.406055927277,646.0272164344788,4586.500638008118,36953,8338,28615,28615,0,31,8120000.0
8120,8120999,20.749547750630274,37.87395315015396,0.08130608028993902,5651.814154624939,646.1025333404541,4589.323750495911,36956,8339,28617,28617,0,31,8121000.0
8121,8121999,20.750033143722842,37.87566793747358,0.0811824285028645,5652.711703777313,646.1802577972412,4590.802960395813,36962,8342,28620,28620,0,31,8122000.0
8122,8122999,20.750306633658354,37.87617759211884,0.08110086748505141,5653.797925949097,646.2693462371826,4592.017315864563,36965,8343,28622,28622,0,31,8123000.0
8123,8123999,20.750467639954724,37.87631651765025,0.08104005389258695,5654.981303215027,646.3474781513214,4592.400860786438,36967,8344,28623,28623,0,31,8124000.0
8124,8124999,20.750802409505457,37.87661624488613,0.08097922457510498,5656.112810850143,646.4306042194366,4593.32896900177,36969,8345,28624,28624,0,31,8125000.0
8125,8125999,20.751373726615647,37.87886925906613,0.08090299365702969,5657.5623660087585,646.5166845321655,4593.157521247864,36975,8348,28627,28627,0,31,8126000.0
8126,8126999,20.75145479099185,37.87869550776585,0.08085464826035649,5658.411551237106,646.5885319709778,4594.6336488723755,36975,8348,28627,28627,0,31,8127000.0
8127,8127999,20.751722447109014,37.87904161468284,0.08080494086963907,5659.182156085968,646.6696786880493,4596.6564683914185,36975,8348,28627,28627,0,31,8128000.0
8128,8128999,20.752013704203144,37.879118234505626,0.08076432166677894,5661.032024383545,646.7813944816589,4596.4289293289185,36979,8350,28629,28629,0,31,8129000.0
8129,8129999,20.752080105907933,37.87860874948292,0.0807283591024548,5662.865948915482,646.8979940414429,4596.490704536438,36983,8352,28631,28631,0,31,8130000.0
8130,8130999,20.752658494746647,37.879390485886454,0.08069259232805936,5663.8050656318665,646.9756309986115,4597.962803840637,36985,8353,28632,28632,0,31,8131000.0
8131,8131999,20.75312443523994,37.8821296588514,0.08065430831401321,5665.0246369838715,647.0531394481659,4597.98254108429,36985,8353,28632,28632,0,31,8132000.0
8132,8132999,20.753543201211457,37.88207796542506,0.08062424798405743,5665.812581539154,647.1364438533783,4599.891026496887,36987,8354,28633,28633,0,31,8133000.0
8133,8133999,20.753877377550754,37.881951798663444,0.08060476661033678,5667.51087641716,647.2242465019226,4598.424527168274,36995,8358,28637,28637,0,31,8134000.0
8134,8134999,20.754288533214737,37.88184886803709,0.0805794421554672,5668.442124605179,647.298172712326,4599.677884101868,36999,8360,28639,28639,0,31,8135000.0
8135,8135999,20.754675705866216,37.88184804107802,0.08056322938400273,5669.523774385452,647.3865909576416,4600.997738838196,36999,8360,28639,28639,0,31,8136000.0
8136,8136999,20.75519654710777,37.88179092637315,0.08055026296032819,5670.629524946213,647.466445684433,4601.589077949524,37001,8361,28640,28640,0,31,8137000.0
8137,8137999,20.755545501184375,37.881453855186614,0.08053753732086288,5672.382144212723,647.5653591156006,4601.013104438782,37003,8362,28641,28641,0,31,8138000.0
8138,8138999,20.75615667765352,37.88133272468888,0.08051505593109498,5673.418016672134,647.649421453476,4602.303021430969,37003,8362,28641,28641,0,31,8139000.0
8139,8139999,20.756152007682093,37.88051862353206,0.08050485462161128,5674.9381947517395,647.7270267009735,4601.061169624329,37005,8363,28642,28642,0,31,8140000.0
8140,8140999,20.75663616643272,37.880871089918806,0.08045138715873401,5675.360501527786,647.8043665885925,4603.971531867981,37018,8363,28655,28655,0,31,8141000.0
8141,8141999,20.757143682793977,37.88131850192442,0.08039911076167938,5675.903436899185,647.8809258937836,4606.402134895325,37018,8363,28655,28655,0,31,8142000.0
8142,8142999,20.757508870955974,37.88142335789349,0.08036109324290741,5676.694196939468,647.9592158794403,4608.019604682922,37022,8365,28657,28657,0,31,8143000.0
8143,8143999,20.75748279571216,37.88090512922482,0.08033944616558941,5678.0261924266815,648.0725963115692,4609.31782245636,37024,8366,28658,28658,0,31,8144000.0
8144,8144999,20.75780313385945,37.88136001809678,0.08030837113375311,5678.99582028389,648.155065536499,4610.662930488586,37028,8368,28660,28660,0,31,8145000.0
8145,8145999,20.75785479412018,37.88102824467144,0.08028786328747473,5680.225268602371,648.2317633628845,4610.789578437805,37034,8370,28664,28664,0,31,8146000.0
8146,8146999,20.758084578279796,37.88081758960907,0.08026924308754435,5681.251478433609,648.3103079795837,4611.535496711731,37038,8372,28666,28666,0,31,8147000.0
8147,8147999,20.758237569198915,37.88046120687168,0.08025183457882745,5682.065241575241,648.389240026474,4613.52175617218,37038,8372,28666,28666,0,31,8148000.0
8148,8148999,20.758756567339628,37.88090447454671,0.08023341440923382,5683.0004942417145,648.4734823703766,4615.450810432434,37040,8373,28667,28667,0,31,8149000.0
8149,8149999,20.75925548305106,37.881566449740916,0.08022050778757428,5684.302631139755,648.5607173442841,4616.103405952454,37046,8376,28670,28670,0,31,8150000.0
8150,8150999,20.759726607195308,37.88226819844368,0.08020761010068544,5685.741751432419,648.6370351314545,4615.218312263489,37050,8378,28672,28672,0,31,8151000.0
8151,8151999,20.760374073853434,37.88320934399549,0.08020071050823985,5687.377216339111,648.7474155426025,4615.556118965149,37050,8378,28672,28672,0,31,8152000.0
8152,8152999,20.761062992135916,37.88492335969614,0.08019239661826894,5688.355998277664,648.8302404880524,4616.946438789368,37054,8380,28674,28674,0,31,8153000.0
8153,8153999,20.76188888534805,37.886856940943325,0.08018694978432406,5689.422585725784,648.9091951847076,4617.72651386261,37056,8381,28675,28675,0,31,8154000.0
8154,8154999,20.76304130694719,37.888303098673624,0.0802110747118766,5690.509684801102,648.9905874729156,4618.624684333801,37060,8383,28677,28677,0,31,8155000.0
8155,8155999,20.763726995804042,37.88855022325483,0.0802231723028255,5691.624673366547,649.0726556777954,4619.000432014465,37062,8384,28678,28678,0,31,8156000.0
8156,8156999,20.764309029952383,37.88903388170972,0.0802146793280154,5692.327381372452,649.152459859848,4621.346356391907,37070,8384,28686,28686,0,31,8157000.0
8157,8157999,20.76497545537817,37.89067150160654,0.08018344525320797,5692.574347496033,649.2275741100311,4624.792538642883,37073,8384,28689,28689,0,31,8158000.0
8158,8158999,20.765979798211347,37.89503911820637,0.08015499492365752,5693.606678009033,649.3277056217194,4626.705868721008,37087,8386,28701,28701,0,31,8159000.0
8159,8159999,20.76669067607458,37.896533208176265,0.08013529418939225,5694.335656642914,649.4027528762817,4628.549771308899,37091,8388,28703,28703,0,31,8160000.0
8160,8160999,20.767457738833365,37.89732156406329,0.08011129076166434,5695.493583202362,649.4838387966156,4629.11909198761,37097,8391,28706,28706,0,31,8161000.0
8161,8161999,20.767785171494776,37.89745596184837,0.08010226452896296,5698.4906005859375,649.6859223842621,4628.892071723938,37099,8392,28707,28707,0,31,8162000.0
8162,8162999,20.768238620204407,37.89781506832214,0.08008980071479732,5699.734558343887,649.7763125896454,4629.6153383255005,37105,8395,28710,28710,0,31,8163000.0
8163,8163999,20.768896507602545,37.8987135675277,0.08007776882470596,5700.568720340729,649.8469228744507,4630.948002815247,37107,8396,28711,28711,0,31,8164000.0
8164,8164999,20.76957185283575,37.89933448470309,0.0800620492372437,5701.5450801849365,649.9206309318542,4631.909054756165,37116,8398,28718,28718,0,31,8165000.0
8165,8165999,20.769987179435926,37.89954304874214,0.08005839326514164,5702.3074288368225,649.9922466278076,4633.873860359192,37118,8399,28719,28719,0,31,8166000.0
8166,8166999,20.771011583169134,37.90454464468717,0.08004153587981033,5703.841996431351,650.070130109787,4632.616742134094,37124,8402,28722,28722,0,31,8167000.0
8167,8167999,20.77222433049465,37.9071909410277,0.08004109179854524,5705.212756872177,650.1456959247589,4631.587010383606,37128,8404,28724,28724,0,31,8168000.0
8168,8168999,20.773811317702357,37.9104548483089,0.08003111313730171,5706.107706069946,650.2205724716187,4632.927670478821,37130,8405,28725,28725,0,31,8169000.0
8169,8169999,20.775502183025225,37.91364178749271,0.08002819561673291,5707.287582397461,650.2967405319214,4633.451313972473,37134,8407,28727,28727,0,31,8170000.0
8170,8170999,20.777733098790552,37.920415087888266,0.08002420585263237,5708.1521809101105,650.3736205101013,4634.822690010071,37134,8407,28727,28727,0,31,8171000.0
8171,8171999,20.7795628760096,37.923723493067854,0.08003529638227158,5708.910644292831,650.469722032547,4637.388806343079,37134,8407,28727,28727,0,31,8172000.0
8172,8172999,20.781258024692125,37.92710311369179,0.08004194457194558,5710.031015872955,650.5513215065002,4638.038296699524,37136,8408,28728,28728,0,31,8173000.0
8173,8173999,20.78265249066701,37.929811276925264,0.08004518758310164,5711.384179830551,650.6324126720428,4637.254933357239,37140,8410,28730,28730,0,31,8174000.0
8174,8174999,20.783516002789103,37.931257855076254,0.08004699673578419,5712.670524835587,650.7181468009949,4638.149930000305,37156,8411,28745,28745,0,31,8175000.0
8175,8175999,20.78351096202314,37.931636137249434,0.08002137682366628,5713.267859220505,650.7909908294678,4639.857808113098,37162,8413,28749,28749,0,31,8176000.0
8176,8176999,20.78331460278092,37.930859027784244,0.0800145852904871,5714.285286426544,650.8683016300201,4640.45511341095,37167,8415,28752,28752,0,31,8177000.0
8177,8177999,20.78328041232796,37.93076937942352,0.08000753456110576,5714.786714553833,650.9437065124512,4643.239521980286,37167,8415,28752,28752,0,31,8178000.0
8178,8178999,20.78334710237329,37.93041844993312,0.07999627236691809,5715.42156791687,651.0131690502167,4645.2820863723755,37167,8415,28752,28752,0,31,8179000.0
8179,8179999,20.783403347056097,37.93069080443189,0.07998796139775044,5757.531861543655,651.1862773895264,4646.563054084778,37169,8416,28753,28753,0,31,8180000.0
8180,8180999,20.78349140860385,37.930382467861484,0.07998231930288091,5758.8223288059235,651.2577140331268,4645.956021308899,37177,8420,28757,28757,0,31,8181000.0
8181,8181999,20.783747173763317,37.93020708543609,0.07997859218363956,5759.585290193558,651.3282175064087,4647.84304523468,37181,8422,28759,28759,0,31,8182000.0
8182,8182999,20.784239190757553,37.93060036211168,0.07997769515797137,5760.442982196808,651.3975756168365,4649.198002815247,37185,8424,28761,28761,0,31,8183000.0
8183,8183999,20.784979161449268,37.93172233048572,0.07998407258880003,5761.278506278992,651.4683492183685,4650.541958808899,37187,8425,28762,28762,0,31,8184000.0
8184,8184999,20.785903682697484,37.932882364314935,0.07999502934569758,5762.3549699783325,651.5395731925964,4650.739056587219,37189,8426,28763,28763,0,31,8185000.0
8185,8185999,20.786469873793898,37.933447171385474,0.08001282634828366,5763.1123468875885,651.6108212471008,4652.681569099426,37191,8427,28764,28764,0,31,8186000.0
8186,8186999,20.78752111450928,37.93470396098487,0.08002724684955298,5764.830380678177,651.6826713085175,4650.284192085266,37195,8429,28766,28766,0,31,8187000.0
8187,8187999,20.788717861789028,37.936334206040186,0.08004172712418522,5765.998950719833,651.75408244133,4650.133503913879,37201,8432,28769,28769,0,31,8188000.0
8188,8188999,20.789932070482294,37.937984009232515,0.08007205722720123,5766.683239936829,651.8239777088165,4652.307812690735,37213,8433,28780,28780,0,31,8189000.0
8189,8189999,20.790949680481596,37.939073519502905,0.08009636991742952,5767.90833067894,651.8971090316772,4651.83312702179,37213,8433,28780,28780,0,31,8190000.0
8190,8190999,20.792312773884404,37.94163613869509,0.08013231350054595,5768.744212388992,651.9687705039978,4653.12170124054,37215,8434,28781,28781,0,31,8191000.0
8191,8191999,20.7939661302805,37.94410540076734,0.08017041074686693,5769.882554531097,652.0429260730743,4653.244740486145,37215,8434,28781,28781,0,31,8192000.0
8192,8192999,20.79554366257704,37.94800460470782,0.08019955530022438,5770.876202583313,652.1139550209045,4653.7700090408325,37215,8434,28781,28781,0,31,8193000.0
8193,8193999,20.79664856174758,37.94892331741883,0.0802309103752451,5771.948818683624,652.188191652298,4653.930859565735,37215,8434,28781,28781,0,31,8194000.0
8194,8194999,20.79707470428712,37.94967616124729,0.08023661980198926,5773.171739578247,652.2606475353241,4653.221982002258,37235,8436,28799,28799,0,31,8195000.0
8195,8195999,20.796974099274628,37.95051391195683,0.08021307609120554,5773.543079137802,652.3288156986237,4656.165349006653,37241,8436,28805,28805,0,31,8196000.0
8196,8196999,20.796742951251208,37.95059551633917,0.08019650617271523,5774.584641218185,652.3990159034729,4656.444996833801,37258,8439,28819,28819,0,31,8197000.0
8197,8197999,20.79654718796339,37.94993205823195,0.08017883474279075,5775.059250593185,652.4688785076141,4659.159306526184,37258,8439,28819,28819,0,31,8198000.0
8198,8198999,20.79636120372744,37.94928110827264,0.08016406722350977,5775.47808098793,652.5379333496094,4662.413365364075,37258,8439,28819,28819,0,31,8199000.0
8199,8199999,20.79627092678811,37.94868317021234,0.08015101916560297,5776.733035564423,652.6107976436615,4661.932370185852,37266,8443,28823,28823,0,31,8200000.0
8200,8200999,20.79589837326872,37.94750121817295,0.08014232261614096,5777.687695264816,652.681489944458,4662.967000007629,37270,8445,28825,28825,0,31,8201000.0
8201,8201999,20.795907178104653,37.94913737832073,0.08012159216677273,5778.435645341873,652.7531585693359,4665.01704120636,37272,8446,28826,28826,0,31,8202000.0
8202,8202999,20.795640342593497,37.94817901790555,0.08011342537734323,5779.465587377548,652.8250358104706,4665.471859931946,37274,8447,28827,28827,0,31,8203000.0
8203,8203999,20.795655662534262,37.947641513481706,0.08010553572431689,5780.167678833008,652.8953704833984,4667.439229011536,37274,8447,28827,28827,0,31,8204000.0
8204,8204999,20.79557490442576,37.94703535112232,0.08010643410919283,5781.415906190872,652.9701421260834,4667.163289070129,37276,8448,28828,28828,0,31,8205000.0
8205,8205999,20.795573051416703,37.94654043571285,0.08010376670710329,5782.410905599594,653.0440676212311,4667.879193305969,37290,8450,28840,28840,0,31,8206000.0
8206,8206999,20.795699831532776,37.9463552551191,0.0801052915418975,5783.931549310684,653.11696600914,4666.063588142395,37308,8454,28854,28854,0,31,8207000.0
8207,8207999,20.796111031676023,37.949072268199075,0.08009027237859523,5784.347336769104,653.1882717609406,4669.26874256134,37308,8454,28854,28854,0,31,8208000.0
8208,8208999,20.796222670531822,37.94867967532918,0.08008906909035685,5785.352847099304,653.2609384059906,4670.127324104309,37312,8456,28856,28856,0,31,8209000.0
8209,8209999,20.796328886878356,37.94849491363867,0.08009426814444442,5786.080552101135,653.3323903083801,4672.126553535461,37312,8456,28856,28856,0,31,8210000.0
8210,8210999,20.796483115465236,37.94812043548312,0.08009390150012119,5787.243055820465,653.4063422679901,4672.172993659973,37314,8457,28857,28857,0,31,8211000.0
8211,8211999,20.796681252330202,37.94773513320529,0.08009461859987799,5788.533104896545,653.4790916442871,4671.616612434387,37323,8459,28864,28864,0,31,8212000.0
8212,8212999,20.796641648671876,37.94696043611911,0.08009774713870899,5789.647113323212,653.5525443553925,4671.66637134552,37329,8460,28869,28869,0,31,8213000.0
8213,8213999,20.79662634958345,37.946091042639246,0.0800967972197133,5790.610533237457,653.6273698806763,4672.569165229797,37331,8461,28870,28870,0,31,8214000.0
8214,8214999,20.796555013198255,37.94589646857665,0.08008846425513771,5791.357205629349,653.6988353729248,4674.208256721497,37345,8461,28884,28884,0,31,8215000.0
8215,8215999,20.796331677080776,37.945066722157605,0.08006179497906574,5791.801795721054,653.7624659538269,4676.462483406067,37353,8462,28891,28891,0,31,8216000.0
8216,8216999,20.796177733643727,37.94512627409644,0.08004069329001284,5792.492248773575,653.827116727829,4677.927548408508,37357,8464,28893,28893,0,31,8217000.0
8217,8217999,20.795665559976374,37.944140547156024,0.08003618986601757,5793.332051992416,653.892507314682,4678.936322212219,37361,8466,28895,28895,0,31,8218000.0
8218,8218999,20.795021321752557,37.942734236447315,0.08003299618710635,5793.970110177994,653.9592323303223,4680.87316608429,37365,8468,28897,28897,0,31,8219000.0
8219,8219999,20.794618656971377,37.941585039832276,0.08003145603955142,5794.350297451019,654.0232639312744,4684.1049699783325,37365,8468,28897,28897,0,31,8220000.0
8220,8220999,20.794156832435114,37.94058286758162,0.08002776558920333,5795.239052295685,654.0934352874756,4685.433888435364,37367,8469,28898,28898,0,31,8221000.0
8221,8221999,20.793599218963518,37.93933753224177,0.08002434142917914,5797.772198200226,654.2433567047119,4684.536679267883,37373,8472,28901,28901,0,31,8222000.0
8222,8222999,20.793321955413642,37.938566074049106,0.08001927540664411,5799.243199825287,654.3762984275818,4685.208630561829,37375,8473,28902,28902,0,31,8223000.0
8223,8223999,20.793035141459494,37.93796773420612,0.08001051033208195,5800.8202538490295,654.5601758956909,4687.727940559387,37377,8474,28903,28903,0,31,8224000.0
8224,8224999,20.79256756648351,37.936994361289194,0.08000690291358326,5802.100327968597,654.6265127658844,4686.9013566970825,37381,8476,28905,28905,0,31,8225000.0
8225,8225999,20.792165287706847,37.93593264098732,0.08000378325384905,5803.0531985759735,654.6952407360077,4687.562909126282,37383,8477,28906,28906,0,31,8226000.0
8226,8226999,20.792021045518265,37.935245397500694,0.08000223425800967,5803.996566534042,654.763231754303,4688.250302314758,37385,8478,28907,28907,0,31,8227000.0
8227,8227999,20.79192202631362,37.93474964589343,0.07999481832808641,5804.703703403473,654.8296940326691,4689.904477119446,37387,8479,28908,28908,0,31,8228000.0
8228,8228999,20.792017969698648,37.93446119690897,0.07998864816596585,5806.032681941986,654.8960852622986,4688.797245979309,37391,8481,28910,28910,0,31,8229000.0
8229,8229999,20.792483143876357,37.93459965425209,0.07997803231857181,5806.889031410217,654.9650762081146,4690.07384967804,37395,8483,28912,28912,0,31,8230000.0
8230,8230999,20.792864816283494,37.934579437817845,0.07997609907762093,5807.741106033325,655.0319509506226,4691.396649360657,37399,8485,28914,28914,0,31,8231000.0
8231,8231999,20.793301718855222,37.93447919324014,0.07997205414869935,5808.917580127716,655.103194475174,4691.423886299133,37413,8487,28926,28926,0,31,8232000.0
8232,8232999,20.793470659681542,37.93420181207472,0.07996831898271106,5810.191493988037,655.1704769134521,4690.253712654114,37413,8487,28926,28926,0,31,8233000.0
8233,8233999,20.79364971234524,37.9336324680331,0.07996355345357153,5811.347850322723,655.2413003444672,4689.689373970032,37413,8487,28926,28926,0,31,8234000.0
8234,8234999,20.793547279772334,37.934165287685005,0.07995738125534169,5812.024297714233,655.3093059062958,4691.608235359192,37413,8487,28926,28926,0,31,8235000.0
8235,8235999,20.79361964590818,37.93455682839959,0.07993983621273082,5812.3805639743805,655.374101638794,4694.572911262512,37429,8487,28942,28942,0,31,8236000.0
8236,8236999,20.79333248153778,37.933769623430926,0.07992867973127382,5813.350275278091,655.4412975311279,4694.795308113098,37433,8489,28944,28944,0,31,8237000.0
8237,8237999,20.79318324386743,37.93401243666321,0.07991379809422028,5814.47500872612,655.5086081027985,4694.70209980011,37443,8494,28949,28949,0,31,8238000.0
8238,8238999,20.793021269898684,37.93410513774279,0.07990603807627272,5814.994017839432,655.5758202075958,4697.353009223938,37445,8495,28950,28950,0,31,8239000.0
8239,8239999,20.792994510409176,37.93359360458105,0.07989353421022438,5815.846745491028,655.643049955368,4698.480626106262,37449,8497,28952,28952,0,31,8240000.0
8240,8240999,20.793012774286623,37.93356743222908,0.07988239329359281,5816.539489269257,655.7102150917053,4700.459561347961,37451,8498,28953,28953,0,31,8241000.0
8241,8241999,20.79298618848365,37.932932946964485,0.07988612565052411,5817.6200523376465,655.7773995399475,4700.611409187317,37457,8501,28956,28956,0,31,8242000.0
8242,8242999,20.79293439832196,37.932357512598614,0.07988286667578004,5818.662578344345,655.8435559272766,4700.832669258118,37461,8503,28958,28958,0,31,8243000.0
8243,8243999,20.79287283165256,37.93166228945434,0.07988840629396954,5819.589140892029,655.9127938747406,4701.6489000320435,37463,8504,28959,28959,0,31,8244000.0
8244,8244999,20.793006554716325,37.9316106109369,0.07987980291924457,5820.63320350647,655.9810724258423,4701.894658088684,37465,8505,28960,28960,0,31,8245000.0
8245,8245999,20.793218642065394,37.93161847646286,0.07987787457406914,5821.394080400467,656.0487060546875,4703.248303413391,37465,8505,28960,28960,0,31,8246000.0
8246,8246999,20.79341342486717,37.93158871270934,0.07988751124022664,5822.371947288513,656.117823600769,4704.206654548645,37467,8506,28961,28961,0,31,8247000.0
8247,8247999,20.793642082136703,37.931411304670235,0.07988394338019422,5823.558704137802,656.1853275299072,4703.564785957336,37469,8507,28962,28962,0,31,8248000.0
8248,8248999,20.79430600148342,37.933692802306744,0.07988332009453847,5824.576199531555,656.2553536891937,4703.501049995422,37471,8508,28963,28963,0,31,8249000.0
8249,8249999,20.794797621055558,37.93392701039736,0.07988808435535999,5825.180436134338,656.3253030776978,4706.059018135071,37471,8508,28963,28963,0,31,8250000.0
8250,8250999,20.795371919784923,37.93407683161116,0.07989167190715218,5826.323698043823,656.3928463459015,4706.035450935364,37489,8512,28977,28977,0,31,8251000.0
8251,8251999,20.79632314390247,37.9355014834613,0.07989665787335276,5827.078438043594,656.4598259925842,4707.961720466614,37491,8513,28978,28978,0,31,8252000.0
8252,8252999,20.797084706797616,37.936688976533354,0.07990558321396846,5828.624850988388,656.5347547531128,4706.0971574783325,37495,8515,28980,28980,0,31,8253000.0
8253,8253999,20.79797381153565,37.93735701950587,0.07991909159464361,5829.417834043503,656.6023271083832,4707.704724311829,37495,8515,28980,28980,0,31,8254000.0
8254,8254999,20.79863463535677,37.93739479504713,0.07992048681953756,5830.465429544449,656.673796415329,4708.389470100403,37504,8517,28987,28987,0,31,8255000.0
8255,8255999,20.799121808184193,37.938859480109684,0.07987931345104982,5831.2547862529755,656.7407510280609,4709.209767341614,37518,8518,29000,29000,0,31,8256000.0
8256,8256999,20.79964906697753,37.93962538240115,0.07987785132422265,5832.291935682297,656.8069887161255,4709.307003974915,37525,8521,29004,29004,0,31,8257000.0
8257,8257999,20.800706612177585,37.94142954355953,0.07987861846554889,5832.8519678115845,656.8725144863129,4711.425557136536,37527,8522,29005,29005,0,31,8258000.0
8258,8258999,20.801627997772865,37.945578492086966,0.079871905334443,5833.681554317474,656.9409618377686,4712.906636238098,37529,8523,29006,29006,0,31,8259000.0
8259,8259999,20.80260951417467,37.94707514751956,0.07987881681571718,5834.523179531097,657.0075159072876,4714.028691291809,37531,8524,29007,29007,0,31,8260000.0
8260,8260999,20.803404137796875,37.94775384777376,0.07988808401775593,5835.144938468933,657.0744707584381,4716.049801826477,37531,8524,29007,29007,0,31,8261000.0
8261,8261999,20.804575226113865,37.94922472130669,0.07990069584886939,5835.667155742645,657.1409933567047,4718.742672920227,37531,8524,29007,29007,0,31,8262000.0
8262,8262999,20.80563393294525,37.95025073792674,0.07990550374604721,5836.385744094849,657.2083942890167,4720.667012214661,37531,8524,29007,29007,0,31,8263000.0
8263,8263999,20.80694919812471,37.95169261507384,0.07991580614337335,5837.289350509644,657.2806439399719,4722.0483293533325,37531,8524,29007,29007,0,31,8264000.0
8264,8264999,20.80807211519187,37.95403719265531,0.07991963606147667,5839.16474032402,657.3487756252289,4718.413578987122,37541,8529,29012,29012,0,31,8265000.0
8265,8265999,20.80920657029423,37.95544239087185,0.0799417864508929,5839.853341817856,657.4146211147308,4720.035870552063,37543,8530,29013,29013,0,31,8266000.0
8266,8266999,20.810528649317,37.95698480180714,0.07995940520346057,5840.832262277603,657.4815661907196,4720.492337226868,37549,8533,29016,29016,0,31,8267000.0
8267,8267999,20.811732650460925,37.95817784886562,0.07998208031948384,5841.685847997665,657.5468134880066,4721.979771614075,37551,8534,29017,29017,0,31,8268000.0
8268,8268999,20.81309067455629,37.95980916001708,0.0800111385803276,5842.645815849304,657.6156558990479,4722.833783149719,37555,8536,29019,29019,0,31,8269000.0
8269,8269999,20.814891248804962,37.963483317391706,0.08004504436113524,5843.686084270477,657.6814312934875,4722.966755867004,37557,8537,29020,29020,0,31,8270000.0
8270,8270999,20.81622185902895,37.96454577613707,0.08007622044952001,5844.617880344391,657.7518224716187,4723.671322822571,37557,8537,29020,29020,0,31,8271000.0
8271,8271999,20.81778356607934,37.96595209081526,0.08010547665910384,5845.743494510651,657.8224267959595,4723.390042304993,37559,8538,29021,29021,0,31,8272000.0
8272,8272999,20.81923354286055,37.96705805523532,0.08013758851065755,5846.75053691864,657.8919246196747,4723.659489631653,37561,8539,29022,29022,0,31,8273000.0
8273,8273999,20.81998900004278,37.96804569187626,0.08012152733234024,5847.554562807083,657.9572396278381,4724.658467292786,37573,8539,29034,29034,0,31,8274000.0
8274,8274999,20.82012013650702,37.97107036542145,0.08001852941756205,5848.080985784531,658.0199229717255,4726.477581977844,37576,8539,29037,29037,0,31,8275000.0
8275,8275999,20.81990190657869,37.97119524931763,0.08001060606410415,5848.531737804413,658.0865025520325,4729.241864204407,37578,8540,29038,29038,0,31,8276000.0
8276,8276999,20.81973220189015,37.97174290818501,0.079999556254432,5849.357517004013,658.1503956317902,4730.2622423172,37609,8541,29068,29068,0,31,8277000.0
8277,8277999,20.819674173046373,37.97154341779636,0.07999276707938974,5850.189790487289,658.2164680957794,4731.2642641067505,37611,8542,29069,29069,0,31,8278000.0
8278,8278999,20.819514243827328,37.97126325316515,0.07998478356714545,5851.178900718689,658.2815034389496,4731.919331550598,37619,8546,29073,29073,0,31,8279000.0
8279,8279999,20.81961838803359,37.971008725494045,0.07997651788284499,5852.241757392883,658.3487470149994,4731.756154060364,37625,8549,29076,29076,0,31,8280000.0
8280,8280999,20.820015093470047,37.971577243248454,0.07996986936937811,5852.876742362976,658.4137399196625,4733.839116096497,37633,8550,29083,29083,0,31,8281000.0
8281,8281999,20.820238514917484,37.97149545082436,0.07996407729914423,5853.6317348480225,658.48002576828,4735.322781562805,37633,8550,29083,29083,0,31,8282000.0
8282,8282999,20.820488182290273,37.97149927640761,0.07995797297847362,5854.433231830597,658.5464565753937,4736.7253313064575,37635,8551,29084,29084,0,31,8283000.0
8283,8283999,20.82099997764353,37.97195298223671,0.07995831298883282,5855.662272691727,658.6125485897064,4736.400532722473,37639,8553,29086,29086,0,31,8284000.0
8284,8284999,20.82148314776,37.9722334747581,0.07995288845911797,5856.723166465759,658.6838912963867,4736.497197151184,37639,8553,29086,29086,0,31,8285000.0
8285,8285999,20.821955561933752,37.97224453053876,0.07995746571161,5858.5004551410675,658.7512049674988,4733.100781440735,37651,8559,29092,29092,0,31,8286000.0
8286,8286999,20.822280886513806,37.97217113719795,0.07995430576194096,5858.877074718475,658.8187413215637,4736.335751533508,37651,8559,29092,29092,0,31,8287000.0
8287,8287999,20.82265733912154,37.972006371067685,0.07995612941227004,5859.812784433365,658.885418176651,4737.11429309845,37655,8561,29094,29094,0,31,8288000.0
8288,8288999,20.822933759251267,37.971898588140974,0.07995524477977622,5861.053143501282,658.953605890274,4736.2435121536255,37660,8563,29097,29097,0,31,8289000.0
8289,8289999,20.823020601645933,37.97118264065133,0.07995332114477305,5861.674753189087,659.0198199748993,4738.187497138977,37660,8563,29097,29097,0,31,8290000.0
8290,8290999,20.823229670724317,37.97279202476496,0.079924412450874,5862.005344867706,659.0844056606293,4741.334515571594,37672,8563,29109,29109,0,31,8291000.0
8291,8291999,20.82297424937649,37.97200417036265,0.07991140230312455,5862.480181455612,659.1476187705994,4743.598340034485,37674,8564,29110,29110,0,31,8292000.0
8292,8292999,20.822810731058794,37.971926297125144,0.07990218081534073,5862.815624952316,659.2132081985474,4746.862225532532,37674,8564,29110,29110,0,31,8293000.0
8293,8293999,20.822649719127153,37.97126931626123,0.07989431792672086,5863.65709733963,659.2775888442993,4747.732502937317,37676,8565,29111,29111,0,31,8294000.0
8294,8294999,20.822661307020812,37.970908075844164,0.07988323406939446,5864.987834692001,659.3431775569916,4746.203061103821,37689,8569,29120,29120,0,31,8295000.0
8295,8295999,20.822621515180934,37.97091138690614,0.07987727625455632,5865.686720371246,659.4077553749084,4747.966519355774,37691,8570,29121,29121,0,31,8296000.0
8296,8296999,20.822689869424927,37.971139841182115,0.07986877863724084,5866.502915143967,659.4722793102264,4749.243977546692,37693,8571,29122,29122,0,31,8297000.0
8297,8297999,20.82282148987468,37.97111391094876,0.07985910998435375,5867.135635852814,659.5381231307983,4751.206128120422,37693,8571,29122,29122,0,31,8298000.0
8298,8298999,20.823046543048502,37.97127854537369,0.07984849670830652,5867.943841218948,659.604814529419,4752.556813240051,37695,8572,29123,29123,0,31,8299000.0
8299,8299999,20.823182665187076,37.97095968613395,0.07983955274469245,5869.003100395203,659.6707112789154,4752.877133369446,37699,8574,29125,29125,0,31,8300000.0
8300,8300999,20.8235175934012,37.971794174949636,0.07983415459399834,5870.435758113861,659.7369282245636,4751.038418769836,37705,8577,29128,29128,0,31,8301000.0
8301,8301999,20.82379889111291,37.971691218364576,0.07982249720138201,5871.078301668167,659.8037114143372,4753.052342414856,37707,8578,29129,29129,0,31,8302000.0
8302,8302999,20.824207396253136,37.972140726001925,0.07981079488595688,5871.965291500092,659.8681356906891,4753.791676521301,37709,8579,29130,29130,0,31,8303000.0
8303,8303999,20.824422887038608,37.97218653966131,0.07980063011820049,5872.588025569916,659.9363489151001,4756.1408586502075,37709,8579,29130,29130,0,31,8304000.0
8304,8304999,20.82459705173748,37.97205640849825,0.07979279922884996,5873.528851985931,660.0038034915924,4756.879002571106,37711,8580,29131,29131,0,31,8305000.0
8305,8305999,20.824974989919678,37.972148275218935,0.07977935507302991,5874.49210691452,660.0704326629639,4757.264912605286,37713,8581,29132,29132,0,31,8306000.0
8306,8306999,20.825281120097216,37.9720290368839,0.07976687233999247,5875.766240358353,660.1372561454773,4756.3071184158325,37721,8585,29136,29136,0,31,8307000.0
8307,8307999,20.825551682692005,37.97260801176401,0.0797527100280776,5876.544080495834,660.2033987045288,4757.660687446594,37721,8585,29136,29136,0,31,8308000.0
8308,8308999,20.825385769720853,37.97172015714213,0.07974529074125913,5877.771728277206,660.2709465026855,4756.926915168762,37725,8587,29138,29138,0,31,8309000.0
8309,8309999,20.82561109976195,37.97163496391647,0.07972377806964948,5878.545345783234,660.3376998901367,4757.924855232239,37752,8588,29164,29164,0,31,8310000.0
8310,8310999,20.82566493664974,37.971368893054546,0.07968933719761107,5879.094655513763,660.4033906459808,4759.750164985657,37753,8588,29165,29165,0,31,8311000.0
8311,8311999,20.82602817384074,37.97196668231244,0.07965413928518317,5880.258456945419,660.4709157943726,4759.296536445618,37759,8591,29168,29168,0,31,8312000.0
8312,8312999,20.826439893590102,37.97254491918348,0.07960799179078881,5880.831752300262,660.5361511707306,4761.366665840149,37761,8592,29169,29169,0,31,8313000.0
8313,8313999,20.826748938293132,37.973093711172034,0.07956938362360766,5881.330813169479,660.601761341095,4763.944127082825,37761,8592,29169,29169,0,31,8314000.0
8314,8314999,20.827392107515955,37.97342068241955,0.07954225998413544,5881.905200481415,660.6669385433197,4766.593312263489,37763,8593,29170,29170,0,31,8315000.0
8315,8315999,20.827894921523157,37.973794900644656,0.07952062091975565,5883.456201791763,660.7334544658661,4764.926182746887,37814,8599,29215,29215,0,31,8316000.0
8316,8316999,20.828164410842277,37.973881882192615,0.0795072418415298,5884.599091053009,660.8007326126099,4765.01939868927,37822,8603,29219,29219,0,31,8317000.0
8317,8317999,20.828520608662206,37.97370798396487,0.07949107905697128,5885.333580732346,660.8662815093994,4766.786923408508,37826,8605,29221,29221,0,31,8318000.0
8318,8318999,20.828836027513752,37.97356630811663,0.0794793185100886,5886.242076635361,660.9343321323395,4767.74612903595,37826,8605,29221,29221,0,31,8319000.0
8319,8319999,20.829623601486695,37.97412792298935,0.07947012997999137,5887.2235605716705,661.0036437511444,4768.5735902786255,37830,8607,29223,29223,0,31,8320000.0
8320,8320999,20.830282957698817,37.97470007760577,0.0794546580509724,5888.320049524307,661.070164680481,4768.7437562942505,37844,8609,29235,29235,0,31,8321000.0
8321,8321999,20.830727841163196,37.97498007448599,0.07943270402214542,5889.584681272507,661.1384258270264,4767.621113777161,37846,8610,29236,29236,0,31,8322000.0
8322,8322999,20.83142104959167,37.97539010884385,0.07941892355062996,5890.681866168976,661.2059187889099,4767.291096687317,37852,8613,29239,29239,0,31,8323000.0
8323,8323999,20.831960518574682,37.97588459093945,0.07941323025803937,5891.38312792778,661.2717719078064,4769.20339679718,37854,8614,29240,29240,0,31,8324000.0
8324,8324999,20.832477750921882,37.97610582949243,0.07940202505852323,5892.46666932106,661.3388636112213,4769.271168708801,37858,8616,29242,29242,0,31,8325000.0
8325,8325999,20.832994479771,37.9761958359128,0.07939409062738068,5893.387356758118,661.4084827899933,4770.022259712219,37870,8617,29253,29253,0,31,8326000.0
8326,8326999,20.833613400959702,37.97680638288836,0.07939573485207507,5894.35061955452,661.4761290550232,4770.349484443665,37872,8618,29254,29254,0,31,8327000.0
8327,8327999,20.834323826220412,37.977500286832736,0.07940097926913725,5895.5726437568665,661.5472266674042,4769.8545961380005,37874,8619,29255,29255,0,31,8328000.0
8328,8328999,20.834685955589297,37.977488154381284,0.07940270932471694,5896.766782283783,661.6173102855682,4769.066052436829,37878,8621,29257,29257,0,31,8329000.0
8329,8329999,20.834864509047794,37.97814369710871,0.07938878867764332,5897.176832437515,661.6825630664825,4771.982914924622,37896,8621,29275,29275,0,31,8330000.0
8330,8330999,20.835075039158685,37.977822813719946,0.07936662535000649,5897.64177441597,661.7491865158081,4774.27712726593,37902,8621,29281,29281,0,31,8331000.0
8331,8331999,20.835196612082992,37.978095274093235,0.07935831387687253,5898.451118469238,661.8146183490753,4775.171345710754,37908,8623,29285,29285,0,31,8332000.0
8332,8332999,20.83560901790368,37.97911327662031,0.07934832281720439,5899.019872665405,661.880734205246,4777.367207527161,37910,8624,29286,29286,0,31,8333000.0
8333,8333999,20.835840139520432,37.97873043939173,0.07935708182181933,5899.900910615921,661.947536945343,4778.280850410461,37914,8626,29288,29288,0,31,8334000.0
8334,8334999,20.836389322720812,37.979742540235776,0.07936515574889214,5900.632299661636,662.0124747753143,4779.969784736633,37916,8627,29289,29289,0,31,8335000.0
8335,8335999,20.83674981457966,37.97975834976282,0.07937787043607925,5901.555655241013,662.0808613300323,4780.757992744446,37918,8628,29290,29290,0,31,8336000.0
8336,8336999,20.8373380943166,37.980287311766986,0.07939295037170002,5902.316383361816,662.1468684673309,4782.047917366028,37918,8628,29290,29290,0,31,8337000.0
8337,8337999,20.83798643187998,37.98103851983952,0.07940708607580227,5902.908498287201,662.2128658294678,4784.323292732239,37920,8629,29291,29291,0,31,8338000.0
8338,8338999,20.838784607807575,37.982031805967566,0.07943413129954613,5903.914799928665,662.2801921367645,4784.8933000564575,37926,8632,29294,29294,0,31,8339000.0
8339,8339999,20.83987516676157,37.98365611687142,0.07947330339496128,5905.045119524002,662.3471720218658,4784.657155036926,37928,8633,29295,29295,0,31,8340000.0
8340,8340999,20.840926551011787,37.985240172344135,0.07949809278316122,5905.998539924622,662.4136211872101,4785.397252082825,37932,8635,29297,29297,0,31,8341000.0
8341,8341999,20.842017318014953,37.986307062245686,0.07951666693579473,5907.089873075485,662.4799270629883,4785.203946113586,37948,8638,29310,29310,0,31,8342000.0
8342,8342999,20.84334581872146,37.98822540188416,0.07954329778098124,5907.944723844528,662.5478720664978,4786.469822883606,37952,8640,29312,29312,0,31,8343000.0
8343,8343999,20.845032778795495,37.99069555197506,0.0795784513873099,5909.162228822708,662.6153841018677,4785.8880434036255,37958,8643,29315,29315,0,31,8344000.0
8344,8344999,20.8464531634971,37.99210721637173,0.07961437708884889,5910.258411169052,662.6829917430878,4785.5676012039185,37962,8645,29317,29317,0,31,8345000.0
8345,8345999,20.848260895493308,37.99452949019994,0.07966101478771193,5911.012558460236,662.7494919300079,4786.92883014679,37964,8646,29318,29318,0,31,8346000.0
8346,8346999,20.84971743797706,37.99604409726416,0.07969186468725054,5911.692898511887,662.8181099891663,4788.818783760071,37966,8647,29319,29319,0,31,8347000.0
8347,8347999,20.851317802165326,37.997594483111264,0.07971533211225634,5912.616610050201,662.8852391242981,4789.494214057922,37968,8648,29320,29320,0,31,8348000.0
8348,8348999,20.85210052310403,37.99767290232499,0.07972353391195397,5913.376092910767,662.9513394832611,4790.952038764954,37969,8648,29321,29321,0,31,8349000.0
8349,8349999,20.852394309007696,37.998296719366856,0.07968429551210843,5913.737001180649,663.0160882472992,4793.522465705872,37987,8649,29338,29338,0,31,8350000.0
8350,8350999,20.852516438536277,37.99820606293883,0.0796517869574741,5914.491650104523,663.08180975914,4794.549084663391,37989,8650,29339,29339,0,31,8351000.0
8351,8351999,20.852607191245333,37.99847356045224,0.07963126747390858,5915.162981033325,663.148099899292,4796.45901966095,37993,8652,29341,29341,0,31,8352000.0
8352,8352999,20.852486662447905,37.99757904976599,0.07961416856559811,5916.154368638992,663.2142815589905,4796.904057502747,37997,8654,29343,29343,0,31,8353000.0
8353,8353999,20.852019656356717,37.99628714931314,0.07960636795866749,5917.056922197342,663.2798357009888,4797.722638130188,37999,8655,29344,29344,0,31,8354000.0
8354,8354999,20.851432099465278,37.99487895525663,0.0796051897938278,5917.956721067429,663.3480496406555,4798.995503425598,38003,8657,29346,29346,0,31,8355000.0
8355,8355999,20.850905596082356,37.993613012383115,0.0796010800920478,5919.214439630508,663.4139583110809,4798.249882698059,38013,8662,29351,29351,0,31,8356000.0
8356,8356999,20.850469586167424,37.99259544542144,0.07959282687665514,5919.931584596634,663.4792945384979,4800.084385871887,38013,8662,29351,29351,0,31,8357000.0
8357,8357999,20.85006096637518,37.991692411436084,0.07958862715697557,5920.834559679031,663.5476138591766,4801.143033027649,38015,8663,29352,29352,0,31,8358000.0
8358,8358999,20.849454206558175,37.99038681946063,0.07958865774635737,5921.511608123779,663.6136374473572,4803.107869148254,38015,8663,29352,29352,0,31,8359000.0
8359,8359999,20.84893920882958,37.989317878194434,0.07959059871581375,5922.335111856461,663.6816511154175,4804.455906867981,38016,8663,29353,29353,0,31,8360000.0
8360,8360999,20.848465293552827,37.98825634780775,0.07959060530158568,5923.062130212784,663.750944852829,4806.466435432434,38016,8663,29353,29353,0,31,8361000.0
8361,8361999,20.848115850221514,37.98721857224439,0.07958992286989475,5924.77321267128,663.8220880031586,4803.439824104309,38028,8667,29361,29361,0,31,8362000.0
8362,8362999,20.84768898271065,37.986293570726,0.07958879404773422,5925.874621391296,663.8904809951782,4802.918972969055,38028,8667,29361,29361,0,31,8363000.0
8363,8363999,20.847257000909412,37.98498768384664,0.07958855545933619,5926.613669633865,663.9577271938324,4804.583584785461,38030,8668,29362,29362,0,31,8364000.0
8364,8364999,20.84692232635932,37.98389431316294,0.07958701810205016,5927.513544082642,664.0249350070953,4805.254681587219,38030,8668,29362,29362,0,31,8365000.0
8365,8365999,20.84657083813244,37.982846264544186,0.07958620040581776,5928.420905351639,664.096688747406,4806.611905097961,38032,8669,29363,29363,0,31,8366000.0
8366,8366999,20.846257965149753,37.981760522123274,0.07958249256048278,5929.814649820328,664.1697516441345,4805.003811836243,38042,8671,29371,29371,0,31,8367000.0
8367,8367999,20.845889274637667,37.980796738010405,0.07957244099303673,5930.827495098114,664.2373235225677,4805.068036079407,38042,8671,29371,29371,0,31,8368000.0
8368,8368999,20.845395882198318,37.97996436137415,0.07956171094485753,5931.461580514908,664.3052558898926,4806.978924751282,38042,8671,29371,29371,0,31,8369000.0
8369,8369999,20.845068337568993,37.97936474710763,0.07954513850541112,5931.868990182877,664.3689167499542,4809.475209236145,38058,8671,29387,29387,0,31,8370000.0
8370,8370999,20.844646532695165,37.978686522365294,0.07952779179464564,5932.151403903961,664.4332025051117,4812.776761054993,38058,8671,29387,29387,0,31,8371000.0
8371,8371999,20.844111093850483,37.97734138438051,0.07951611073177367,5933.126965522766,664.4973266124725,4813.379445075989,38072,8673,29399,29399,0,31,8372000.0
8372,8372999,20.843652111970997,37.976078431386014,0.07950278992847104,5933.891805410385,664.562822341919,4814.778431892395,38074,8674,29400,29400,0,31,8373000.0
8373,8373999,20.843253105455492,37.97611516352448,0.07949253843967952,5934.760580539703,664.6307888031006,4815.57140827179,38078,8676,29402,29402,0,31,8374000.0
8374,8374999,20.84251023112927,37.97465482050728,0.07949141398096726,5935.600114822388,664.6952629089355,4816.614903450012,38082,8678,29404,29404,0,31,8375000.0
8375,8375999,20.84168424538085,37.97347699089734,0.07949138558034141,5936.393927335739,664.7605314254761,4818.178288459778,38086,8680,29406,29406,0,31,8376000.0
8376,8376999,20.84114722223161,37.974703236857124,0.07948184550183934,5937.699213027954,664.8271887302399,4817.151646614075,38116,8682,29434,29434,0,31,8377000.0
8377,8377999,20.84052216085876,37.97443595105802,0.07947696114051261,5938.593169212341,664.8949158191681,4817.898465156555,38116,8682,29434,29434,0,31,8378000.0
8378,8378999,20.839878034972383,37.97351637439094,0.07947643600526699,5939.449776649475,664.9613485336304,4818.825459480286,38118,8683,29435,29435,0,31,8379000.0
8379,8379999,20.83904827865472,37.971979638366676,0.07947534858579564,5940.4123702049255,665.0283725261688,4819.430401802063,38120,8684,29436,29436,0,31,8380000.0
8380,8380999,20.838349286551743,37.970752602319855,0.07947080088932557,5941.476076841354,665.0969669818878,4819.686696052551,38122,8685,29437,29437,0,31,8381000.0
8381,8381999,20.837860191764012,37.97090512249621,0.07946192335616376,5942.329893112183,665.1647751331329,4820.5854387283325,38122,8685,29437,29437,0,31,8382000.0
8382,8382999,20.837376512138345,37.97000732209703,0.0794559233033596,5943.273556947708,665.2323875427246,4821.114056587219,38134,8686,29448,29448,0,31,8383000.0
8383,8383999,20.837149045559602,37.96951803161458,0.07944895846924072,5944.196776390076,665.3020296096802,4821.814961433411,38134,8686,29448,29448,0,31,8384000.0
8384,8384999,20.836748097734556,37.96867186315026,0.07944194069824206,5945.655369758606,665.3704016208649,4819.9545640945435,38145,8687,29458,29458,0,31,8385000.0
8385,8385999,20.836714608706803,37.968475927134264,0.07943204882758126,5946.412674665451,665.4400858879089,4821.438115119934,38145,8687,29458,29458,0,31,8386000.0
8386,8386999,20.83635403827567,37.96769926968734,0.07942372104930528,5947.359948635101,665.5084059238434,4821.8964738845825,38147,8688,29459,29459,0,31,8387000.0
8387,8387999,20.83607263106147,37.96673941573115,0.07941693370438707,5948.053564310074,665.5761005878448,4823.77933216095,38159,8689,29470,29470,0,31,8388000.0
8388,8388999,20.83611551962455,37.96798442024745,0.07940742549210278,5949.144646644592,665.6428465843201,4823.820622444153,38159,8689,29470,29470,0,31,8389000.0
8389,8389999,20.835646297529337,37.96686550587879,0.0793985031408404,5949.641136169434,665.7078573703766,4826.257237434387,38190,8690,29500,29500,0,31,8390000.0
8390,8390999,20.834857917410194,37.965270067815496,0.07939556942239878,5950.15646481514,665.7729194164276,4828.565274238586,38201,8691,29510,29510,0,31,8391000.0
8391,8391999,20.834282710831914,37.96441946077559,0.07939103417946014,5950.871495008469,665.8376660346985,4830.033185005188,38210,8693,29517,29517,0,31,8392000.0
8392,8392999,20.833807410687943,37.96316528469264,0.07938520369021251,5951.297920703888,665.9033796787262,4832.935399055481,38214,8693,29521,29521,0,31,8393000.0
8393,8393999,20.833494303825354,37.962413349717075,0.07937726920929655,5952.236607789993,665.9680156707764,4833.606366157532,38221,8696,29525,29525,0,31,8394000.0
8394,8394999,20.833211536447894,37.96154895282355,0.07937680969653771,5952.942139148712,666.034087896347,4835.325909614563,38226,8698,29528,29528,0,31,8395000.0
8395,8395999,20.83291723620138,37.96063849997343,0.07938197453758822,5953.908164978027,666.1011335849762,4835.482808113098,38228,8699,29529,29529,0,31,8396000.0
8396,8396999,20.83256297880296,37.95959758010966,0.07938075287118984,5954.541370630264,666.1671962738037,4837.464406013489,38229,8699,29530,29530,0,31,8397000.0
8397,8397999,20.832629500507167,37.96217571895145,0.07937356259541395,5955.418602228165,666.2324466705322,4838.341221809387,38231,8700,29531,29531,0,31,8398000.0
8398,8398999,20.832646810060382,37.9623531214151,0.07937256885879651,5956.051587820053,666.2988929748535,4840.705639839172,38231,8700,29531,29531,0,31,8399000.0
8399,8399999,20.832487504118195,37.96170796416242,0.07938393675512512,5957.396898269653,666.3653478622437,4839.523732185364,38237,8703,29534,29534,0,31,8400000.0
8400,8400999,20.83247495534457,37.96155514775016,0.07938733301760359,5958.056004285812,666.4305768013,4841.484295845032,38237,8703,29534,29534,0,31,8401000.0
8401,8401999,20.8325637161264,37.961617453236194,0.07939922419195933,5959.036680936813,666.4966688156128,4842.01850605011,38241,8705,29536,29536,0,31,8402000.0
8402,8402999,20.83271761046577,37.96157395447202,0.07940373174295323,5959.9193794727325,666.5640380382538,4843.226162910461,38241,8705,29536,29536,0,31,8403000.0
8403,8403999,20.832875052868676,37.961409895738036,0.07940428467135507,5960.971332788467,666.6296763420105,4843.333676338196,38243,8706,29537,29537,0,31,8404000.0
8404,8404999,20.83300598715962,37.96082654453097,0.079415527539074,5961.5827023983,666.6989524364471,4845.8819398880005,38243,8706,29537,29537,0,31,8405000.0
8405,8405999,20.833484403449223,37.96111166701887,0.0794258416380419,5962.68714594841,666.7659175395966,4846.023526191711,38247,8708,29539,29539,0,31,8406000.0
8406,8406999,20.833958776333386,37.9609960366771,0.07943262146761709,5964.16397356987,666.8343553543091,4844.430996894836,38255,8712,29543,29543,0,31,8407000.0
8407,8407999,20.834362586410975,37.96099039592119,0.07944136814648672,5965.432323932648,666.9006946086884,4843.760388374329,38263,8716,29547,29547,0,31,8408000.0
8408,8408999,20.834572141709476,37.96050307534104,0.07944691879213306,5966.468083143234,666.9662787914276,4843.952702522278,38265,8717,29548,29548,0,31,8409000.0
8409,8409999,20.834219668543277,37.95995687514775,0.0794394290669076,5966.867474555969,667.0352635383606,4846.896794319153,38288,8717,29571,29571,0,31,8410000.0
8410,8410999,20.83386972742017,37.95971574023348,0.07943265413865275,5967.321017742157,667.1046545505524,4849.254651069641,38292,8717,29575,29575,0,31,8411000.0
8411,8411999,20.833142475125058,37.95835545798801,0.07943281293235971,5967.922081947327,667.1744656562805,4851.3025941848755,38298,8719,29579,29579,0,31,8412000.0
8412,8412999,20.832564728785517,37.957217015813505,0.07943354836772676,5968.403253555298,667.2443449497223,4854.014317512512,38298,8719,29579,29579,0,31,8413000.0
8413,8413999,20.83209420156515,37.9560919104486,0.07943042327191008,5969.372423887253,667.315994977951,4854.866063117981,38302,8721,29581,29581,0,31,8414000.0
8414,8414999,20.831317839738063,37.95460489931915,0.07943266248503889,5970.329297304153,667.3936805725098,4856.049702644348,38304,8722,29582,29582,0,31,8415000.0
8415,8415999,20.830672824822877,37.95342195972301,0.07943180354211954,5971.269862413406,667.4707329273224,4857.260342597961,38307,8723,29584,29584,0,31,8416000.0
8416,8416999,20.830249456075833,37.952393232626605,0.07942703470444334,5972.3347427845,667.545393705368,4857.681134223938,38310,8724,29586,29586,0,31,8417000.0
8417,8417999,20.829806859675006,37.951596147158014,0.07942036974066102,5973.093141317368,667.6169023513794,4859.096508979797,38310,8724,29586,29586,0,31,8418000.0
8418,8418999,20.829247519685513,37.95025251380342,0.07941675871556053,5973.972964525223,667.6928052902222,4860.435544013977,38310,8724,29586,29586,0,31,8419000.0
8419,8419999,20.828924971610334,37.94945570035408,0.07941220750708788,5975.053938627243,667.768940448761,4860.854687690735,38314,8726,29588,29588,0,31,8420000.0
8420,8420999,20.828658111388204,37.94865942239644,0.07940350068129276,5976.2319593429565,667.8413832187653,4860.317723274231,38319,8728,29591,29591,0,31,8421000.0
8421,8421999,20.82833666500277,37.94764505922625,0.07939645610703916,5977.196046590805,667.9127974510193,4861.18305683136,38321,8729,29592,29592,0,31,8422000.0
8422,8422999,20.82815793105882,37.9469294205471,0.07939258122564485,5978.183585882187,667.9841206073761,4861.4841051101685,38325,8731,29594,29594,0,31,8423000.0
8423,8423999,20.82806337294393,37.947316639689475,0.07938340301634106,5979.237562179565,668.0563230514526,4861.214245796204,38328,8732,29596,29596,0,31,8424000.0
8424,8424999,20.827904485885497,37.9474602608068,0.07937332045073942,5979.86537694931,668.128250837326,4863.2036027908325,38328,8732,29596,29596,0,31,8425000.0
8425,8425999,20.827357113338497,37.94614236279392,0.0793720517803087,5980.632879734039,668.1990773677826,4864.511342048645,38328,8732,29596,29596,0,31,8426000.0
8426,8426999,20.827091665157127,37.945452638880035,0.07935340533413882,5981.322998285294,668.2682316303253,4866.132367134094,38350,8734,29616,29616,0,31,8427000.0
8427,8427999,20.826830939485365,37.9468531596135,0.07933175920219737,5981.847274541855,668.3372433185577,4868.180333137512,38350,8734,29616,29616,0,31,8428000.0
8428,8428999,20.82671869215517,37.94671388576513,0.07931849564838256,5982.546268701553,668.4055924415588,4869.606007575989,38352,8735,29617,29617,0,31,8429000.0
8429,8429999,20.82613407146225,37.94574720622269,0.07931487521089053,5983.27038025856,668.4768991470337,4870.884900093079,38366,8736,29630,29630,0,31,8430000.0
8430,8430999,20.825690940749443,37.94503096740847,0.079309490088177,5983.6997718811035,668.5488429069519,4873.671673774719,38369,8737,29632,29632,0,31,8431000.0
8431,8431999,20.825489899866916,37.94469849711102,0.07930916776501984,5984.371226787567,668.6204771995544,4875.602246284485,38371,8738,29633,29633,0,31,8432000.0
8432,8432999,20.825123121980077,37.94383556478863,0.07930897129720793,5985.391218662262,668.6921441555023,4875.836972236633,38373,8739,29634,29634,0,31,8433000.0
8433,8433999,20.824567449536836,37.94274729703238,0.07932005648844431,5986.0479645729065,668.7640976905823,4877.812237739563,38375,8740,29635,29635,0,31,8434000.0
8434,8434999,20.824396712261763,37.94293455904936,0.07931963838852807,5987.048203706741,668.8379881381989,4877.948056221008,38377,8741,29636,29636,0,31,8435000.0
8435,8435999,20.824194398262062,37.942473229753986,0.07932161727533182,5988.342906951904,668.9105899333954,4876.71585559845,38382,8743,29639,29639,0,31,8436000.0
8436,8436999,20.823945448373085,37.94154062024793,0.07932225244072666,5989.216952085495,668.9827585220337,4877.429707527161,38382,8743,29639,29639,0,31,8437000.0
8437,8437999,20.82394326820435,37.94145910396044,0.07931667039380474,5989.871153831482,669.057948589325,4879.610798835754,38394,8744,29650,29650,0,31,8438000.0
8438,8438999,20.823762919807645,37.9407049093495,0.07931546774735909,5991.1707944869995,669.1310937404633,4878.417645454407,38396,8745,29651,29651,0,31,8439000.0
8439,8439999,20.8239589978941,37.94079717570506,0.07931161454719815,5992.390247583389,669.2045547962189,4877.490025520325,38398,8746,29652,29652,0,31,8440000.0
8440,8440999,20.82391938720444,37.94010028652796,0.07930648004445884,5993.219959259033,669.2801077365875,4878.647343635559,38400,8747,29653,29653,0,31,8441000.0
8441,8441999,20.8240805091606,37.93972765715322,0.07930431454603282,5994.054225206375,669.3537120819092,4879.870923042297,38402,8748,29654,29654,0,31,8442000.0
8442,8442999,20.824333019421832,37.939449357054286,0.07930211163057466,5995.0836861133575,669.4287497997284,4880.240635871887,38402,8748,29654,29654,0,31,8443000.0
8443,8443999,20.824398513156964,37.939505686973995,0.07929292585979675,5996.232682466507,669.5028834342957,4879.776616096497,38402,8748,29654,29654,0,31,8444000.0
8444,8444999,20.82451245344997,37.941153194097275,0.07927759589722316,5997.1771767139435,669.5759246349335,4880.594723701477,38404,8749,29655,29655,0,31,8445000.0
8445,8445999,20.82418075670612,37.94076431145902,0.07927074582788796,5997.63302731514,669.6430251598358,4883.001133918762,38420,8749,29671,29671,0,31,8446000.0
8446,8446999,20.823593321329813,37.93975195525284,0.07927163024497297,5998.115783691406,669.7114794254303,4885.313015937805,38420,8749,29671,29671,0,31,8447000.0
8447,8447999,20.82340129438741,37.939978947192564,0.07926382326081105,5998.78470826149,669.7787592411041,4886.922741889954,38422,8750,29672,29672,0,31,8448000.0
8448,8448999,20.8232568608696,37.94016950354498,0.07925510340718267,5999.45737862587,669.8471081256866,4888.890698432922,38426,8752,29674,29674,0,31,8449000.0
8449,8449999,20.823329556787442,37.939983545100915,0.07925829030069032,6000.38756108284,669.9186732769012,4889.46577167511,38428,8753,29675,29675,0,31,8450000.0
8450,8450999,20.823607547624658,37.940350975561024,0.07925461698304537,6001.312563896179,669.9876079559326,4890.455075263977,38434,8755,29679,29679,0,31,8451000.0
8451,8451999,20.823818468189216,37.940344075723864,0.07925718582879426,6002.135458469391,670.0570225715637,4891.2986879348755,38434,8755,29679,29679,0,31,8452000.0
8452,8452999,20.82402787784529,37.94019385444363,0.07926037244939699,6003.115414619446,670.1282856464386,4892.304776191711,38441,8757,29684,29684,0,31,8453000.0
8453,8453999,20.824576289975283,37.940887082429796,0.07925806317589079,6004.0783088207245,670.197428226471,4892.768200874329,38443,8758,29685,29685,0,31,8454000.0
8454,8454999,20.82493615175505,37.941057768820855,0.07926987680979691,6004.757770061493,670.2653615474701,4894.686116218567,38447,8759,29688,29688,0,31,8455000.0
8455,8455999,20.825088777617673,37.94130706726896,0.07927319772189279,6005.894631147385,670.3363926410675,4894.555500984192,38449,8760,29689,29689,0,31,8456000.0
8456,8456999,20.82569424446301,37.94238688808179,0.07928324452206281,6007.379030704498,670.407443523407,4892.59484577179,38455,8763,29692,29692,0,31,8457000.0
8457,8457999,20.825720984259778,37.942095097668215,0.07928841339103954,6008.136452198029,670.4757905006409,4893.94721698761,38455,8763,29692,29692,0,31,8458000.0
8458,8458999,20.826312786540193,37.94302493712445,0.07929750353458487,6008.8341064453125,670.5446953773499,4895.874676704407,38457,8764,29693,29693,0,31,8459000.0
8459,8459999,20.82667660860869,37.94323817351909,0.07930550652008861,6009.618900775909,670.6155433654785,4897.288311958313,38457,8764,29693,29693,0,31,8460000.0
8460,8460999,20.82700066033152,37.943376572730344,0.07930772723763946,6010.525150775909,670.6889333724976,4898.419148445129,38459,8765,29694,29694,0,31,8461000.0
8461,8461999,20.827654110006186,37.943997354034536,0.07931752772257505,6011.5904104709625,670.7610068321228,4898.4993715286255,38459,8765,29694,29694,0,31,8462000.0
8462,8462999,20.828136081157087,37.94486192186984,0.07933335807125053,6012.737327337265,670.8328614234924,4897.9594469070435,38462,8766,29696,29696,0,31,8463000.0
8463,8463999,20.828456802294372,37.94488508884608,0.07934078959496971,6013.896404981613,670.9026601314545,4897.51638507843,38466,8767,29699,29699,0,31,8464000.0
8464,8464999,20.828641084476367,37.94458864878372,0.07935406160713854,6014.806630373001,670.9731919765472,4898.192669868469,38466,8767,29699,29699,0,31,8465000.0
8465,8465999,20.828271024099816,37.94472033825686,0.07934992118902062,6015.284090995789,671.044842004776,4900.804409980774,38484,8767,29717,29717,0,31,8466000.0
8466,8466999,20.82758678866342,37.94375175689042,0.0793513267278344,6015.7170877456665,671.1131658554077,4903.5961809158325,38488,8768,29720,29720,0,31,8467000.0
8467,8467999,20.827028400670528,37.942918885786426,0.0793523708408781,6016.410413503647,671.1818583011627,4905.1134996414185,38490,8769,29721,29721,0,31,8468000.0
8468,8468999,20.826456095257022,37.94168666850539,0.07935170510274048,6017.121725320816,671.2496809959412,4906.603344917297,38492,8770,29722,29722,0,31,8469000.0
8469,8469999,20.826150937169945,37.941678625578966,0.07934099180826149,6017.647574901581,671.3178086280823,4909.267109870911,38492,8770,29722,29722,0,31,8470000.0
8470,8470999,20.825644539671718,37.941144776450855,0.07934022770628135,6018.9982759952545,671.3872122764587,4908.164105415344,38496,8772,29724,29724,0,31,8471000.0
8471,8471999,20.825189473517717,37.940197968719524,0.07933889644536452,6020.161098241806,671.456286907196,4907.769101142883,38503,8775,29728,29728,0,31,8472000.0
8472,8472999,20.824831284548672,37.93967397946321,0.07933506647181299,6021.157815217972,671.5266330242157,4908.221623420715,38507,8777,29730,29730,0,31,8473000.0
8473,8473999,20.824804036509267,37.939646863827875,0.07934242644665346,6022.2994866371155,671.5987393856049,4908.125493049622,38513,8780,29733,29733,0,31,8474000.0
8474,8474999,20.825205883689712,37.940285172610494,0.0793457932797037,6023.039424657822,671.667379617691,4909.756314277649,38513,8780,29733,29733,0,31,8475000.0
8475,8475999,20.8257474831471,37.94110783514966,0.07935558544374544,6023.881595849991,671.7403886318207,4911.102879524231,38513,8780,29733,29733,0,31,8476000.0
8476,8476999,20.826640984917017,37.94306147138306,0.07936638835339505,6024.889291524887,671.8111267089844,4911.574421882629,38519,8782,29737,29737,0,31,8477000.0
8477,8477999,20.82780062867406,37.945618816147025,0.07941529384429202,6025.963888168335,671.8828821182251,4911.433835029602,38521,8783,29738,29738,0,31,8478000.0
8478,8478999,20.829153955172124,37.948859729910964,0.07942740883442023,6026.765838861465,671.9546051025391,4912.884037971497,38524,8784,29740,29740,0,31,8479000.0
8479,8479999,20.830526235367042,37.95270944324415,0.07947332870269408,6027.707997083664,672.0274879932404,4913.667462348938,38524,8784,29740,29740,0,31,8480000.0
8480,8480999,20.831444337886996,37.95389189911259,0.07948488582811863,6028.549950838089,672.0978765487671,4914.9710512161255,38524,8784,29740,29740,0,31,8481000.0
8481,8481999,20.83298092909724,37.95800436923928,0.0794978111216379,6029.4060933589935,672.1686837673187,4916.239880561829,38528,8786,29742,29742,0,31,8482000.0
8482,8482999,20.83409307146112,37.959272118529064,0.07952879409175417,6030.45424747467,672.2404334545135,4917.000508308411,38561,8788,29773,29773,0,31,8483000.0
8483,8483999,20.835005490302542,37.960782642985855,0.07953430228256497,6031.918672084808,672.3132584095001,4915.2546281814575,38575,8790,29785,29785,0,31,8484000.0
8484,8484999,20.835022002687445,37.960637658599246,0.07953027254615419,6032.7014763355255,672.3852410316467,4916.435803413391,38596,8791,29805,29805,0,31,8485000.0
8485,8485999,20.834792673191735,37.960056310098075,0.07952495586776209,6033.307540655136,672.4535386562347,4918.188923835754,38598,8791,29807,29807,0,31,8486000.0
8486,8486999,20.834747069667454,37.96002382795226,0.07952577450461673,6033.912180423737,672.5210869312286,4920.253018379211,38600,8792,29808,29808,0,31,8487000.0
8487,8487999,20.834703918895723,37.96023345645176,0.0795191061035968,6034.850821495056,672.5897798538208,4920.83124256134,38602,8793,29809,29809,0,31,8488000.0
8488,8488999,20.834681366880837,37.95993171874978,0.07952499174928462,6035.493186473846,672.6601014137268,4922.851010322571,38602,8793,29809,29809,0,31,8489000.0
8489,8489999,20.83462394674719,37.959343591520145,0.0795233136922453,6036.406181097031,672.7298436164856,4924.110226631165,38604,8794,29810,29810,0,31,8490000.0
8490,8490999,20.834446447640644,37.95863593208117,0.07953033502288831,6037.48623085022,672.8075113296509,4924.1243715286255,38609,8796,29813,29813,0,31,8491000.0
8491,8491999,20.834346744506792,37.958115807338686,0.07953486923911857,6039.640715122223,672.9698405265808,4924.759404182434,38615,8799,29816,29816,0,31,8492000.0
8492,8492999,20.834507865200504,37.958653480446195,0.07953031179293213,6041.342657327652,673.1279284954071,4925.686505317688,38619,8801,29818,29818,0,31,8493000.0
8493,8493999,20.834541780166617,37.95811345786701,0.0795325478572877,6042.870754480362,673.2488932609558,4926.40034198761,38625,8804,29821,29821,0,31,8494000.0
8494,8494999,20.834634374592053,37.95784715424345,0.07954345500869142,6044.603337049484,673.3744866847992,4927.046414375305,38627,8805,29822,29822,0,31,8495000.0
8495,8495999,20.83472685110036,37.95742742362324,0.07954268404882969,6046.212912559509,673.4815683364868,4927.438054084778,38627,8805,29822,29822,0,31,8496000.0
8496,8496999,20.83469945967422,37.95679913452054,0.079541939455402,6049.546087265015,673.6891803741455,4928.550625801086,38629,8806,29823,29823,0,31,8497000.0
8497,8497999,20.834634026700858,37.95603524659641,0.07954414033419244,6051.082688093185,673.8012034893036,4928.630940437317,38629,8806,29823,29823,0,31,8498000.0
8498,8498999,20.834792065047985,37.95570436895935,0.07954313965894533,6051.861858129501,673.895724773407,4931.186123847961,38629,8806,29823,29823,0,31,8499000.0
8499,8499999,20.834822448106653,37.95515431233829,0.07953834841621121,6053.250067472458,673.9982531070709,4931.86323261261,38629,8806,29823,29823,0,31,8500000.0
8500,8500999,20.834866219830968,37.954715860347285,0.07953405916691836,6054.954760313034,674.1188271045685,4932.480862617493,38643,8808,29835,29835,0,31,8501000.0
8501,8501999,20.834836322845334,37.954994142283894,0.07952982689195798,6057.056069135666,674.2318181991577,4931.209233283997,38650,8810,29840,29840,0,31,8502000.0
8502,8502999,20.834611994182676,37.95394080309182,0.07952670935367434,6058.060596704483,674.3546686172485,4933.7311754226685,38650,8810,29840,29840,0,31,8503000.0
8503,8503999,20.834468113094633,37.95314498945508,0.07952152951000935,6059.971546888351,674.4589085578918,4932.54829120636,38654,8812,29842,29842,0,31,8504000.0
8504,8504999,20.833673315075828,37.951587847256235,0.0795226935082135,6060.549070358276,674.5463364124298,4935.27615070343,38661,8813,29848,29848,0,31,8505000.0
8505,8505999,20.832730178286816,37.95007522516676,0.07952516125174303,6061.4465935230255,674.6567485332489,4936.892521858215,38676,8814,29862,29862,0,31,8506000.0
8506,8506999,20.831906545515654,37.94852684300465,0.07952716639532331,6062.110129833221,674.7756977081299,4939.785885810852,38676,8814,29862,29862,0,31,8507000.0
8507,8507999,20.83113292604365,37.94763379139993,0.07952667005260872,6063.062552452087,674.8740999698639,4941.32497882843,38676,8814,29862,29862,0,31,8508000.0
8508,8508999,20.830312667204,37.94614212330231,0.07952750121618524,6063.988813638687,674.9762501716614,4943.359631538391,38676,8814,29862,29862,0,31,8509000.0
8509,8509999,20.82965360123415,37.945242811963595,0.07952510856859674,6065.774441957474,675.0807507038116,4942.6402406692505,38681,8816,29865,29865,0,31,8510000.0
8510,8510999,20.828929025952963,37.94411227444756,0.07952633793065889,6066.484157800674,675.2073848247528,4945.861889839172,38681,8816,29865,29865,0,31,8511000.0
8511,8511999,20.82826052598939,37.94361370454398,0.07952424542635972,6068.458475589752,675.3250813484192,4944.829174995422,38683,8817,29866,29866,0,31,8512000.0
8512,8512999,20.828032947615938,37.944298751903055,0.07952619364189217,6069.32698392868,675.4129202365875,4946.447598457336,38685,8818,29867,29867,0,31,8513000.0
8513,8513999,20.82848177968565,37.947266801465695,0.07952415430267334,6070.837376356125,675.5097935199738,4946.073727607727,38687,8819,29868,29868,0,31,8514000.0
8514,8514999,20.82858804311087,37.95021144290047,0.07950207406568266,6072.316516637802,675.6062738895416,4945.944363594055,38689,8820,29869,29869,0,31,8515000.0
8515,8515999,20.82861380647613,37.950911320725986,0.0794924212141559,6073.77183842659,675.7144913673401,4946.846737861633,38691,8821,29870,29870,0,31,8516000.0
8516,8516999,20.828772891068116,37.951873737444075,0.07947728562403211,6075.088129758835,675.8346219062805,4947.5820055007935,38694,8822,29872,29872,0,31,8517000.0
8517,8517999,20.829020892241417,37.95244886775021,0.07946649493414004,6076.57457947731,675.9471964836121,4947.903195381165,38702,8826,29876,29876,0,31,8518000.0
8518,8518999,20.829224488719177,37.95274188000477,0.0794596784670768,6077.997445106506,676.0741105079651,4948.8499574661255,38706,8828,29878,29878,0,31,8519000.0
8519,8519999,20.829772234604935,37.95421815330251,0.0794468505182866,6079.028806686401,676.1745820045471,4950.2042055130005,38706,8828,29878,29878,0,31,8520000.0
8520,8520999,20.830592066236488,37.9556226250198,0.0794358393969502,6079.745505094528,676.2880234718323,4953.389859199524,38706,8828,29878,29878,0,31,8521000.0
8521,8521999,20.831259188691067,37.95689363971244,0.07942065769277207,6082.459450006485,676.3956513404846,4950.296757698059,38724,8832,29892,29892,0,31,8522000.0
8522,8522999,20.83176766506751,37.95743353885673,0.07941133320013105,6084.297452449799,676.4903535842896,4948.621693611145,38728,8834,29894,29894,0,31,8523000.0
8523,8523999,20.831802710050184,37.957454019697565,0.07939907978387628,6086.4237496852875,676.6144549846649,4947.251431465149,38733,8836,29897,29897,0,31,8524000.0
8524,8524999,20.831670072903997,37.95709249524905,0.07937962770481266,6086.751574277878,676.7207887172699,4950.896077156067,38753,8836,29917,29917,0,31,8525000.0
8525,8525999,20.83160332396569,37.956508784962416,0.0793590069900777,6087.539743185043,676.82248711586,4953.075558662415,38754,8836,29918,29918,0,31,8526000.0
8526,8526999,20.83154645343793,37.95598542665283,0.07935176603473637,6088.539224386215,676.9187853336334,4954.455334663391,38768,8838,29930,29930,0,31,8527000.0
8527,8527999,20.831437088877827,37.9552084330395,0.07934214299375575,6089.979374885559,677.0397849082947,4955.590901374817,38768,8838,29930,29930,0,31,8528000.0
8528,8528999,20.831572772738376,37.954842064448215,0.07933903741154258,6091.335242033005,677.1535375118256,4956.506367683411,38772,8840,29932,29932,0,31,8529000.0
8529,8529999,20.83182864109166,37.95507741630981,0.07932987825183324,6092.9458129405975,677.2508239746094,4956.165112495422,38778,8843,29935,29935,0,31,8530000.0
8530,8530999,20.831991695063973,37.955281413173616,0.07932816051096347,6094.132324934006,677.3419103622437,4956.867993354797,38780,8844,29936,29936,0,31,8531000.0
8531,8531999,20.832257974900962,37.955985113149204,0.07932471997833923,6095.21027135849,677.4329209327698,4958.110920906067,38786,8847,29939,29939,0,31,8532000.0
8532,8532999,20.832571373214005,37.9562979970363,0.07932820590548795,6137.299902439117,677.6092851161957,4958.59476184845,38788,8848,29940,29940,0,31,8533000.0
